trial,train_size,embed_dim,hidden_dim,alpha,learning_rate,accuracy,train_accuracy,batch_pos,batch_neg
1,104,10,100,1e-05,0.01,0.504,0.5576923076923077,52,52
1,204,10,100,1e-05,0.01,0.53,0.6519607843137255,98,106
1,304,10,100,1e-05,0.01,0.532,0.618421052631579,146,158
1,404,10,100,1e-05,0.01,0.52,0.6113861386138614,207,197
1,504,10,100,1e-05,0.01,0.506,0.5753968253968254,256,248
1,604,10,100,1e-05,0.01,0.514,0.6440397350993378,303,301
1,704,10,100,1e-05,0.01,0.52,0.6036931818181818,354,350
1,804,10,100,1e-05,0.01,0.528,0.6455223880597015,401,403
1,904,10,100,1e-05,0.01,0.534,0.6393805309734514,448,456
1,1004,10,100,1e-05,0.01,0.53,0.6693227091633466,499,505
1,1104,10,100,1e-05,0.01,0.516,0.6512681159420289,544,560
1,1204,10,100,1e-05,0.01,0.542,0.6818936877076412,594,610
1,1304,10,100,1e-05,0.01,0.52,0.6909509202453987,637,667
1,1404,10,100,1e-05,0.01,0.528,0.7072649572649573,686,718
1,1504,10,100,1e-05,0.01,0.51,0.6988031914893617,733,771
1,1604,10,100,1e-05,0.01,0.51,0.7206982543640897,778,826
1,1704,10,100,1e-05,0.01,0.504,0.7095070422535211,830,874
1,1804,10,100,1e-05,0.01,0.506,0.7466740576496674,877,927
1,1904,10,100,1e-05,0.01,0.51,0.6964285714285714,929,975
1,2004,10,100,1e-05,0.01,0.5,0.7130738522954092,973,1031
1,2104,10,100,1e-05,0.01,0.504,0.7400190114068441,1022,1082
1,2204,10,100,1e-05,0.01,0.54,0.7468239564428312,1064,1140
1,2304,10,100,1e-05,0.01,0.536,0.7638888888888888,1113,1191
1,2404,10,100,1e-05,0.01,0.556,0.7529118136439268,1168,1236
1,2504,10,100,1e-05,0.01,0.56,0.7559904153354633,1229,1275
1,2604,10,100,1e-05,0.01,0.562,0.7910906298003072,1271,1333
1,2704,10,100,1e-05,0.01,0.576,0.7847633136094675,1312,1392
1,2804,10,100,1e-05,0.01,0.616,0.8334522111269614,1364,1440
1,2904,10,100,1e-05,0.01,0.628,0.8271349862258953,1413,1491
1,3004,10,100,1e-05,0.01,0.636,0.8525299600532623,1463,1541
1,3104,10,100,1e-05,0.01,0.656,0.8472938144329897,1523,1581
1,3204,10,100,1e-05,0.01,0.684,0.8629837702871411,1580,1624
1,3304,10,100,1e-05,0.01,0.694,0.8577481840193705,1633,1671
1,3404,10,100,1e-05,0.01,0.698,0.8586956521739131,1683,1721
1,3504,10,100,1e-05,0.01,0.716,0.9049657534246576,1734,1770
1,3604,10,100,1e-05,0.01,0.708,0.8967813540510544,1792,1812
1,3704,10,100,1e-05,0.01,0.762,0.916036717062635,1836,1868
1,3804,10,100,1e-05,0.01,0.758,0.9363827549947423,1889,1915
1,3904,10,100,1e-05,0.01,0.772,0.936219262295082,1946,1958
1,4004,10,100,1e-05,0.01,0.746,0.9183316683316683,1992,2012
1,4104,10,100,1e-05,0.01,0.79,0.922270955165692,2046,2058
1,4204,10,100,1e-05,0.01,0.776,0.9124643196955281,2092,2112
1,4304,10,100,1e-05,0.01,0.774,0.9140334572490706,2142,2162
1,4404,10,100,1e-05,0.01,0.778,0.9416439600363307,2188,2216
1,4504,10,100,1e-05,0.01,0.794,0.9480461811722913,2240,2264
1,4604,10,100,1e-05,0.01,0.79,0.9578627280625543,2299,2305
1,4704,10,100,1e-05,0.01,0.796,0.9642857142857143,2346,2358
1,4804,10,100,1e-05,0.01,0.822,0.9592006661115737,2396,2408
1,4904,10,100,1e-05,0.01,0.786,0.9482055464926591,2442,2462
1,5004,10,100,1e-05,0.01,0.782,0.9160671462829736,2491,2513
1,5104,10,100,1e-05,0.01,0.808,0.8983150470219435,2542,2562
1,5204,10,100,1e-05,0.01,0.854,0.9515757109915449,2594,2610
1,5304,10,100,1e-05,0.01,0.86,0.9666289592760181,2649,2655
1,5404,10,100,1e-05,0.01,0.862,0.9744633604737232,2703,2701
1,5504,10,100,1e-05,0.01,0.88,0.981468023255814,2754,2750
1,5604,10,100,1e-05,0.01,0.854,0.9685938615274804,2795,2809
1,5704,10,100,1e-05,0.01,0.842,0.9384642356241234,2848,2856
1,5804,10,100,1e-05,0.01,0.864,0.9539972432804962,2891,2913
1,5904,10,100,1e-05,0.01,0.876,0.9769647696476965,2943,2961
1,6004,10,100,1e-05,0.01,0.912,0.9820119920053297,2993,3011
1,6104,10,100,1e-05,0.01,0.872,0.9865661861074705,3036,3068
1,6204,10,100,1e-05,0.01,0.916,0.9930689877498388,3081,3123
1,6304,10,100,1e-05,0.01,0.908,0.9912753807106599,3136,3168
1,6404,10,100,1e-05,0.01,0.902,0.9943785134291068,3189,3215
1,6504,10,100,1e-05,0.01,0.916,0.9923124231242313,3240,3264
1,6604,10,100,1e-05,0.01,0.91,0.9924288310115081,3284,3320
1,6704,10,100,1e-05,0.01,0.896,0.985381861575179,3342,3362
1,6804,10,100,1e-05,0.01,0.916,0.9897119341563786,3395,3409
1,6904,10,100,1e-05,0.01,0.914,0.9879779837775203,3444,3460
1,7004,10,100,1e-05,0.01,0.88,0.9745859508852085,3497,3507
1,7104,10,100,1e-05,0.01,0.918,0.9880349099099099,3548,3556
1,7204,10,100,1e-05,0.01,0.922,0.9884786229872293,3595,3609
1,7304,10,100,1e-05,0.01,0.928,0.9945235487404163,3651,3653
1,7404,10,100,1e-05,0.01,0.93,0.9978390059427337,3708,3696
1,7504,10,100,1e-05,0.01,0.932,0.9957356076759062,3757,3747
1,7604,10,100,1e-05,0.01,0.942,0.9971067859021567,3805,3799
1,7704,10,100,1e-05,0.01,0.942,0.997533748701973,3854,3850
1,7804,10,100,1e-05,0.01,0.904,0.9641209636084059,3900,3904
1,7904,10,100,1e-05,0.01,0.886,0.9476214574898786,3956,3948
1,8004,10,100,1e-05,0.01,0.92,0.9816341829085458,4006,3998
1,8104,10,100,1e-05,0.01,0.94,0.991238894373149,4063,4041
1,8204,10,100,1e-05,0.01,0.966,0.9929302779132131,4108,4096
1,8304,10,100,1e-05,0.01,0.954,0.9989161849710982,4152,4152
1,8404,10,100,1e-05,0.01,0.968,0.9996430271299381,4202,4202
1,8504,10,100,1e-05,0.01,0.966,0.9998824082784572,4254,4250
1,8604,10,100,1e-05,0.01,0.97,0.997907949790795,4298,4306
1,8704,10,100,1e-05,0.01,0.97,0.9993106617647058,4354,4350
1,8804,10,100,1e-05,0.01,0.97,0.9955701953657429,4401,4403
1,8904,10,100,1e-05,0.01,0.96,0.9966307277628033,4444,4460
1,9004,10,100,1e-05,0.01,0.958,0.9973345179920036,4489,4515
1,9104,10,100,1e-05,0.01,0.962,0.9974736379613357,4532,4572
1,9204,10,100,1e-05,0.01,0.962,0.9977183833116037,4583,4621
1,9304,10,100,1e-05,0.01,0.966,0.9970980223559759,4627,4677
1,9404,10,100,1e-05,0.01,0.944,0.9787324542747767,4675,4729
1,9504,10,100,1e-05,0.01,0.964,0.9891624579124579,4724,4780
1,9604,10,100,1e-05,0.01,0.966,0.9880258225739276,4776,4828
1,9704,10,100,1e-05,0.01,0.966,0.9963932399010718,4829,4875
1,9804,10,100,1e-05,0.01,0.972,0.9968380252957977,4888,4916
1,9904,10,100,1e-05,0.01,0.978,0.9994951534733441,4938,4966
1,10004,10,100,1e-05,0.01,0.98,0.998500599760096,4990,5014
1,10104,10,100,1e-05,0.01,0.978,0.9994061757719715,5048,5056
1,10204,10,100,1e-05,0.01,0.974,0.9955899647197177,5105,5099
1,10304,10,100,1e-05,0.01,0.988,0.9967003105590062,5155,5149
1,10404,10,100,1e-05,0.01,0.972,0.9944252210688197,5206,5198
1,10504,10,100,1e-05,0.01,0.964,0.9907654226961158,5263,5241
1,10604,10,100,1e-05,0.01,0.974,0.9932101093926821,5319,5285
1,10704,10,100,1e-05,0.01,0.978,0.9985052316890882,5368,5336
1,10804,10,100,1e-05,0.01,0.976,0.9952795261014439,5414,5390
1,10904,10,100,1e-05,0.01,0.976,0.9991746148202495,5464,5440
1,11004,10,100,1e-05,0.01,0.982,0.9970010905125409,5513,5491
1,11104,10,100,1e-05,0.01,0.978,0.9985590778097982,5564,5540
1,11204,10,100,1e-05,0.01,0.984,0.9973223848625491,5607,5597
1,11304,10,100,1e-05,0.01,0.98,0.9969037508846426,5655,5649
1,11404,10,100,1e-05,0.01,0.99,0.9992108032269379,5706,5698
1,11504,10,100,1e-05,0.01,0.986,0.9989568845618915,5749,5755
1,11604,10,100,1e-05,0.01,0.986,0.9999138228197173,5792,5812
1,11704,10,100,1e-05,0.01,0.992,0.9985475051264525,5842,5862
1,11804,10,100,1e-05,0.01,0.982,0.9953405625211793,5899,5905
1,11904,10,100,1e-05,0.01,0.98,0.9968918010752689,5945,5959
1,12004,10,100,1e-05,0.01,0.97,0.9820893035654782,5996,6008
1,12104,10,100,1e-05,0.01,0.988,0.9885161929940516,6044,6060
1,12204,10,100,1e-05,0.01,0.992,0.9964765650606359,6094,6110
1,12304,10,100,1e-05,0.01,0.986,0.9973179453836151,6141,6163
1,12404,10,100,1e-05,0.01,0.99,0.9986294743631087,6186,6218
1,12504,10,100,1e-05,0.01,0.988,0.997040946896993,6232,6272
1,12604,10,100,1e-05,0.01,0.996,0.9984925420501428,6285,6319
1,12704,10,100,1e-05,0.01,0.994,0.999448992443325,6334,6370
1,12804,10,100,1e-05,0.01,0.992,0.9995313964386129,6393,6411
1,12904,10,100,1e-05,0.01,0.988,0.9994575325480471,6436,6468
1,13004,10,100,1e-05,0.01,0.984,0.9967702245462935,6487,6517
1,13104,10,100,1e-05,0.01,0.99,0.996947496947497,6535,6569
1,13204,10,100,1e-05,0.01,0.99,0.9971978188427749,6576,6628
1,13304,10,100,1e-05,0.01,0.982,0.9937612748045701,6631,6673
1,13404,10,100,1e-05,0.01,0.988,0.9993285586392122,6682,6722
1,13504,10,100,1e-05,0.01,0.994,0.998593009478673,6734,6770
1,13604,10,100,1e-05,0.01,0.99,0.9994854454572185,6797,6807
1,13704,10,100,1e-05,0.01,0.986,0.9981027437244601,6836,6868
1,13804,10,100,1e-05,0.01,0.996,0.9997826716893654,6884,6920
1,13904,10,100,1e-05,0.01,0.992,0.999928078250863,6930,6974
1,14004,10,100,1e-05,0.01,0.986,0.9983576121108255,6988,7016
1,14104,10,100,1e-05,0.01,0.99,0.9967385138967668,7040,7064
1,14204,10,100,1e-05,0.01,0.974,0.9936637566882568,7090,7114
1,14304,10,100,1e-05,0.01,0.992,0.9917505592841164,7132,7172
1,14404,10,100,1e-05,0.01,0.994,0.997917245209664,7183,7221
1,14504,10,100,1e-05,0.01,0.996,0.9993794815223387,7238,7266
1,14604,10,100,1e-05,0.01,0.996,0.9999315256094221,7291,7313
1,14704,10,100,1e-05,0.01,0.998,0.9995919477693145,7339,7365
1,14804,10,100,1e-05,0.01,1.0,0.9995271548230208,7397,7407
1,14904,10,100,1e-05,0.01,0.996,0.999194847020934,7445,7459
1,15004,10,100,1e-05,0.01,0.994,0.9974006931484938,7501,7503
2,104,10,100,1e-05,0.01,0.508,0.6442307692307693,67,37
2,204,10,100,1e-05,0.01,0.516,0.6617647058823529,116,88
2,304,10,100,1e-05,0.01,0.494,0.6052631578947368,159,145
2,404,10,100,1e-05,0.01,0.482,0.5618811881188119,205,199
2,504,10,100,1e-05,0.01,0.47,0.6111111111111112,252,252
2,604,10,100,1e-05,0.01,0.52,0.6241721854304636,304,300
2,704,10,100,1e-05,0.01,0.508,0.6676136363636364,351,353
2,804,10,100,1e-05,0.01,0.508,0.6766169154228856,406,398
2,904,10,100,1e-05,0.01,0.472,0.6581858407079646,456,448
2,1004,10,100,1e-05,0.01,0.474,0.6882470119521913,508,496
2,1104,10,100,1e-05,0.01,0.476,0.6748188405797102,557,547
2,1204,10,100,1e-05,0.01,0.518,0.6885382059800664,607,597
2,1304,10,100,1e-05,0.01,0.528,0.6748466257668712,657,647
2,1404,10,100,1e-05,0.01,0.508,0.7022792022792023,702,702
2,1504,10,100,1e-05,0.01,0.534,0.6775265957446809,750,754
2,1604,10,100,1e-05,0.01,0.486,0.6801745635910225,806,798
2,1704,10,100,1e-05,0.01,0.544,0.727112676056338,845,859
2,1804,10,100,1e-05,0.01,0.488,0.7488913525498891,889,915
2,1904,10,100,1e-05,0.01,0.554,0.7253151260504201,935,969
2,2004,10,100,1e-05,0.01,0.528,0.7754491017964071,980,1024
2,2104,10,100,1e-05,0.01,0.534,0.7585551330798479,1026,1078
2,2204,10,100,1e-05,0.01,0.568,0.7803992740471869,1082,1122
2,2304,10,100,1e-05,0.01,0.542,0.7881944444444444,1129,1175
2,2404,10,100,1e-05,0.01,0.566,0.8202995008319468,1181,1223
2,2504,10,100,1e-05,0.01,0.544,0.8446485623003195,1229,1275
2,2604,10,100,1e-05,0.01,0.562,0.8725038402457758,1282,1322
2,2704,10,100,1e-05,0.01,0.592,0.852810650887574,1332,1372
2,2804,10,100,1e-05,0.01,0.576,0.8605563480741797,1387,1417
2,2904,10,100,1e-05,0.01,0.628,0.8798209366391184,1438,1466
2,3004,10,100,1e-05,0.01,0.652,0.9131158455392809,1482,1522
2,3104,10,100,1e-05,0.01,0.646,0.9384664948453608,1534,1570
2,3204,10,100,1e-05,0.01,0.648,0.8860799001248439,1584,1620
2,3304,10,100,1e-05,0.01,0.652,0.8686440677966102,1635,1669
2,3404,10,100,1e-05,0.01,0.692,0.9174500587544065,1680,1724
2,3504,10,100,1e-05,0.01,0.702,0.9429223744292238,1728,1776
2,3604,10,100,1e-05,0.01,0.714,0.9203662597114317,1778,1826
2,3704,10,100,1e-05,0.01,0.752,0.968682505399568,1831,1873
2,3804,10,100,1e-05,0.01,0.798,0.9847528916929548,1872,1932
2,3904,10,100,1e-05,0.01,0.826,0.9879610655737705,1923,1981
2,4004,10,100,1e-05,0.01,0.85,0.9920079920079921,1968,2036
2,4104,10,100,1e-05,0.01,0.87,0.9929337231968811,2021,2083
2,4204,10,100,1e-05,0.01,0.862,0.9907231208372979,2063,2141
2,4304,10,100,1e-05,0.01,0.908,0.9965148698884758,2103,2201
2,4404,10,100,1e-05,0.01,0.89,0.9900090826521344,2146,2258
2,4504,10,100,1e-05,0.01,0.91,0.9704706927175843,2196,2308
2,4604,10,100,1e-05,0.01,0.918,0.9871850564726324,2250,2354
2,4704,10,100,1e-05,0.01,0.904,0.9904336734693877,2297,2407
2,4804,10,100,1e-05,0.01,0.932,0.9975020815986678,2349,2455
2,4904,10,100,1e-05,0.01,0.94,0.9987765089722676,2390,2514
2,5004,10,100,1e-05,0.01,0.938,0.9992006394884093,2450,2554
2,5104,10,100,1e-05,0.01,0.954,0.9996081504702194,2510,2594
2,5204,10,100,1e-05,0.01,0.944,0.9986548808608763,2566,2638
2,5304,10,100,1e-05,0.01,0.954,0.9996229260935143,2619,2685
2,5404,10,100,1e-05,0.01,0.964,0.9998149518874907,2669,2735
2,5504,10,100,1e-05,0.01,0.952,0.9976380813953488,2719,2785
2,5604,10,100,1e-05,0.01,0.96,0.9998215560314061,2765,2839
2,5704,10,100,1e-05,0.01,0.97,1.0,2815,2889
2,5804,10,100,1e-05,0.01,0.968,1.0,2862,2942
2,5904,10,100,1e-05,0.01,0.966,0.9996612466124661,2915,2989
2,6004,10,100,1e-05,0.01,0.966,0.9993337774816788,2968,3036
2,6104,10,100,1e-05,0.01,0.958,0.9908256880733946,3013,3091
2,6204,10,100,1e-05,0.01,0.946,0.9866215344938749,3062,3142
2,6304,10,100,1e-05,0.01,0.954,0.9901649746192893,3105,3199
2,6404,10,100,1e-05,0.01,0.95,0.9881324172392255,3162,3242
2,6504,10,100,1e-05,0.01,0.974,0.998769987699877,3211,3293
2,6604,10,100,1e-05,0.01,0.97,0.9965172622652938,3255,3349
2,6704,10,100,1e-05,0.01,0.972,0.9968675417661098,3302,3402
2,6804,10,100,1e-05,0.01,0.97,0.9995590828924162,3352,3452
2,6904,10,100,1e-05,0.01,0.988,1.0,3403,3501
2,7004,10,100,1e-05,0.01,0.988,0.9992861222158766,3456,3548
2,7104,10,100,1e-05,0.01,0.984,0.9998592342342343,3501,3603
2,7204,10,100,1e-05,0.01,0.984,0.9997223764575236,3551,3653
2,7304,10,100,1e-05,0.01,0.988,1.0,3607,3697
2,7404,10,100,1e-05,0.01,0.988,1.0,3660,3744
2,7504,10,100,1e-05,0.01,0.988,1.0,3709,3795
2,7604,10,100,1e-05,0.01,0.988,1.0,3751,3853
2,7704,10,100,1e-05,0.01,0.988,0.9997403946002077,3799,3905
2,7804,10,100,1e-05,0.01,0.988,0.9998718605843158,3844,3960
2,7904,10,100,1e-05,0.01,0.982,0.999746963562753,3897,4007
2,8004,10,100,1e-05,0.01,0.986,0.999000499750125,3951,4053
2,8104,10,100,1e-05,0.01,0.99,0.9981490621915103,4000,4104
2,8204,10,100,1e-05,0.01,0.98,0.9951243295953194,4053,4151
2,8304,10,100,1e-05,0.01,0.978,0.9909682080924855,4100,4204
2,8404,10,100,1e-05,0.01,0.98,0.9861970490242742,4152,4252
2,8504,10,100,1e-05,0.01,0.97,0.9914158043273753,4207,4297
2,8604,10,100,1e-05,0.01,0.986,0.997443049744305,4262,4342
2,8704,10,100,1e-05,0.01,0.986,0.9979319852941176,4305,4399
2,8804,10,100,1e-05,0.01,0.99,0.9990913221263062,4362,4442
2,8904,10,100,1e-05,0.01,0.986,0.9985399820305481,4412,4492
2,9004,10,100,1e-05,0.01,0.988,0.9985561972456686,4450,4554
2,9104,10,100,1e-05,0.01,0.986,0.9992311072056239,4498,4606
2,9204,10,100,1e-05,0.01,0.982,0.99793568013907,4551,4653
2,9304,10,100,1e-05,0.01,0.992,0.9994625967325881,4598,4706
2,9404,10,100,1e-05,0.01,0.982,0.9974478945129732,4649,4755
2,9504,10,100,1e-05,0.01,0.992,0.9982112794612794,4707,4797
2,9604,10,100,1e-05,0.01,0.988,0.9941690962099126,4766,4838
2,9704,10,100,1e-05,0.01,0.976,0.9935078318219291,4810,4894
2,9804,10,100,1e-05,0.01,0.986,0.994390044879641,4859,4945
2,9904,10,100,1e-05,0.01,0.992,0.9991922455573505,4908,4996
2,10004,10,100,1e-05,0.01,0.992,0.9997001199520192,4959,5045
2,10104,10,100,1e-05,0.01,0.996,0.9990102929532858,5005,5099
2,10204,10,100,1e-05,0.01,0.994,0.9995099960799686,5057,5147
2,10304,10,100,1e-05,0.01,0.996,0.999902950310559,5107,5197
2,10404,10,100,1e-05,0.01,0.994,0.9997116493656286,5155,5249
2,10504,10,100,1e-05,0.01,0.994,1.0,5203,5301
2,10604,10,100,1e-05,0.01,0.994,0.9986797434930215,5249,5355
2,10704,10,100,1e-05,0.01,0.992,1.0,5300,5404
2,10804,10,100,1e-05,0.01,0.994,1.0,5353,5451
2,10904,10,100,1e-05,0.01,0.996,1.0,5401,5503
2,11004,10,100,1e-05,0.01,0.992,1.0,5450,5554
2,11104,10,100,1e-05,0.01,0.994,1.0,5494,5610
2,11204,10,100,1e-05,0.01,0.994,0.9995537308104249,5543,5661
2,11304,10,100,1e-05,0.01,0.992,0.9988499646142959,5601,5703
2,11404,10,100,1e-05,0.01,0.988,0.9900035075412136,5653,5751
2,11504,10,100,1e-05,0.01,0.99,0.9943497913769124,5716,5788
2,11604,10,100,1e-05,0.01,0.996,0.9936228886590831,5770,5834
2,11704,10,100,1e-05,0.01,0.994,0.9985475051264525,5820,5884
2,11804,10,100,1e-05,0.01,0.994,0.9987292443239579,5865,5939
2,11904,10,100,1e-05,0.01,0.996,0.9991599462365591,5918,5986
2,12004,10,100,1e-05,0.01,0.996,0.9993335554815062,5978,6026
2,12104,10,100,1e-05,0.01,0.994,0.9996695307336417,6024,6080
2,12204,10,100,1e-05,0.01,0.996,0.9998361193051458,6082,6122
2,12304,10,100,1e-05,0.01,0.994,0.9993498049414824,6133,6171
2,12404,10,100,1e-05,0.01,0.998,0.9999193808448887,6186,6218
2,12504,10,100,1e-05,0.01,0.994,0.9999200255918106,6234,6270
2,12604,10,100,1e-05,0.01,0.996,0.9998413202158045,6280,6324
2,12704,10,100,1e-05,0.01,0.996,1.0,6337,6367
2,12804,10,100,1e-05,0.01,0.996,1.0,6395,6409
2,12904,10,100,1e-05,0.01,0.99,0.9989925604463732,6437,6467
2,13004,10,100,1e-05,0.01,0.996,0.9969240233774224,6486,6518
2,13104,10,100,1e-05,0.01,0.998,0.9984737484737485,6532,6572
2,13204,10,100,1e-05,0.01,0.996,0.997046349591033,6586,6618
2,13304,10,100,1e-05,0.01,0.996,0.9985718580877931,6639,6665
2,13404,10,100,1e-05,0.01,0.992,0.9962697702178455,6681,6723
2,13504,10,100,1e-05,0.01,0.994,0.9985189573459715,6729,6775
2,13604,10,100,1e-05,0.01,0.992,0.9963246104087033,6785,6819
2,13704,10,100,1e-05,0.01,0.99,0.9976649153531816,6839,6865
2,13804,10,100,1e-05,0.01,0.992,0.9966676325702695,6888,6916
2,13904,10,100,1e-05,0.01,0.994,0.9994965477560415,6944,6960
2,14004,10,100,1e-05,0.01,0.998,1.0,7000,7004
2,14104,10,100,1e-05,0.01,0.998,0.9999290981281905,7040,7064
2,14204,10,100,1e-05,0.01,0.998,1.0,7091,7113
2,14304,10,100,1e-05,0.01,0.998,1.0,7146,7158
2,14404,10,100,1e-05,0.01,0.998,1.0,7194,7210
2,14504,10,100,1e-05,0.01,0.998,1.0,7252,7252
2,14604,10,100,1e-05,0.01,0.998,1.0,7301,7303
2,14704,10,100,1e-05,0.01,0.998,1.0,7356,7348
2,14804,10,100,1e-05,0.01,0.998,1.0,7406,7398
2,14904,10,100,1e-05,0.01,0.998,0.9997316156736447,7451,7453
2,15004,10,100,1e-05,0.01,0.998,0.9999333511063716,7498,7506
3,104,10,100,1e-05,0.01,0.494,0.49038461538461536,55,49
3,204,10,100,1e-05,0.01,0.498,0.696078431372549,93,111
3,304,10,100,1e-05,0.01,0.524,0.6611842105263158,148,156
3,404,10,100,1e-05,0.01,0.53,0.655940594059406,205,199
3,504,10,100,1e-05,0.01,0.52,0.6150793650793651,247,257
3,604,10,100,1e-05,0.01,0.514,0.640728476821192,298,306
3,704,10,100,1e-05,0.01,0.508,0.6448863636363636,363,341
3,804,10,100,1e-05,0.01,0.514,0.6728855721393034,406,398
3,904,10,100,1e-05,0.01,0.49,0.6803097345132744,459,445
3,1004,10,100,1e-05,0.01,0.528,0.6404382470119522,506,498
3,1104,10,100,1e-05,0.01,0.5,0.6503623188405797,561,543
3,1204,10,100,1e-05,0.01,0.496,0.6694352159468439,605,599
3,1304,10,100,1e-05,0.01,0.506,0.7032208588957055,655,649
3,1404,10,100,1e-05,0.01,0.5,0.7250712250712251,711,693
3,1504,10,100,1e-05,0.01,0.53,0.7340425531914894,752,752
3,1604,10,100,1e-05,0.01,0.54,0.7518703241895262,805,799
3,1704,10,100,1e-05,0.01,0.538,0.7224178403755869,862,842
3,1804,10,100,1e-05,0.01,0.556,0.7433481152993349,918,886
3,1904,10,100,1e-05,0.01,0.558,0.7641806722689075,967,937
3,2004,10,100,1e-05,0.01,0.586,0.8063872255489022,1027,977
3,2104,10,100,1e-05,0.01,0.61,0.8008555133079848,1080,1024
3,2204,10,100,1e-05,0.01,0.62,0.852087114337568,1138,1066
3,2304,10,100,1e-05,0.01,0.626,0.8502604166666666,1187,1117
3,2404,10,100,1e-05,0.01,0.66,0.877287853577371,1236,1168
3,2504,10,100,1e-05,0.01,0.684,0.8634185303514377,1284,1220
3,2604,10,100,1e-05,0.01,0.694,0.8978494623655914,1335,1269
3,2704,10,100,1e-05,0.01,0.724,0.915680473372781,1393,1311
3,2804,10,100,1e-05,0.01,0.746,0.9290299572039943,1444,1360
3,2904,10,100,1e-05,0.01,0.79,0.9369834710743802,1495,1409
3,3004,10,100,1e-05,0.01,0.796,0.9374167776298269,1544,1460
3,3104,10,100,1e-05,0.01,0.762,0.9407216494845361,1592,1512
3,3204,10,100,1e-05,0.01,0.812,0.9697253433208489,1641,1563
3,3304,10,100,1e-05,0.01,0.822,0.9769975786924939,1684,1620
3,3404,10,100,1e-05,0.01,0.84,0.9850176263219741,1731,1673
3,3504,10,100,1e-05,0.01,0.83,0.978310502283105,1787,1717
3,3604,10,100,1e-05,0.01,0.85,0.9836293007769146,1832,1772
3,3704,10,100,1e-05,0.01,0.876,0.990280777537797,1877,1827
3,3804,10,100,1e-05,0.01,0.87,0.9865930599369085,1926,1878
3,3904,10,100,1e-05,0.01,0.866,0.9838627049180327,1966,1938
3,4004,10,100,1e-05,0.01,0.878,0.9887612387612388,2014,1990
3,4104,10,100,1e-05,0.01,0.892,0.9917153996101364,2063,2041
3,4204,10,100,1e-05,0.01,0.882,0.9976213130352045,2103,2101
3,4304,10,100,1e-05,0.01,0.9,0.9983736059479554,2144,2160
3,4404,10,100,1e-05,0.01,0.902,0.9965940054495913,2195,2209
3,4504,10,100,1e-05,0.01,0.884,0.9833481349911191,2251,2253
3,4604,10,100,1e-05,0.01,0.888,0.9641615986099045,2304,2300
3,4704,10,100,1e-05,0.01,0.9,0.9800170068027211,2353,2351
3,4804,10,100,1e-05,0.01,0.91,0.992714404662781,2409,2395
3,4904,10,100,1e-05,0.01,0.916,0.9942903752039152,2460,2444
3,5004,10,100,1e-05,0.01,0.924,0.9990007993605116,2515,2489
3,5104,10,100,1e-05,0.01,0.93,0.9992163009404389,2563,2541
3,5204,10,100,1e-05,0.01,0.928,0.9990392006149116,2614,2590
3,5304,10,100,1e-05,0.01,0.92,0.9996229260935143,2665,2639
3,5404,10,100,1e-05,0.01,0.93,0.9996299037749815,2715,2689
3,5504,10,100,1e-05,0.01,0.924,1.0,2762,2742
3,5604,10,100,1e-05,0.01,0.94,0.9998215560314061,2816,2788
3,5704,10,100,1e-05,0.01,0.93,0.998422159887798,2865,2839
3,5804,10,100,1e-05,0.01,0.948,0.9991385251550655,2912,2892
3,5904,10,100,1e-05,0.01,0.944,0.9989837398373984,2963,2941
3,6004,10,100,1e-05,0.01,0.924,0.9936708860759493,3011,2993
3,6104,10,100,1e-05,0.01,0.906,0.9701834862385321,3059,3045
3,6204,10,100,1e-05,0.01,0.95,0.9785622179239201,3109,3095
3,6304,10,100,1e-05,0.01,0.958,0.9950824873096447,3162,3142
3,6404,10,100,1e-05,0.01,0.96,0.9982823235477827,3213,3191
3,6504,10,100,1e-05,0.01,0.96,0.9990774907749077,3258,3246
3,6604,10,100,1e-05,0.01,0.964,0.9996971532404604,3306,3298
3,6704,10,100,1e-05,0.01,0.964,0.9992541766109785,3349,3355
3,6804,10,100,1e-05,0.01,0.968,0.9997060552616108,3398,3406
3,6904,10,100,1e-05,0.01,0.97,0.9992757821552724,3447,3457
3,7004,10,100,1e-05,0.01,0.966,0.9997144488863506,3494,3510
3,7104,10,100,1e-05,0.01,0.966,0.9905686936936937,3551,3553
3,7204,10,100,1e-05,0.01,0.974,0.9980566352026652,3603,3601
3,7304,10,100,1e-05,0.01,0.966,0.9997261774370209,3658,3646
3,7404,10,100,1e-05,0.01,0.97,1.0,3714,3690
3,7504,10,100,1e-05,0.01,0.966,0.9998667377398721,3758,3746
3,7604,10,100,1e-05,0.01,0.954,0.9938190426091531,3807,3797
3,7704,10,100,1e-05,0.01,0.95,0.9913032191069574,3862,3842
3,7804,10,100,1e-05,0.01,0.96,0.9925679138903126,3915,3889
3,7904,10,100,1e-05,0.01,0.96,0.9906376518218624,3965,3939
3,8004,10,100,1e-05,0.01,0.972,0.993503248375812,4017,3987
3,8104,10,100,1e-05,0.01,0.97,0.9987660414610069,4062,4042
3,8204,10,100,1e-05,0.01,0.974,0.9958556801560214,4119,4085
3,8304,10,100,1e-05,0.01,0.972,0.9986753371868978,4167,4137
3,8404,10,100,1e-05,0.01,0.982,0.9996430271299381,4212,4192
3,8504,10,100,1e-05,0.01,0.98,0.9995296331138288,4257,4247
3,8604,10,100,1e-05,0.01,0.98,1.0,4304,4300
3,8704,10,100,1e-05,0.01,0.98,1.0,4352,4352
3,8804,10,100,1e-05,0.01,0.982,1.0,4406,4398
3,8904,10,100,1e-05,0.01,0.986,0.9978661275831087,4457,4447
3,9004,10,100,1e-05,0.01,0.982,0.9954464682363394,4509,4495
3,9104,10,100,1e-05,0.01,0.974,0.9903339191564148,4548,4556
3,9204,10,100,1e-05,0.01,0.978,0.9957627118644068,4600,4604
3,9304,10,100,1e-05,0.01,0.97,0.9938736027515047,4646,4658
3,9404,10,100,1e-05,0.01,0.98,0.9945767758400681,4693,4711
3,9504,10,100,1e-05,0.01,0.982,0.9976851851851852,4748,4756
3,9604,10,100,1e-05,0.01,0.982,0.9987505206164098,4794,4810
3,9704,10,100,1e-05,0.01,0.996,0.9987633965375103,4844,4860
3,9804,10,100,1e-05,0.01,0.97,0.9939820481436149,4896,4908
3,9904,10,100,1e-05,0.01,0.972,0.9963651050080775,4944,4960
3,10004,10,100,1e-05,0.01,0.98,0.9957017193122751,4993,5011
3,10104,10,100,1e-05,0.01,0.986,0.9990102929532858,5036,5068
3,10204,10,100,1e-05,0.01,0.986,0.9961779694237554,5084,5120
3,10304,10,100,1e-05,0.01,0.982,0.9967973602484472,5137,5167
3,10404,10,100,1e-05,0.01,0.986,0.9987504805843906,5191,5213
3,10504,10,100,1e-05,0.01,0.99,1.0,5239,5265
3,10604,10,100,1e-05,0.01,0.992,0.9998113919275745,5288,5316
3,10704,10,100,1e-05,0.01,0.988,0.9961696562032885,5339,5365
3,10804,10,100,1e-05,0.01,0.994,0.9990744168826361,5387,5417
3,10904,10,100,1e-05,0.01,0.984,0.996606749816581,5431,5473
3,11004,10,100,1e-05,0.01,0.988,0.9988186114140313,5492,5512
3,11104,10,100,1e-05,0.01,0.99,0.9986491354466859,5545,5559
3,11204,10,100,1e-05,0.01,0.97,0.9817029632274188,5594,5610
3,11304,10,100,1e-05,0.01,0.98,0.9952229299363057,5643,5661
3,11404,10,100,1e-05,0.01,0.982,0.9968432129077517,5690,5714
3,11504,10,100,1e-05,0.01,0.992,0.9996522948539638,5739,5765
3,11604,10,100,1e-05,0.01,0.996,0.999741468459152,5794,5810
3,11704,10,100,1e-05,0.01,0.996,1.0,5847,5857
3,11804,10,100,1e-05,0.01,0.994,1.0,5897,5907
3,11904,10,100,1e-05,0.01,0.996,0.9999159946236559,5943,5961
3,12004,10,100,1e-05,0.01,0.994,1.0,5977,6027
3,12104,10,100,1e-05,0.01,0.994,1.0,6031,6073
3,12204,10,100,1e-05,0.01,0.994,0.998852835136021,6082,6122
3,12304,10,100,1e-05,0.01,0.994,0.9999187256176854,6133,6171
3,12404,10,100,1e-05,0.01,0.992,0.9981457594324411,6192,6212
3,12504,10,100,1e-05,0.01,0.986,0.9994401791426744,6245,6259
3,12604,10,100,1e-05,0.01,0.99,0.9946842272294509,6303,6301
3,12704,10,100,1e-05,0.01,0.992,0.9992128463476071,6352,6352
3,12804,10,100,1e-05,0.01,0.99,0.9983598875351453,6399,6405
3,12904,10,100,1e-05,0.01,0.994,0.9986050836949782,6453,6451
3,13004,10,100,1e-05,0.01,0.994,0.9977699169486312,6508,6496
3,13104,10,100,1e-05,0.01,0.99,0.9992368742368742,6555,6549
3,13204,10,100,1e-05,0.01,0.996,0.999924265374129,6601,6603
3,13304,10,100,1e-05,0.01,0.994,1.0,6648,6656
3,13404,10,100,1e-05,0.01,0.996,1.0,6692,6712
3,13504,10,100,1e-05,0.01,0.996,1.0,6740,6764
3,13604,10,100,1e-05,0.01,0.996,1.0,6793,6811
3,13704,10,100,1e-05,0.01,0.986,0.9975189725627553,6839,6865
3,13804,10,100,1e-05,0.01,0.994,0.9992031295276731,6888,6916
3,13904,10,100,1e-05,0.01,0.984,0.9933831990794016,6937,6967
3,14004,10,100,1e-05,0.01,0.99,0.9974293059125964,6990,7014
3,14104,10,100,1e-05,0.01,0.998,0.9994327850255247,7032,7072
3,14204,10,100,1e-05,0.01,0.998,1.0,7089,7115
3,14304,10,100,1e-05,0.01,0.996,1.0,7136,7168
3,14404,10,100,1e-05,0.01,0.996,1.0,7180,7224
3,14504,10,100,1e-05,0.01,0.996,1.0,7234,7270
3,14604,10,100,1e-05,0.01,0.996,0.9997945768282662,7282,7322
3,14704,10,100,1e-05,0.01,0.998,0.9993199129488575,7329,7375
3,14804,10,100,1e-05,0.01,0.998,0.9988516617130505,7390,7414
3,14904,10,100,1e-05,0.01,0.988,0.9931561996779388,7448,7456
3,15004,10,100,1e-05,0.01,0.992,0.9972007464676086,7498,7506
4,104,10,100,1e-05,0.01,0.492,0.5288461538461539,55,49
4,204,10,100,1e-05,0.01,0.504,0.6519607843137255,99,105
4,304,10,100,1e-05,0.01,0.52,0.5723684210526315,144,160
4,404,10,100,1e-05,0.01,0.496,0.6460396039603961,198,206
4,504,10,100,1e-05,0.01,0.508,0.6349206349206349,251,253
4,604,10,100,1e-05,0.01,0.526,0.6324503311258278,292,312
4,704,10,100,1e-05,0.01,0.516,0.6264204545454546,337,367
4,804,10,100,1e-05,0.01,0.478,0.654228855721393,393,411
4,904,10,100,1e-05,0.01,0.512,0.6648230088495575,436,468
4,1004,10,100,1e-05,0.01,0.516,0.6643426294820717,486,518
4,1104,10,100,1e-05,0.01,0.528,0.6956521739130435,536,568
4,1204,10,100,1e-05,0.01,0.53,0.7009966777408638,586,618
4,1304,10,100,1e-05,0.01,0.518,0.6817484662576687,643,661
4,1404,10,100,1e-05,0.01,0.514,0.7001424501424501,705,699
4,1504,10,100,1e-05,0.01,0.516,0.7074468085106383,757,747
4,1604,10,100,1e-05,0.01,0.5,0.736284289276808,809,795
4,1704,10,100,1e-05,0.01,0.506,0.7224178403755869,856,848
4,1804,10,100,1e-05,0.01,0.528,0.7455654101995566,910,894
4,1904,10,100,1e-05,0.01,0.506,0.7022058823529411,969,935
4,2004,10,100,1e-05,0.01,0.52,0.719061876247505,1035,969
4,2104,10,100,1e-05,0.01,0.51,0.7495247148288974,1087,1017
4,2204,10,100,1e-05,0.01,0.55,0.7813067150635209,1143,1061
4,2304,10,100,1e-05,0.01,0.542,0.8159722222222222,1189,1115
4,2404,10,100,1e-05,0.01,0.52,0.8361064891846922,1244,1160
4,2504,10,100,1e-05,0.01,0.546,0.810702875399361,1284,1220
4,2604,10,100,1e-05,0.01,0.568,0.8440860215053764,1343,1261
4,2704,10,100,1e-05,0.01,0.554,0.8735207100591716,1403,1301
4,2804,10,100,1e-05,0.01,0.568,0.8141940085592011,1456,1348
4,2904,10,100,1e-05,0.01,0.576,0.8539944903581267,1504,1400
4,3004,10,100,1e-05,0.01,0.608,0.8861517976031957,1549,1455
4,3104,10,100,1e-05,0.01,0.6,0.8985180412371134,1601,1503
4,3204,10,100,1e-05,0.01,0.644,0.931960049937578,1657,1547
4,3304,10,100,1e-05,0.01,0.686,0.9322033898305084,1709,1595
4,3404,10,100,1e-05,0.01,0.684,0.950940070505288,1753,1651
4,3504,10,100,1e-05,0.01,0.718,0.9600456621004566,1812,1692
4,3604,10,100,1e-05,0.01,0.744,0.9630965593784684,1866,1738
4,3704,10,100,1e-05,0.01,0.752,0.9732721382289417,1922,1782
4,3804,10,100,1e-05,0.01,0.774,0.9689800210304942,1982,1822
4,3904,10,100,1e-05,0.01,0.748,0.9715676229508197,2036,1868
4,4004,10,100,1e-05,0.01,0.798,0.9667832167832168,2081,1923
4,4104,10,100,1e-05,0.01,0.776,0.9346978557504874,2134,1970
4,4204,10,100,1e-05,0.01,0.782,0.9638439581351094,2189,2015
4,4304,10,100,1e-05,0.01,0.808,0.95817843866171,2228,2076
4,4404,10,100,1e-05,0.01,0.836,0.9786557674841053,2277,2127
4,4504,10,100,1e-05,0.01,0.856,0.9904529307282416,2325,2179
4,4604,10,100,1e-05,0.01,0.824,0.9784969591659427,2372,2232
4,4704,10,100,1e-05,0.01,0.856,0.9583333333333334,2422,2282
4,4804,10,100,1e-05,0.01,0.868,0.9787676935886761,2471,2333
4,4904,10,100,1e-05,0.01,0.868,0.9900081566068516,2521,2383
4,5004,10,100,1e-05,0.01,0.884,0.9954036770583533,2573,2431
4,5104,10,100,1e-05,0.01,0.878,0.9970611285266457,2619,2485
4,5204,10,100,1e-05,0.01,0.888,0.9948116833205227,2667,2537
4,5304,10,100,1e-05,0.01,0.9,0.9945324283559578,2722,2582
4,5404,10,100,1e-05,0.01,0.886,0.9974093264248705,2767,2637
4,5504,10,100,1e-05,0.01,0.89,0.997093023255814,2826,2678
4,5604,10,100,1e-05,0.01,0.902,0.9958957887223412,2875,2729
4,5704,10,100,1e-05,0.01,0.902,0.9973702664796634,2932,2772
4,5804,10,100,1e-05,0.01,0.902,0.9950034458993797,2981,2823
4,5904,10,100,1e-05,0.01,0.918,0.988990514905149,3032,2872
4,6004,10,100,1e-05,0.01,0.918,0.9918387741505663,3079,2925
4,6104,10,100,1e-05,0.01,0.93,0.9934469200524246,3129,2975
4,6204,10,100,1e-05,0.01,0.934,0.9929078014184397,3174,3030
4,6304,10,100,1e-05,0.01,0.924,0.9931789340101523,3218,3086
4,6404,10,100,1e-05,0.01,0.93,0.990318550905684,3278,3126
4,6504,10,100,1e-05,0.01,0.924,0.9867773677736777,3331,3173
4,6604,10,100,1e-05,0.01,0.936,0.9947001817080557,3382,3222
4,6704,10,100,1e-05,0.01,0.93,0.9955250596658711,3433,3271
4,6804,10,100,1e-05,0.01,0.948,0.9964726631393298,3478,3326
4,6904,10,100,1e-05,0.01,0.942,0.9973928157589803,3531,3373
4,7004,10,100,1e-05,0.01,0.95,0.9992861222158766,3582,3422
4,7104,10,100,1e-05,0.01,0.956,0.9990146396396397,3623,3481
4,7204,10,100,1e-05,0.01,0.962,0.999305941143809,3670,3534
4,7304,10,100,1e-05,0.01,0.958,0.9987677984665937,3713,3591
4,7404,10,100,1e-05,0.01,0.95,0.9975688816855753,3759,3645
4,7504,10,100,1e-05,0.01,0.948,0.9957356076759062,3806,3698
4,7604,10,100,1e-05,0.01,0.952,0.9969752761704366,3864,3740
4,7704,10,100,1e-05,0.01,0.952,0.9974039460020768,3914,3790
4,7804,10,100,1e-05,0.01,0.944,0.993208610968734,3960,3844
4,7904,10,100,1e-05,0.01,0.926,0.9773532388663968,4005,3899
4,8004,10,100,1e-05,0.01,0.954,0.992503748125937,4048,3956
4,8104,10,100,1e-05,0.01,0.952,0.9944471865745311,4101,4003
4,8204,10,100,1e-05,0.01,0.96,0.9974402730375427,4151,4053
4,8304,10,100,1e-05,0.01,0.964,0.9991570327552987,4200,4104
4,8404,10,100,1e-05,0.01,0.966,0.9997620180866255,4251,4153
4,8504,10,100,1e-05,0.01,0.958,0.9975305738476011,4304,4200
4,8604,10,100,1e-05,0.01,0.958,0.9959321245932125,4353,4251
4,8704,10,100,1e-05,0.01,0.97,0.9979319852941176,4410,4294
4,8804,10,100,1e-05,0.01,0.956,0.9960245343025897,4460,4344
4,8904,10,100,1e-05,0.01,0.97,0.9957322551662174,4511,4393
4,9004,10,100,1e-05,0.01,0.964,0.9992225677476677,4552,4452
4,9104,10,100,1e-05,0.01,0.974,0.99945079086116,4610,4494
4,9204,10,100,1e-05,0.01,0.96,0.9971751412429378,4660,4544
4,9304,10,100,1e-05,0.01,0.972,0.9964531384350817,4707,4597
4,9404,10,100,1e-05,0.01,0.956,0.9943641003828159,4749,4655
4,9504,10,100,1e-05,0.01,0.954,0.9947390572390572,4804,4700
4,9604,10,100,1e-05,0.01,0.962,0.993856726364015,4858,4746
4,9704,10,100,1e-05,0.01,0.962,0.9936108821104699,4901,4803
4,9804,10,100,1e-05,0.01,0.96,0.9922480620155039,4950,4854
4,9904,10,100,1e-05,0.01,0.972,0.9968699515347335,5005,4899
4,10004,10,100,1e-05,0.01,0.978,0.9953018792483007,5053,4951
4,10104,10,100,1e-05,0.01,0.96,0.9947545526524149,5100,5004
4,10204,10,100,1e-05,0.01,0.954,0.9937279498235986,5159,5045
4,10304,10,100,1e-05,0.01,0.97,0.9966032608695652,5201,5103
4,10404,10,100,1e-05,0.01,0.976,0.9992310649750096,5250,5154
4,10504,10,100,1e-05,0.01,0.98,0.9995239908606245,5293,5211
4,10604,10,100,1e-05,0.01,0.976,0.9998113919275745,5336,5268
4,10704,10,100,1e-05,0.01,0.974,0.9985052316890882,5385,5319
4,10804,10,100,1e-05,0.01,0.976,0.9994446501295816,5436,5368
4,10904,10,100,1e-05,0.01,0.976,0.9999082905355833,5482,5422
4,11004,10,100,1e-05,0.01,0.978,0.9996364958197019,5527,5477
4,11104,10,100,1e-05,0.01,0.98,0.9999099423631124,5579,5525
4,11204,10,100,1e-05,0.01,0.982,0.9988397001071047,5642,5562
4,11304,10,100,1e-05,0.01,0.974,0.9998230714791224,5691,5613
4,11404,10,100,1e-05,0.01,0.976,0.9993861802876184,5738,5666
4,11504,10,100,1e-05,0.01,0.972,0.9946105702364395,5787,5717
4,11604,10,100,1e-05,0.01,0.97,0.9896587383660806,5831,5773
4,11704,10,100,1e-05,0.01,0.974,0.9895762132604238,5876,5828
4,11804,10,100,1e-05,0.01,0.968,0.9955947136563876,5931,5873
4,11904,10,100,1e-05,0.01,0.978,0.9985719086021505,5976,5928
4,12004,10,100,1e-05,0.01,0.98,0.9986671109630123,6024,5980
4,12104,10,100,1e-05,0.01,0.984,0.9995042961004627,6078,6026
4,12204,10,100,1e-05,0.01,0.984,0.9994264175680105,6129,6075
4,12304,10,100,1e-05,0.01,0.976,0.9991872561768531,6174,6130
4,12404,10,100,1e-05,0.01,0.986,1.0,6222,6182
4,12504,10,100,1e-05,0.01,0.984,0.9998400511836213,6266,6238
4,12604,10,100,1e-05,0.01,0.984,0.9999206601079023,6316,6288
4,12704,10,100,1e-05,0.01,0.988,0.9998425692695214,6353,6351
4,12804,10,100,1e-05,0.01,0.984,0.9993751952514839,6404,6400
4,12904,10,100,1e-05,0.01,0.99,0.9987600743955363,6448,6456
4,13004,10,100,1e-05,0.01,0.984,0.9971547216241157,6501,6503
4,13104,10,100,1e-05,0.01,0.98,0.9954212454212454,6551,6553
4,13204,10,100,1e-05,0.01,0.976,0.9951529839442593,6597,6607
4,13304,10,100,1e-05,0.01,0.984,0.9975195429945881,6646,6658
4,13404,10,100,1e-05,0.01,0.948,0.9838854073410922,6698,6706
4,13504,10,100,1e-05,0.01,0.976,0.9973341232227488,6748,6756
4,13604,10,100,1e-05,0.01,0.98,0.9978682740370479,6807,6797
4,13704,10,100,1e-05,0.01,0.98,0.9967162872154116,6853,6851
4,13804,10,100,1e-05,0.01,0.982,0.9995653433787308,6906,6898
4,13904,10,100,1e-05,0.01,0.986,1.0,6962,6942
4,14004,10,100,1e-05,0.01,0.986,1.0,7012,6992
4,14104,10,100,1e-05,0.01,0.984,0.9992909812819059,7062,7042
4,14204,10,100,1e-05,0.01,0.988,0.9995071810757533,7107,7097
4,14304,10,100,1e-05,0.01,0.984,0.9992309843400448,7151,7153
4,14404,10,100,1e-05,0.01,0.984,0.9986809219661206,7204,7200
4,14504,10,100,1e-05,0.01,0.98,0.996207942636514,7260,7244
4,14604,10,100,1e-05,0.01,0.986,0.9976718707203506,7311,7293
4,14704,10,100,1e-05,0.01,0.984,0.9980957562568009,7359,7345
4,14804,10,100,1e-05,0.01,0.988,0.9995947041340179,7405,7399
4,14904,10,100,1e-05,0.01,0.988,0.9994632313472893,7458,7446
4,15004,10,100,1e-05,0.01,0.992,0.9998000533191149,7507,7497
5,104,10,100,1e-05,0.01,0.464,0.5961538461538461,42,62
5,204,10,100,1e-05,0.01,0.438,0.6274509803921569,100,104
5,304,10,100,1e-05,0.01,0.522,0.6217105263157895,158,146
5,404,10,100,1e-05,0.01,0.492,0.6361386138613861,208,196
5,504,10,100,1e-05,0.01,0.458,0.5535714285714286,252,252
5,604,10,100,1e-05,0.01,0.458,0.6026490066225165,302,302
5,704,10,100,1e-05,0.01,0.498,0.609375,358,346
5,804,10,100,1e-05,0.01,0.492,0.6218905472636815,407,397
5,904,10,100,1e-05,0.01,0.46,0.6006637168141593,449,455
5,1004,10,100,1e-05,0.01,0.516,0.651394422310757,496,508
5,1104,10,100,1e-05,0.01,0.478,0.6394927536231884,544,560
5,1204,10,100,1e-05,0.01,0.512,0.659468438538206,591,613
5,1304,10,100,1e-05,0.01,0.482,0.6664110429447853,641,663
5,1404,10,100,1e-05,0.01,0.486,0.6524216524216524,687,717
5,1504,10,100,1e-05,0.01,0.508,0.6894946808510638,735,769
5,1604,10,100,1e-05,0.01,0.522,0.6951371571072319,785,819
5,1704,10,100,1e-05,0.01,0.52,0.6983568075117371,828,876
5,1804,10,100,1e-05,0.01,0.538,0.7222838137472284,873,931
5,1904,10,100,1e-05,0.01,0.554,0.7169117647058824,914,990
5,2004,10,100,1e-05,0.01,0.592,0.7360279441117764,971,1033
5,2104,10,100,1e-05,0.01,0.542,0.7376425855513308,1015,1089
5,2204,10,100,1e-05,0.01,0.624,0.7776769509981851,1071,1133
5,2304,10,100,1e-05,0.01,0.608,0.7842881944444444,1126,1178
5,2404,10,100,1e-05,0.01,0.626,0.7903494176372712,1174,1230
5,2504,10,100,1e-05,0.01,0.65,0.7915335463258786,1223,1281
5,2604,10,100,1e-05,0.01,0.694,0.8241167434715821,1267,1337
5,2704,10,100,1e-05,0.01,0.706,0.8365384615384616,1318,1386
5,2804,10,100,1e-05,0.01,0.76,0.8580599144079886,1371,1433
5,2904,10,100,1e-05,0.01,0.75,0.8794765840220385,1419,1485
5,3004,10,100,1e-05,0.01,0.78,0.888814913448735,1475,1529
5,3104,10,100,1e-05,0.01,0.776,0.9056056701030928,1529,1575
5,3204,10,100,1e-05,0.01,0.782,0.8938826466916354,1571,1633
5,3304,10,100,1e-05,0.01,0.786,0.899818401937046,1628,1676
5,3404,10,100,1e-05,0.01,0.77,0.8910105757931844,1679,1725
5,3504,10,100,1e-05,0.01,0.816,0.9240867579908676,1734,1770
5,3604,10,100,1e-05,0.01,0.826,0.9242508324084351,1779,1825
5,3704,10,100,1e-05,0.01,0.844,0.9584233261339092,1826,1878
5,3804,10,100,1e-05,0.01,0.834,0.9442691903259727,1878,1926
5,3904,10,100,1e-05,0.01,0.844,0.9569672131147541,1928,1976
5,4004,10,100,1e-05,0.01,0.844,0.9495504495504495,1973,2031
5,4104,10,100,1e-05,0.01,0.834,0.9315302144249513,2025,2079
5,4204,10,100,1e-05,0.01,0.852,0.9545670789724072,2077,2127
5,4304,10,100,1e-05,0.01,0.848,0.9484200743494424,2125,2179
5,4404,10,100,1e-05,0.01,0.856,0.9582198001816531,2174,2230
5,4504,10,100,1e-05,0.01,0.874,0.9793516873889876,2232,2272
5,4604,10,100,1e-05,0.01,0.878,0.9724152910512598,2285,2319
5,4704,10,100,1e-05,0.01,0.892,0.9795918367346939,2338,2366
5,4804,10,100,1e-05,0.01,0.868,0.9748126561199001,2376,2428
5,4904,10,100,1e-05,0.01,0.89,0.9879690048939641,2423,2481
5,5004,10,100,1e-05,0.01,0.864,0.9828137490007993,2477,2527
5,5104,10,100,1e-05,0.01,0.878,0.9825626959247649,2533,2571
5,5204,10,100,1e-05,0.01,0.896,0.9846272098385856,2580,2624
5,5304,10,100,1e-05,0.01,0.896,0.9868024132730016,2629,2675
5,5404,10,100,1e-05,0.01,0.876,0.9776091783863805,2679,2725
5,5504,10,100,1e-05,0.01,0.9,0.9845566860465116,2737,2767
5,5604,10,100,1e-05,0.01,0.902,0.9789436117059244,2791,2813
5,5704,10,100,1e-05,0.01,0.864,0.9568723702664796,2839,2865
5,5804,10,100,1e-05,0.01,0.886,0.9701929703652653,2878,2926
5,5904,10,100,1e-05,0.01,0.908,0.9854336043360433,2933,2971
5,6004,10,100,1e-05,0.01,0.916,0.9871752165223184,2991,3013
5,6104,10,100,1e-05,0.01,0.906,0.9950851900393185,3043,3061
5,6204,10,100,1e-05,0.01,0.91,0.9922630560928434,3091,3113
5,6304,10,100,1e-05,0.01,0.904,0.9815989847715736,3142,3162
5,6404,10,100,1e-05,0.01,0.902,0.9865708931917552,3198,3206
5,6504,10,100,1e-05,0.01,0.906,0.9898523985239852,3246,3258
5,6604,10,100,1e-05,0.01,0.91,0.9881889763779528,3303,3301
5,6704,10,100,1e-05,0.01,0.91,0.9885143198090692,3346,3358
5,6804,10,100,1e-05,0.01,0.84,0.9159318048206937,3397,3407
5,6904,10,100,1e-05,0.01,0.87,0.8946987253765932,3444,3460
5,7004,10,100,1e-05,0.01,0.914,0.9470302684180468,3489,3515
5,7104,10,100,1e-05,0.01,0.942,0.9740990990990991,3538,3566
5,7204,10,100,1e-05,0.01,0.942,0.9854247640199889,3592,3612
5,7304,10,100,1e-05,0.01,0.93,0.9782311062431545,3641,3663
5,7404,10,100,1e-05,0.01,0.894,0.9496218260399784,3687,3717
5,7504,10,100,1e-05,0.01,0.924,0.9557569296375267,3730,3774
5,7604,10,100,1e-05,0.01,0.942,0.9764597580220936,3777,3827
5,7704,10,100,1e-05,0.01,0.932,0.9813084112149533,3834,3870
5,7804,10,100,1e-05,0.01,0.908,0.9490005125576627,3882,3922
5,7904,10,100,1e-05,0.01,0.934,0.9662196356275303,3935,3969
5,8004,10,100,1e-05,0.01,0.956,0.988255872063968,3992,4012
5,8104,10,100,1e-05,0.01,0.96,0.991609081934847,4037,4067
5,8204,10,100,1e-05,0.01,0.94,0.984397854705022,4084,4120
5,8304,10,100,1e-05,0.01,0.964,0.992533718689788,4139,4165
5,8404,10,100,1e-05,0.01,0.964,0.9933365064255116,4191,4213
5,8504,10,100,1e-05,0.01,0.962,0.9961194731890874,4243,4261
5,8604,10,100,1e-05,0.01,0.958,0.9962807996280799,4296,4308
5,8704,10,100,1e-05,0.01,0.97,0.9973575367647058,4351,4353
5,8804,10,100,1e-05,0.01,0.946,0.9833030440708769,4399,4405
5,8904,10,100,1e-05,0.01,0.958,0.9957322551662174,4449,4455
5,9004,10,100,1e-05,0.01,0.946,0.9860062194580187,4503,4501
5,9104,10,100,1e-05,0.01,0.948,0.9836335676625659,4549,4555
5,9204,10,100,1e-05,0.01,0.952,0.9892438070404173,4590,4614
5,9304,10,100,1e-05,0.01,0.968,0.9965606190885641,4634,4670
5,9404,10,100,1e-05,0.01,0.966,0.9952148022118248,4683,4721
5,9504,10,100,1e-05,0.01,0.966,0.9948442760942761,4732,4772
5,9604,10,100,1e-05,0.01,0.96,0.9907330279050396,4781,4823
5,9704,10,100,1e-05,0.01,0.968,0.9970115416323165,4834,4870
5,9804,10,100,1e-05,0.01,0.972,0.9944920440636474,4878,4926
5,9904,10,100,1e-05,0.01,0.976,0.9959612277867528,4935,4969
5,10004,10,100,1e-05,0.01,0.968,0.9968012794882047,4979,5025
5,10104,10,100,1e-05,0.01,0.966,0.9983174980205859,5016,5088
5,10204,10,100,1e-05,0.01,0.966,0.9970599764798118,5060,5144
5,10304,10,100,1e-05,0.01,0.972,0.9979619565217391,5125,5179
5,10404,10,100,1e-05,0.01,0.97,0.9998077662437524,5181,5223
5,10504,10,100,1e-05,0.01,0.972,0.9988575780654989,5223,5281
5,10604,10,100,1e-05,0.01,0.974,0.9964164466239155,5285,5319
5,10704,10,100,1e-05,0.01,0.97,0.9930866965620329,5342,5362
5,10804,10,100,1e-05,0.01,0.966,0.9917623102554609,5388,5416
5,10904,10,100,1e-05,0.01,0.972,0.9878026412325752,5438,5466
5,11004,10,100,1e-05,0.01,0.97,0.9943656852053798,5490,5514
5,11104,10,100,1e-05,0.01,0.974,0.997928674351585,5535,5569
5,11204,10,100,1e-05,0.01,0.982,0.9980364155658693,5586,5618
5,11304,10,100,1e-05,0.01,0.986,0.9992038216560509,5633,5671
5,11404,10,100,1e-05,0.01,0.98,0.9983339179235357,5678,5726
5,11504,10,100,1e-05,0.01,0.98,0.9982614742698191,5729,5775
5,11604,10,100,1e-05,0.01,0.982,0.9957773181661496,5794,5810
5,11704,10,100,1e-05,0.01,0.966,0.9902597402597403,5846,5858
5,11804,10,100,1e-05,0.01,0.982,0.9958488647915961,5905,5899
5,11904,10,100,1e-05,0.01,0.98,0.997059811827957,5962,5942
5,12004,10,100,1e-05,0.01,0.984,0.9971676107964011,6006,5998
5,12104,10,100,1e-05,0.01,0.986,0.99628222075347,6065,6039
5,12204,10,100,1e-05,0.01,0.986,0.9959849229760734,6118,6086
5,12304,10,100,1e-05,0.01,0.984,0.9982119635890767,6167,6137
5,12404,10,100,1e-05,0.01,0.974,0.9956465656239922,6215,6189
5,12504,10,100,1e-05,0.01,0.98,0.9951215611004478,6267,6237
5,12604,10,100,1e-05,0.01,0.98,0.9976991431291653,6316,6288
5,12704,10,100,1e-05,0.01,0.962,0.9815806045340051,6366,6338
5,12804,10,100,1e-05,0.01,0.988,0.9932052483598875,6414,6390
5,12904,10,100,1e-05,0.01,0.99,0.9991475511469312,6461,6443
5,13004,10,100,1e-05,0.01,0.99,0.9998462011688711,6509,6495
5,13104,10,100,1e-05,0.01,0.99,1.0,6556,6548
5,13204,10,100,1e-05,0.01,0.99,0.9996970614965162,6613,6591
5,13304,10,100,1e-05,0.01,0.988,0.9999248346361996,6665,6639
5,13404,10,100,1e-05,0.01,0.992,1.0,6721,6683
5,13504,10,100,1e-05,0.01,0.994,0.9997778436018957,6767,6737
5,13604,10,100,1e-05,0.01,0.988,0.9997059688326962,6820,6784
5,13704,10,100,1e-05,0.01,0.99,1.0,6864,6840
5,13804,10,100,1e-05,0.01,0.99,1.0,6911,6893
5,13904,10,100,1e-05,0.01,0.988,1.0,6953,6951
5,14004,10,100,1e-05,0.01,0.992,1.0,7002,7002
5,14104,10,100,1e-05,0.01,0.99,0.9998581962563812,7043,7061
5,14204,10,100,1e-05,0.01,0.992,0.9999295972965362,7094,7110
5,14304,10,100,1e-05,0.01,0.982,0.9952460850111857,7145,7159
5,14404,10,100,1e-05,0.01,0.96,0.985906692585393,7195,7209
5,14504,10,100,1e-05,0.01,0.982,0.9871070049641478,7245,7259
5,14604,10,100,1e-05,0.01,0.99,0.9973979731580389,7299,7305
5,14704,10,100,1e-05,0.01,0.99,0.9995919477693145,7345,7359
5,14804,10,100,1e-05,0.01,0.994,0.9989867603350446,7397,7407
5,14904,10,100,1e-05,0.01,0.988,0.9996645195920558,7436,7468
5,15004,10,100,1e-05,0.01,0.99,0.9999333511063716,7484,7520
6,104,10,100,1e-05,0.01,0.486,0.7115384615384616,56,48
6,204,10,100,1e-05,0.01,0.492,0.6078431372549019,110,94
6,304,10,100,1e-05,0.01,0.488,0.631578947368421,163,141
6,404,10,100,1e-05,0.01,0.51,0.6039603960396039,217,187
6,504,10,100,1e-05,0.01,0.51,0.6547619047619048,274,230
6,604,10,100,1e-05,0.01,0.498,0.6589403973509934,327,277
6,704,10,100,1e-05,0.01,0.474,0.6363636363636364,377,327
6,804,10,100,1e-05,0.01,0.486,0.650497512437811,427,377
6,904,10,100,1e-05,0.01,0.462,0.6393805309734514,478,426
6,1004,10,100,1e-05,0.01,0.468,0.6673306772908366,527,477
6,1104,10,100,1e-05,0.01,0.476,0.6630434782608695,578,526
6,1204,10,100,1e-05,0.01,0.49,0.6669435215946844,634,570
6,1304,10,100,1e-05,0.01,0.49,0.6871165644171779,680,624
6,1404,10,100,1e-05,0.01,0.548,0.7051282051282052,727,677
6,1504,10,100,1e-05,0.01,0.532,0.682845744680851,783,721
6,1604,10,100,1e-05,0.01,0.52,0.726932668329177,824,780
6,1704,10,100,1e-05,0.01,0.534,0.7171361502347418,887,817
6,1804,10,100,1e-05,0.01,0.522,0.7583148558758315,940,864
6,1904,10,100,1e-05,0.01,0.554,0.7794117647058824,993,911
6,2004,10,100,1e-05,0.01,0.544,0.7325349301397206,1047,957
6,2104,10,100,1e-05,0.01,0.562,0.7238593155893536,1112,992
6,2204,10,100,1e-05,0.01,0.556,0.7781306715063521,1156,1048
6,2304,10,100,1e-05,0.01,0.54,0.8198784722222222,1211,1093
6,2404,10,100,1e-05,0.01,0.592,0.8481697171381032,1259,1145
6,2504,10,100,1e-05,0.01,0.648,0.8785942492012779,1302,1202
6,2604,10,100,1e-05,0.01,0.666,0.8974654377880185,1351,1253
6,2704,10,100,1e-05,0.01,0.644,0.8975591715976331,1399,1305
6,2804,10,100,1e-05,0.01,0.676,0.8944365192582026,1450,1354
6,2904,10,100,1e-05,0.01,0.68,0.9149449035812672,1504,1400
6,3004,10,100,1e-05,0.01,0.708,0.9244340878828229,1550,1454
6,3104,10,100,1e-05,0.01,0.69,0.8721005154639175,1598,1506
6,3204,10,100,1e-05,0.01,0.712,0.918227215980025,1650,1554
6,3304,10,100,1e-05,0.01,0.75,0.9255447941888619,1716,1588
6,3404,10,100,1e-05,0.01,0.782,0.9459459459459459,1762,1642
6,3504,10,100,1e-05,0.01,0.76,0.9483447488584474,1813,1691
6,3604,10,100,1e-05,0.01,0.8,0.9761376248612652,1853,1751
6,3704,10,100,1e-05,0.01,0.828,0.9848812095032398,1896,1808
6,3804,10,100,1e-05,0.01,0.856,0.9860672975814931,1950,1854
6,3904,10,100,1e-05,0.01,0.852,0.9951331967213115,2002,1902
6,4004,10,100,1e-05,0.01,0.84,0.99000999000999,2050,1954
6,4104,10,100,1e-05,0.01,0.848,0.9865984405458089,2105,1999
6,4204,10,100,1e-05,0.01,0.882,0.9940532825880114,2150,2054
6,4304,10,100,1e-05,0.01,0.874,0.9960501858736059,2205,2099
6,4404,10,100,1e-05,0.01,0.868,0.9811534968210718,2264,2140
6,4504,10,100,1e-05,0.01,0.872,0.9602575488454707,2315,2189
6,4604,10,100,1e-05,0.01,0.878,0.9548218940052129,2349,2255
6,4704,10,100,1e-05,0.01,0.874,0.9466411564625851,2390,2314
6,4804,10,100,1e-05,0.01,0.93,0.9883430474604497,2430,2374
6,4904,10,100,1e-05,0.01,0.94,0.9971451876019576,2484,2420
6,5004,10,100,1e-05,0.01,0.936,0.9982014388489209,2539,2465
6,5104,10,100,1e-05,0.01,0.946,0.9992163009404389,2598,2506
6,5204,10,100,1e-05,0.01,0.954,1.0,2642,2562
6,5304,10,100,1e-05,0.01,0.95,0.9998114630467572,2690,2614
6,5404,10,100,1e-05,0.01,0.96,0.9998149518874907,2739,2665
6,5504,10,100,1e-05,0.01,0.964,0.9996366279069767,2785,2719
6,5604,10,100,1e-05,0.01,0.958,0.9989293361884368,2838,2766
6,5704,10,100,1e-05,0.01,0.958,0.9989481065918654,2885,2819
6,5804,10,100,1e-05,0.01,0.968,0.9993108201240524,2929,2875
6,5904,10,100,1e-05,0.01,0.962,0.9996612466124661,2981,2923
6,6004,10,100,1e-05,0.01,0.954,0.9991672218520986,3041,2963
6,6104,10,100,1e-05,0.01,0.96,0.9995085190039319,3083,3021
6,6204,10,100,1e-05,0.01,0.964,0.9995164410058027,3135,3069
6,6304,10,100,1e-05,0.01,0.956,0.9973032994923858,3183,3121
6,6404,10,100,1e-05,0.01,0.962,0.9993753903810119,3232,3172
6,6504,10,100,1e-05,0.01,0.968,0.9998462484624846,3272,3232
6,6604,10,100,1e-05,0.01,0.972,0.9998485766202302,3330,3274
6,6704,10,100,1e-05,0.01,0.97,0.9992541766109785,3380,3324
6,6804,10,100,1e-05,0.01,0.944,0.9883891828336273,3429,3375
6,6904,10,100,1e-05,0.01,0.966,0.9927578215527231,3473,3431
6,7004,10,100,1e-05,0.01,0.968,0.9970017133066819,3524,3480
6,7104,10,100,1e-05,0.01,0.97,0.9971846846846847,3570,3534
6,7204,10,100,1e-05,0.01,0.966,0.9969461410327596,3609,3595
6,7304,10,100,1e-05,0.01,0.972,0.9991785323110625,3659,3645
6,7404,10,100,1e-05,0.01,0.974,0.9986493787142086,3718,3686
6,7504,10,100,1e-05,0.01,0.972,0.9993336886993603,3774,3730
6,7604,10,100,1e-05,0.01,0.976,0.9998684902682798,3820,3784
6,7704,10,100,1e-05,0.01,0.976,0.9998701973001038,3859,3845
6,7804,10,100,1e-05,0.01,0.976,0.9983341875961046,3912,3892
6,7904,10,100,1e-05,0.01,0.974,0.9988613360323887,3971,3933
6,8004,10,100,1e-05,0.01,0.97,0.9995002498750625,4027,3977
6,8104,10,100,1e-05,0.01,0.97,0.9972852912142152,4074,4030
6,8204,10,100,1e-05,0.01,0.972,0.9941491955143832,4125,4079
6,8304,10,100,1e-05,0.01,0.96,0.9902456647398844,4174,4130
6,8404,10,100,1e-05,0.01,0.916,0.9431223227034745,4228,4176
6,8504,10,100,1e-05,0.01,0.946,0.9622530573847601,4284,4220
6,8604,10,100,1e-05,0.01,0.972,0.9908182240818224,4331,4273
6,8704,10,100,1e-05,0.01,0.98,0.9966681985294118,4385,4319
6,8804,10,100,1e-05,0.01,0.974,0.9967060427078601,4438,4366
6,8904,10,100,1e-05,0.01,0.976,0.9979784366576819,4486,4418
6,9004,10,100,1e-05,0.01,0.982,0.9998889382496668,4529,4475
6,9104,10,100,1e-05,0.01,0.978,0.999890158172232,4577,4527
6,9204,10,100,1e-05,0.01,0.98,0.999348109517601,4628,4576
6,9304,10,100,1e-05,0.01,0.982,0.9998925193465176,4680,4624
6,9404,10,100,1e-05,0.01,0.984,1.0,4735,4669
6,9504,10,100,1e-05,0.01,0.98,0.9989478114478114,4786,4718
6,9604,10,100,1e-05,0.01,0.982,0.9989587671803415,4826,4778
6,9704,10,100,1e-05,0.01,0.988,0.9987633965375103,4869,4835
6,9804,10,100,1e-05,0.01,0.978,0.9973480212158303,4912,4892
6,9904,10,100,1e-05,0.01,0.98,0.9974757673667205,4960,4944
6,10004,10,100,1e-05,0.01,0.976,0.9924030387844862,5019,4985
6,10104,10,100,1e-05,0.01,0.98,0.9956452889944576,5071,5033
6,10204,10,100,1e-05,0.01,0.984,0.9990199921599373,5123,5081
6,10304,10,100,1e-05,0.01,0.984,0.999417701863354,5173,5131
6,10404,10,100,1e-05,0.01,0.986,0.9998077662437524,5219,5185
6,10504,10,100,1e-05,0.01,0.986,0.9999047981721249,5276,5228
6,10604,10,100,1e-05,0.01,0.984,0.999245567710298,5327,5277
6,10704,10,100,1e-05,0.01,0.982,0.999813153961136,5378,5326
6,10804,10,100,1e-05,0.01,0.988,1.0,5432,5372
6,10904,10,100,1e-05,0.01,0.988,1.0,5488,5416
6,11004,10,100,1e-05,0.01,0.986,0.9991821155943293,5540,5464
6,11104,10,100,1e-05,0.01,0.986,0.9983789625360231,5585,5519
6,11204,10,100,1e-05,0.01,0.982,0.9956265619421635,5633,5571
6,11304,10,100,1e-05,0.01,0.978,0.9946036801132343,5680,5624
6,11404,10,100,1e-05,0.01,0.954,0.9784286215363031,5731,5673
6,11504,10,100,1e-05,0.01,0.972,0.9881780250347705,5780,5724
6,11604,10,100,1e-05,0.01,0.986,0.9969837986901069,5830,5774
6,11704,10,100,1e-05,0.01,0.99,0.9992310321257689,5879,5825
6,11804,10,100,1e-05,0.01,0.99,0.9997458488647916,5926,5878
6,11904,10,100,1e-05,0.01,0.99,0.9999159946236559,5976,5928
6,12004,10,100,1e-05,0.01,0.992,1.0,6021,5983
6,12104,10,100,1e-05,0.01,0.992,1.0,6074,6030
6,12204,10,100,1e-05,0.01,0.992,1.0,6131,6073
6,12304,10,100,1e-05,0.01,0.992,1.0,6180,6124
6,12404,10,100,1e-05,0.01,0.992,1.0,6229,6175
6,12504,10,100,1e-05,0.01,0.992,1.0,6264,6240
6,12604,10,100,1e-05,0.01,0.992,1.0,6304,6300
6,12704,10,100,1e-05,0.01,0.99,1.0,6354,6350
6,12804,10,100,1e-05,0.01,0.99,0.9999218994064355,6411,6393
6,12904,10,100,1e-05,0.01,0.984,0.9962802231866088,6464,6440
6,13004,10,100,1e-05,0.01,0.984,0.9961550292217779,6506,6498
6,13104,10,100,1e-05,0.01,0.982,0.9954212454212454,6548,6556
6,13204,10,100,1e-05,0.01,0.996,0.9976522265980006,6596,6608
6,13304,10,100,1e-05,0.01,0.992,0.9994738424533974,6658,6646
6,13404,10,100,1e-05,0.01,0.992,0.9994777678304984,6716,6688
6,13504,10,100,1e-05,0.01,0.992,1.0,6762,6742
6,13604,10,100,1e-05,0.01,0.99,0.9979417818288738,6800,6804
6,13704,10,100,1e-05,0.01,0.99,0.99905137186223,6846,6858
6,13804,10,100,1e-05,0.01,0.99,0.9995653433787308,6900,6904
6,13904,10,100,1e-05,0.01,0.99,0.9994246260069045,6953,6951
6,14004,10,100,1e-05,0.01,0.99,0.9996429591545273,7003,7001
6,14104,10,100,1e-05,0.01,0.988,0.9958876914350538,7045,7059
6,14204,10,100,1e-05,0.01,0.99,0.9983807378203323,7093,7111
6,14304,10,100,1e-05,0.01,0.988,0.9986017897091722,7143,7161
6,14404,10,100,1e-05,0.01,0.99,0.9983337961677312,7188,7216
6,14504,10,100,1e-05,0.01,0.986,0.9987589630446774,7229,7275
6,14604,10,100,1e-05,0.01,0.996,0.9993837304847987,7279,7325
6,14704,10,100,1e-05,0.01,0.994,0.9984357997823722,7335,7369
6,14804,10,100,1e-05,0.01,0.992,0.9970953796271278,7391,7413
6,14904,10,100,1e-05,0.01,0.988,0.9979871175523349,7447,7457
6,15004,10,100,1e-05,0.01,0.992,0.9993335110637164,7504,7500
7,104,10,100,1e-05,0.01,0.476,0.7980769230769231,50,54
7,204,10,100,1e-05,0.01,0.484,0.7745098039215687,97,107
7,304,10,100,1e-05,0.01,0.486,0.6973684210526315,147,157
7,404,10,100,1e-05,0.01,0.538,0.6658415841584159,196,208
7,504,10,100,1e-05,0.01,0.536,0.6488095238095238,245,259
7,604,10,100,1e-05,0.01,0.504,0.6854304635761589,294,310
7,704,10,100,1e-05,0.01,0.49,0.6676136363636364,338,366
7,804,10,100,1e-05,0.01,0.48,0.667910447761194,395,409
7,904,10,100,1e-05,0.01,0.492,0.6460176991150443,448,456
7,1004,10,100,1e-05,0.01,0.514,0.6713147410358565,502,502
7,1104,10,100,1e-05,0.01,0.5,0.6603260869565217,548,556
7,1204,10,100,1e-05,0.01,0.554,0.659468438538206,605,599
7,1304,10,100,1e-05,0.01,0.516,0.6656441717791411,653,651
7,1404,10,100,1e-05,0.01,0.53,0.7257834757834758,705,699
7,1504,10,100,1e-05,0.01,0.544,0.6768617021276596,756,748
7,1604,10,100,1e-05,0.01,0.542,0.7026184538653366,801,803
7,1704,10,100,1e-05,0.01,0.532,0.721830985915493,853,851
7,1804,10,100,1e-05,0.01,0.572,0.758869179600887,901,903
7,1904,10,100,1e-05,0.01,0.578,0.7578781512605042,943,961
7,2004,10,100,1e-05,0.01,0.556,0.7894211576846307,992,1012
7,2104,10,100,1e-05,0.01,0.574,0.7680608365019012,1043,1061
7,2204,10,100,1e-05,0.01,0.574,0.8039927404718693,1095,1109
7,2304,10,100,1e-05,0.01,0.568,0.7816840277777778,1148,1156
7,2404,10,100,1e-05,0.01,0.554,0.8227953410981698,1195,1209
7,2504,10,100,1e-05,0.01,0.598,0.827076677316294,1235,1269
7,2604,10,100,1e-05,0.01,0.572,0.8636712749615976,1291,1313
7,2704,10,100,1e-05,0.01,0.58,0.8443047337278107,1342,1362
7,2804,10,100,1e-05,0.01,0.598,0.8505706134094151,1397,1407
7,2904,10,100,1e-05,0.01,0.604,0.8818870523415978,1448,1456
7,3004,10,100,1e-05,0.01,0.622,0.9154460719041279,1497,1507
7,3104,10,100,1e-05,0.01,0.654,0.9259020618556701,1545,1559
7,3204,10,100,1e-05,0.01,0.64,0.91729088639201,1595,1609
7,3304,10,100,1e-05,0.01,0.634,0.8952784503631961,1648,1656
7,3404,10,100,1e-05,0.01,0.662,0.9242068155111633,1697,1707
7,3504,10,100,1e-05,0.01,0.676,0.9066780821917808,1749,1755
7,3604,10,100,1e-05,0.01,0.696,0.935072142064373,1803,1801
7,3704,10,100,1e-05,0.01,0.742,0.9551835853131749,1851,1853
7,3804,10,100,1e-05,0.01,0.706,0.9292849631966351,1899,1905
7,3904,10,100,1e-05,0.01,0.734,0.8880635245901639,1948,1956
7,4004,10,100,1e-05,0.01,0.76,0.9338161838161838,1996,2008
7,4104,10,100,1e-05,0.01,0.79,0.9549220272904484,2043,2061
7,4204,10,100,1e-05,0.01,0.786,0.9726450999048525,2090,2114
7,4304,10,100,1e-05,0.01,0.816,0.9855947955390335,2143,2161
7,4404,10,100,1e-05,0.01,0.846,0.984786557674841,2192,2212
7,4504,10,100,1e-05,0.01,0.828,0.9846802841918295,2236,2268
7,4604,10,100,1e-05,0.01,0.82,0.9921807124239791,2286,2318
7,4704,10,100,1e-05,0.01,0.846,0.9810799319727891,2335,2369
7,4804,10,100,1e-05,0.01,0.85,0.984804329725229,2384,2420
7,4904,10,100,1e-05,0.01,0.854,0.9900081566068516,2434,2470
7,5004,10,100,1e-05,0.01,0.86,0.9854116706634692,2481,2523
7,5104,10,100,1e-05,0.01,0.878,0.9884404388714734,2535,2569
7,5204,10,100,1e-05,0.01,0.874,0.989815526518063,2592,2612
7,5304,10,100,1e-05,0.01,0.878,0.996606334841629,2640,2664
7,5404,10,100,1e-05,0.01,0.88,0.9887120651369357,2695,2709
7,5504,10,100,1e-05,0.01,0.866,0.9778343023255814,2755,2749
7,5604,10,100,1e-05,0.01,0.886,0.9891149179157744,2811,2793
7,5704,10,100,1e-05,0.01,0.884,0.9922861150070126,2863,2841
7,5804,10,100,1e-05,0.01,0.926,0.9950034458993797,2917,2887
7,5904,10,100,1e-05,0.01,0.922,0.9974593495934959,2965,2939
7,6004,10,100,1e-05,0.01,0.93,0.998834110592938,3012,2992
7,6104,10,100,1e-05,0.01,0.93,0.9952490170380078,3052,3052
7,6204,10,100,1e-05,0.01,0.928,0.9941972920696325,3097,3107
7,6304,10,100,1e-05,0.01,0.93,0.9927030456852792,3152,3152
7,6404,10,100,1e-05,0.01,0.91,0.9781386633354153,3203,3201
7,6504,10,100,1e-05,0.01,0.932,0.9964637146371463,3251,3253
7,6604,10,100,1e-05,0.01,0.942,0.9977286493034525,3303,3301
7,6704,10,100,1e-05,0.01,0.95,0.9995525059665871,3352,3352
7,6804,10,100,1e-05,0.01,0.96,0.9992651381540271,3396,3408
7,6904,10,100,1e-05,0.01,0.964,0.9989860950173812,3448,3456
7,7004,10,100,1e-05,0.01,0.956,0.9935750999428897,3497,3507
7,7104,10,100,1e-05,0.01,0.964,0.9961993243243243,3543,3561
7,7204,10,100,1e-05,0.01,0.958,0.995835646862854,3597,3607
7,7304,10,100,1e-05,0.01,0.956,0.9945235487404163,3645,3659
7,7404,10,100,1e-05,0.01,0.968,0.9958130740140465,3693,3711
7,7504,10,100,1e-05,0.01,0.956,0.998001066098081,3740,3764
7,7604,10,100,1e-05,0.01,0.964,0.9981588637559179,3788,3816
7,7704,10,100,1e-05,0.01,0.948,0.9813084112149533,3846,3858
7,7804,10,100,1e-05,0.01,0.956,0.9862890825217837,3892,3912
7,7904,10,100,1e-05,0.01,0.954,0.9846912955465587,3939,3965
7,8004,10,100,1e-05,0.01,0.97,0.9912543728135932,3992,4012
7,8104,10,100,1e-05,0.01,0.976,0.9990128331688055,4042,4062
7,8204,10,100,1e-05,0.01,0.972,0.9992686494392979,4094,4110
7,8304,10,100,1e-05,0.01,0.98,0.9993978805394991,4131,4173
7,8404,10,100,1e-05,0.01,0.974,0.9957163255592575,4176,4228
7,8504,10,100,1e-05,0.01,0.962,0.9991768579492004,4232,4272
7,8604,10,100,1e-05,0.01,0.98,0.99953509995351,4278,4326
7,8704,10,100,1e-05,0.01,0.974,0.9981617647058824,4328,4376
7,8804,10,100,1e-05,0.01,0.98,0.9990913221263062,4376,4428
7,8904,10,100,1e-05,0.01,0.976,1.0,4425,4479
7,9004,10,100,1e-05,0.01,0.978,0.9996668147490004,4476,4528
7,9104,10,100,1e-05,0.01,0.972,0.999670474516696,4525,4579
7,9204,10,100,1e-05,0.01,0.976,0.9970664928292047,4568,4636
7,9304,10,100,1e-05,0.01,0.98,0.9984952708512468,4619,4685
7,9404,10,100,1e-05,0.01,0.976,0.9901105912377711,4656,4748
7,9504,10,100,1e-05,0.01,0.966,0.9923190235690236,4705,4799
7,9604,10,100,1e-05,0.01,0.968,0.9892753019575177,4758,4846
7,9704,10,100,1e-05,0.01,0.964,0.9858821104699094,4814,4890
7,9804,10,100,1e-05,0.01,0.978,0.9968380252957977,4859,4945
7,9904,10,100,1e-05,0.01,0.972,0.9975767366720517,4910,4994
7,10004,10,100,1e-05,0.01,0.972,0.9953018792483007,4959,5045
7,10104,10,100,1e-05,0.01,0.976,0.9979216152019003,5006,5098
7,10204,10,100,1e-05,0.01,0.98,0.9964719717757742,5052,5152
7,10304,10,100,1e-05,0.01,0.982,0.9973796583850931,5099,5205
7,10404,10,100,1e-05,0.01,0.974,0.9967320261437909,5153,5251
7,10504,10,100,1e-05,0.01,0.984,0.9983815689261234,5206,5298
7,10604,10,100,1e-05,0.01,0.97,0.9957563183704262,5255,5349
7,10704,10,100,1e-05,0.01,0.978,0.9933669656203289,5318,5386
7,10804,10,100,1e-05,0.01,0.98,0.9988893002591632,5366,5438
7,10904,10,100,1e-05,0.01,0.978,0.9985326485693323,5418,5486
7,11004,10,100,1e-05,0.01,0.98,0.9976372228280626,5468,5536
7,11104,10,100,1e-05,0.01,0.984,0.9991894812680115,5519,5585
7,11204,10,100,1e-05,0.01,0.982,0.9988397001071047,5577,5627
7,11304,10,100,1e-05,0.01,0.984,0.9982307147912244,5626,5678
7,11404,10,100,1e-05,0.01,0.988,0.998860049105577,5680,5724
7,11504,10,100,1e-05,0.01,0.978,0.9966098748261474,5726,5778
7,11604,10,100,1e-05,0.01,0.978,0.999224405377456,5776,5828
7,11704,10,100,1e-05,0.01,0.984,0.9992310321257689,5823,5881
7,11804,10,100,1e-05,0.01,0.984,0.9981362250084717,5871,5933
7,11904,10,100,1e-05,0.01,0.984,0.9991599462365591,5919,5985
7,12004,10,100,1e-05,0.01,0.986,0.9998333888703765,5971,6033
7,12104,10,100,1e-05,0.01,0.982,0.9997521480502314,6025,6079
7,12204,10,100,1e-05,0.01,0.978,0.9976237299246149,6081,6123
7,12304,10,100,1e-05,0.01,0.962,0.9900032509752926,6138,6166
7,12404,10,100,1e-05,0.01,0.958,0.9875040309577555,6194,6210
7,12504,10,100,1e-05,0.01,0.98,0.9971209213051824,6244,6260
7,12604,10,100,1e-05,0.01,0.984,0.9984132021580451,6292,6312
7,12704,10,100,1e-05,0.01,0.984,0.9988192695214105,6339,6365
7,12804,10,100,1e-05,0.01,0.982,1.0,6394,6410
7,12904,10,100,1e-05,0.01,0.98,1.0,6443,6461
7,13004,10,100,1e-05,0.01,0.986,0.9993848046754845,6494,6510
7,13104,10,100,1e-05,0.01,0.98,0.9999236874236874,6540,6564
7,13204,10,100,1e-05,0.01,0.986,0.9998485307482581,6600,6604
7,13304,10,100,1e-05,0.01,0.984,1.0,6641,6663
7,13404,10,100,1e-05,0.01,0.988,1.0,6692,6712
7,13504,10,100,1e-05,0.01,0.986,1.0,6739,6765
7,13604,10,100,1e-05,0.01,0.978,0.9902969714789768,6789,6815
7,13704,10,100,1e-05,0.01,0.962,0.9794950379451255,6838,6866
7,13804,10,100,1e-05,0.01,0.984,0.9927557229788467,6890,6914
7,13904,10,100,1e-05,0.01,0.99,0.9989930955120828,6942,6962
7,14004,10,100,1e-05,0.01,0.99,0.9994287346472437,6992,7012
7,14104,10,100,1e-05,0.01,0.988,1.0,7044,7060
7,14204,10,100,1e-05,0.01,0.99,0.9997887918896086,7091,7113
7,14304,10,100,1e-05,0.01,0.992,1.0,7147,7157
7,14404,10,100,1e-05,0.01,0.994,0.9998611496806442,7198,7206
7,14504,10,100,1e-05,0.01,0.986,0.9996552675124104,7248,7256
7,14604,10,100,1e-05,0.01,0.992,0.9993152560942208,7297,7307
7,14704,10,100,1e-05,0.01,0.988,0.9985038084874864,7345,7359
7,14804,10,100,1e-05,0.01,0.988,0.9980410699810862,7399,7405
7,14904,10,100,1e-05,0.01,0.986,0.9985909822866345,7447,7457
7,15004,10,100,1e-05,0.01,0.978,0.9946014396161024,7497,7507
8,104,10,100,1e-05,0.01,0.488,0.7211538461538461,47,57
8,204,10,100,1e-05,0.01,0.528,0.6421568627450981,86,118
8,304,10,100,1e-05,0.01,0.52,0.631578947368421,131,173
8,404,10,100,1e-05,0.01,0.544,0.5792079207920792,177,227
8,504,10,100,1e-05,0.01,0.552,0.6448412698412699,219,285
8,604,10,100,1e-05,0.01,0.51,0.609271523178808,267,337
8,704,10,100,1e-05,0.01,0.532,0.6363636363636364,313,391
8,804,10,100,1e-05,0.01,0.55,0.6616915422885572,358,446
8,904,10,100,1e-05,0.01,0.572,0.6758849557522124,409,495
8,1004,10,100,1e-05,0.01,0.582,0.6912350597609562,461,543
8,1104,10,100,1e-05,0.01,0.562,0.6838768115942029,522,582
8,1204,10,100,1e-05,0.01,0.556,0.7109634551495017,579,625
8,1304,10,100,1e-05,0.01,0.55,0.7055214723926381,620,684
8,1404,10,100,1e-05,0.01,0.55,0.7257834757834758,666,738
8,1504,10,100,1e-05,0.01,0.584,0.7021276595744681,715,789
8,1604,10,100,1e-05,0.01,0.56,0.766209476309227,768,836
8,1704,10,100,1e-05,0.01,0.564,0.7634976525821596,814,890
8,1804,10,100,1e-05,0.01,0.554,0.7272727272727273,860,944
8,1904,10,100,1e-05,0.01,0.546,0.7773109243697479,914,990
8,2004,10,100,1e-05,0.01,0.596,0.8168662674650699,965,1039
8,2104,10,100,1e-05,0.01,0.566,0.7385931558935361,1022,1082
8,2204,10,100,1e-05,0.01,0.638,0.8103448275862069,1071,1133
8,2304,10,100,1e-05,0.01,0.642,0.8307291666666666,1125,1179
8,2404,10,100,1e-05,0.01,0.69,0.8277870216306157,1183,1221
8,2504,10,100,1e-05,0.01,0.678,0.8730031948881789,1232,1272
8,2604,10,100,1e-05,0.01,0.68,0.8982334869431644,1279,1325
8,2704,10,100,1e-05,0.01,0.714,0.8890532544378699,1332,1372
8,2804,10,100,1e-05,0.01,0.738,0.9104850213980028,1374,1430
8,2904,10,100,1e-05,0.01,0.75,0.9225206611570248,1424,1480
8,3004,10,100,1e-05,0.01,0.756,0.9284287616511319,1480,1524
8,3104,10,100,1e-05,0.01,0.776,0.9288015463917526,1527,1577
8,3204,10,100,1e-05,0.01,0.8,0.9538077403245943,1581,1623
8,3304,10,100,1e-05,0.01,0.806,0.9667070217917676,1630,1674
8,3404,10,100,1e-05,0.01,0.824,0.9706227967097533,1675,1729
8,3504,10,100,1e-05,0.01,0.818,0.9811643835616438,1728,1776
8,3604,10,100,1e-05,0.01,0.822,0.9772475027746947,1786,1818
8,3704,10,100,1e-05,0.01,0.814,0.9597732181425486,1840,1864
8,3804,10,100,1e-05,0.01,0.834,0.9713459516298633,1888,1916
8,3904,10,100,1e-05,0.01,0.796,0.9293032786885246,1943,1961
8,4004,10,100,1e-05,0.01,0.84,0.9647852147852148,1996,2008
8,4104,10,100,1e-05,0.01,0.82,0.97953216374269,2040,2064
8,4204,10,100,1e-05,0.01,0.826,0.9740723120837298,2095,2109
8,4304,10,100,1e-05,0.01,0.836,0.9872211895910781,2138,2166
8,4404,10,100,1e-05,0.01,0.854,0.9881925522252498,2188,2216
8,4504,10,100,1e-05,0.01,0.858,0.9933392539964476,2236,2268
8,4604,10,100,1e-05,0.01,0.86,0.9921807124239791,2288,2316
8,4704,10,100,1e-05,0.01,0.858,0.9902210884353742,2338,2366
8,4804,10,100,1e-05,0.01,0.862,0.9962531223980017,2388,2416
8,4904,10,100,1e-05,0.01,0.86,0.9965334420880914,2434,2470
8,5004,10,100,1e-05,0.01,0.872,0.9966027178257394,2484,2520
8,5104,10,100,1e-05,0.01,0.876,0.9917711598746082,2540,2564
8,5204,10,100,1e-05,0.01,0.89,0.9963489623366641,2585,2619
8,5304,10,100,1e-05,0.01,0.872,0.9896304675716441,2634,2670
8,5404,10,100,1e-05,0.01,0.872,0.9927831236121392,2685,2719
8,5504,10,100,1e-05,0.01,0.87,0.9887354651162791,2741,2763
8,5604,10,100,1e-05,0.01,0.884,0.9916131334760885,2790,2814
8,5704,10,100,1e-05,0.01,0.89,0.9856241234221599,2831,2873
8,5804,10,100,1e-05,0.01,0.864,0.978118538938663,2881,2923
8,5904,10,100,1e-05,0.01,0.876,0.9874661246612466,2933,2971
8,6004,10,100,1e-05,0.01,0.898,0.9915056628914057,2974,3030
8,6104,10,100,1e-05,0.01,0.91,0.9932830930537353,3030,3074
8,6204,10,100,1e-05,0.01,0.896,0.9959703417150225,3085,3119
8,6304,10,100,1e-05,0.01,0.926,0.9907994923857868,3135,3169
8,6404,10,100,1e-05,0.01,0.916,0.9942223610243598,3190,3214
8,6504,10,100,1e-05,0.01,0.916,0.9829335793357934,3245,3259
8,6604,10,100,1e-05,0.01,0.914,0.9906117504542702,3288,3316
8,6704,10,100,1e-05,0.01,0.924,0.9916467780429594,3341,3363
8,6804,10,100,1e-05,0.01,0.908,0.9842739564961788,3401,3403
8,6904,10,100,1e-05,0.01,0.916,0.9885573580533025,3448,3456
8,7004,10,100,1e-05,0.01,0.924,0.9981439177612793,3504,3500
8,7104,10,100,1e-05,0.01,0.928,0.997043918918919,3554,3550
8,7204,10,100,1e-05,0.01,0.916,0.994447529150472,3605,3599
8,7304,10,100,1e-05,0.01,0.928,0.9946604600219058,3654,3650
8,7404,10,100,1e-05,0.01,0.932,0.9914910858995137,3700,3704
8,7504,10,100,1e-05,0.01,0.924,0.9934701492537313,3753,3751
8,7604,10,100,1e-05,0.01,0.916,0.9786954234613361,3800,3804
8,7704,10,100,1e-05,0.01,0.924,0.995846313603323,3859,3845
8,7804,10,100,1e-05,0.01,0.928,0.9837262942080984,3912,3892
8,7904,10,100,1e-05,0.01,0.932,0.9955718623481782,3958,3946
8,8004,10,100,1e-05,0.01,0.932,0.9913793103448276,4004,4000
8,8104,10,100,1e-05,0.01,0.926,0.9930898321816387,4049,4055
8,8204,10,100,1e-05,0.01,0.946,0.9978059483178937,4107,4097
8,8304,10,100,1e-05,0.01,0.938,0.9965077071290944,4159,4145
8,8404,10,100,1e-05,0.01,0.934,0.9957163255592575,4214,4190
8,8504,10,100,1e-05,0.01,0.928,0.9925917215428034,4261,4243
8,8604,10,100,1e-05,0.01,0.948,0.9900046490004649,4323,4281
8,8704,10,100,1e-05,0.01,0.93,0.9865579044117647,4376,4328
8,8804,10,100,1e-05,0.01,0.946,0.9945479327578374,4422,4382
8,8904,10,100,1e-05,0.01,0.942,0.9961814914645103,4470,4434
8,9004,10,100,1e-05,0.01,0.946,0.9954464682363394,4507,4497
8,9104,10,100,1e-05,0.01,0.94,0.9942882249560633,4553,4551
8,9204,10,100,1e-05,0.01,0.952,0.997283789656671,4599,4605
8,9304,10,100,1e-05,0.01,0.94,0.9954858125537404,4643,4661
8,9404,10,100,1e-05,0.01,0.948,0.9967035304125904,4693,4711
8,9504,10,100,1e-05,0.01,0.952,0.9969486531986532,4749,4755
8,9604,10,100,1e-05,0.01,0.948,0.9942732194918784,4797,4807
8,9704,10,100,1e-05,0.01,0.936,0.9923742786479802,4848,4856
8,9804,10,100,1e-05,0.01,0.944,0.994594043247654,4897,4907
8,9904,10,100,1e-05,0.01,0.946,0.9976777059773829,4951,4953
8,10004,10,100,1e-05,0.01,0.948,0.9920031987205118,5007,4997
8,10104,10,100,1e-05,0.01,0.946,0.9915874901029296,5061,5043
8,10204,10,100,1e-05,0.01,0.954,0.9954919639357115,5107,5097
8,10304,10,100,1e-05,0.01,0.948,0.9936917701863354,5166,5138
8,10404,10,100,1e-05,0.01,0.958,0.9950019223375625,5214,5190
8,10504,10,100,1e-05,0.01,0.962,0.9993335872048743,5270,5234
8,10604,10,100,1e-05,0.01,0.962,0.9998113919275745,5315,5289
8,10704,10,100,1e-05,0.01,0.962,0.999813153961136,5362,5342
8,10804,10,100,1e-05,0.01,0.962,0.9992595335061089,5414,5390
8,10904,10,100,1e-05,0.01,0.946,0.9976155539251651,5470,5434
8,11004,10,100,1e-05,0.01,0.95,0.9969102144674664,5513,5491
8,11104,10,100,1e-05,0.01,0.954,0.9985590778097982,5560,5544
8,11204,10,100,1e-05,0.01,0.96,0.9963405926454838,5612,5592
8,11304,10,100,1e-05,0.01,0.952,0.9762915782024062,5665,5639
8,11404,10,100,1e-05,0.01,0.958,0.9852683269028412,5725,5679
8,11504,10,100,1e-05,0.01,0.962,0.9928720445062587,5775,5729
8,11604,10,100,1e-05,0.01,0.97,0.9957773181661496,5818,5786
8,11704,10,100,1e-05,0.01,0.966,0.9995727956254272,5871,5833
8,11804,10,100,1e-05,0.01,0.966,0.9990681125042359,5915,5889
8,11904,10,100,1e-05,0.01,0.964,0.9992439516129032,5965,5939
8,12004,10,100,1e-05,0.01,0.968,0.998750416527824,6013,5991
8,12104,10,100,1e-05,0.01,0.97,0.9995869134170522,6059,6045
8,12204,10,100,1e-05,0.01,0.966,0.9971320878400525,6106,6098
8,12304,10,100,1e-05,0.01,0.964,0.9992685305591678,6156,6148
8,12404,10,100,1e-05,0.01,0.962,0.9981457594324411,6203,6201
8,12504,10,100,1e-05,0.01,0.964,0.9971209213051824,6249,6255
8,12604,10,100,1e-05,0.01,0.972,0.9999206601079023,6309,6295
8,12704,10,100,1e-05,0.01,0.962,0.9970875314861462,6355,6349
8,12804,10,100,1e-05,0.01,0.958,0.9912527335207748,6410,6394
8,12904,10,100,1e-05,0.01,0.966,0.9975201487910725,6460,6444
8,13004,10,100,1e-05,0.01,0.968,0.9973085204552445,6506,6498
8,13104,10,100,1e-05,0.01,0.966,0.9974053724053724,6557,6547
8,13204,10,100,1e-05,0.01,0.974,0.9995455922447744,6607,6597
8,13304,10,100,1e-05,0.01,0.976,0.9999248346361996,6661,6643
8,13404,10,100,1e-05,0.01,0.978,0.9999253954043569,6712,6692
8,13504,10,100,1e-05,0.01,0.976,0.9996297393364929,6763,6741
8,13604,10,100,1e-05,0.01,0.978,1.0,6802,6802
8,13704,10,100,1e-05,0.01,0.974,0.9986135434909515,6850,6854
8,13804,10,100,1e-05,0.01,0.98,0.9999275572297884,6909,6895
8,13904,10,100,1e-05,0.01,0.976,0.9974827387802071,6959,6945
8,14004,10,100,1e-05,0.01,0.976,0.9987860611253927,7009,6995
8,14104,10,100,1e-05,0.01,0.974,0.9951077708451503,7058,7046
8,14204,10,100,1e-05,0.01,0.96,0.9951422134609968,7109,7095
8,14304,10,100,1e-05,0.01,0.974,0.9984619686800895,7158,7146
8,14404,10,100,1e-05,0.01,0.978,0.9993057484032213,7214,7190
8,14504,10,100,1e-05,0.01,0.976,0.9952426916712631,7256,7248
8,14604,10,100,1e-05,0.01,0.978,0.9984250890167078,7306,7298
8,14704,10,100,1e-05,0.01,0.972,0.9991158868335147,7354,7350
8,14804,10,100,1e-05,0.01,0.964,0.992839773034315,7404,7400
8,14904,10,100,1e-05,0.01,0.97,0.9983225979602791,7449,7455
8,15004,10,100,1e-05,0.01,0.98,0.9979338842975206,7498,7506
9,104,10,100,1e-05,0.01,0.506,0.6057692307692307,41,63
9,204,10,100,1e-05,0.01,0.506,0.7303921568627451,88,116
9,304,10,100,1e-05,0.01,0.484,0.6348684210526315,140,164
9,404,10,100,1e-05,0.01,0.496,0.7128712871287128,183,221
9,504,10,100,1e-05,0.01,0.49,0.6706349206349206,233,271
9,604,10,100,1e-05,0.01,0.476,0.6738410596026491,279,325
9,704,10,100,1e-05,0.01,0.49,0.6690340909090909,324,380
9,804,10,100,1e-05,0.01,0.484,0.6878109452736318,377,427
9,904,10,100,1e-05,0.01,0.498,0.6969026548672567,431,473
9,1004,10,100,1e-05,0.01,0.478,0.704183266932271,474,530
9,1104,10,100,1e-05,0.01,0.474,0.6992753623188406,525,579
9,1204,10,100,1e-05,0.01,0.484,0.7558139534883721,572,632
9,1304,10,100,1e-05,0.01,0.48,0.7469325153374233,622,682
9,1404,10,100,1e-05,0.01,0.474,0.7756410256410257,675,729
9,1504,10,100,1e-05,0.01,0.506,0.7626329787234043,729,775
9,1604,10,100,1e-05,0.01,0.49,0.7917705735660848,771,833
9,1704,10,100,1e-05,0.01,0.526,0.8022300469483568,826,878
9,1804,10,100,1e-05,0.01,0.546,0.835920177383592,877,927
9,1904,10,100,1e-05,0.01,0.546,0.8287815126050421,928,976
9,2004,10,100,1e-05,0.01,0.528,0.8597804391217565,978,1026
9,2104,10,100,1e-05,0.01,0.554,0.839828897338403,1024,1080
9,2204,10,100,1e-05,0.01,0.57,0.8493647912885662,1077,1127
9,2304,10,100,1e-05,0.01,0.574,0.8776041666666666,1120,1184
9,2404,10,100,1e-05,0.01,0.646,0.903910149750416,1179,1225
9,2504,10,100,1e-05,0.01,0.622,0.9093450479233227,1229,1275
9,2604,10,100,1e-05,0.01,0.672,0.9362519201228878,1280,1324
9,2704,10,100,1e-05,0.01,0.672,0.9230769230769231,1331,1373
9,2804,10,100,1e-05,0.01,0.676,0.9407988587731811,1379,1425
9,2904,10,100,1e-05,0.01,0.682,0.9445592286501377,1426,1478
9,3004,10,100,1e-05,0.01,0.718,0.9567243675099867,1479,1525
9,3104,10,100,1e-05,0.01,0.74,0.9722938144329897,1535,1569
9,3204,10,100,1e-05,0.01,0.72,0.9653558052434457,1582,1622
9,3304,10,100,1e-05,0.01,0.758,0.9748789346246973,1641,1663
9,3404,10,100,1e-05,0.01,0.766,0.9844300822561692,1696,1708
9,3504,10,100,1e-05,0.01,0.764,0.9694634703196348,1743,1761
9,3604,10,100,1e-05,0.01,0.75,0.9517203107658158,1792,1812
9,3704,10,100,1e-05,0.01,0.756,0.911987041036717,1837,1867
9,3804,10,100,1e-05,0.01,0.788,0.9566246056782335,1889,1915
9,3904,10,100,1e-05,0.01,0.804,0.9751536885245902,1939,1965
9,4004,10,100,1e-05,0.01,0.794,0.967032967032967,1990,2014
9,4104,10,100,1e-05,0.01,0.82,0.9683235867446394,2044,2060
9,4204,10,100,1e-05,0.01,0.834,0.9626546146527117,2088,2116
9,4304,10,100,1e-05,0.01,0.856,0.9925650557620818,2138,2166
9,4404,10,100,1e-05,0.01,0.842,0.9954586739327884,2192,2212
9,4504,10,100,1e-05,0.01,0.89,0.991785079928952,2239,2265
9,4604,10,100,1e-05,0.01,0.872,0.9945699391833188,2287,2317
9,4704,10,100,1e-05,0.01,0.892,0.9965986394557823,2342,2362
9,4804,10,100,1e-05,0.01,0.868,0.9925062447960034,2390,2414
9,4904,10,100,1e-05,0.01,0.882,0.99836867862969,2438,2466
9,5004,10,100,1e-05,0.01,0.89,0.9982014388489209,2499,2505
9,5104,10,100,1e-05,0.01,0.88,0.9945141065830722,2551,2553
9,5204,10,100,1e-05,0.01,0.878,0.9827056110684089,2594,2610
9,5304,10,100,1e-05,0.01,0.878,0.9873680241327301,2649,2655
9,5404,10,100,1e-05,0.01,0.894,0.9859363434492968,2695,2709
9,5504,10,100,1e-05,0.01,0.906,0.9949127906976745,2753,2751
9,5604,10,100,1e-05,0.01,0.918,0.9942897930049964,2811,2793
9,5704,10,100,1e-05,0.01,0.9,0.9938639551192145,2858,2846
9,5804,10,100,1e-05,0.01,0.918,0.9960372157133012,2908,2896
9,5904,10,100,1e-05,0.01,0.918,0.9983062330623306,2958,2946
9,6004,10,100,1e-05,0.01,0.924,0.9985009993337775,3010,2994
9,6104,10,100,1e-05,0.01,0.944,0.9983617300131061,3056,3048
9,6204,10,100,1e-05,0.01,0.928,0.9869439071566731,3106,3098
9,6304,10,100,1e-05,0.01,0.94,0.9977791878172588,3157,3147
9,6404,10,100,1e-05,0.01,0.944,0.9976577139287945,3212,3192
9,6504,10,100,1e-05,0.01,0.94,0.9916974169741697,3258,3246
9,6604,10,100,1e-05,0.01,0.928,0.9953058752271351,3316,3288
9,6704,10,100,1e-05,0.01,0.942,0.9961217183770883,3365,3339
9,6804,10,100,1e-05,0.01,0.934,0.9822163433274544,3416,3388
9,6904,10,100,1e-05,0.01,0.948,0.9918887601390498,3467,3437
9,7004,10,100,1e-05,0.01,0.956,0.9968589377498572,3517,3487
9,7104,10,100,1e-05,0.01,0.946,0.9942286036036037,3567,3537
9,7204,10,100,1e-05,0.01,0.956,0.9988895058300944,3614,3590
9,7304,10,100,1e-05,0.01,0.962,0.9961664841182913,3664,3640
9,7404,10,100,1e-05,0.01,0.956,0.9955429497568882,3712,3692
9,7504,10,100,1e-05,0.01,0.954,0.9977345415778252,3767,3737
9,7604,10,100,1e-05,0.01,0.976,0.9978958442924777,3825,3779
9,7704,10,100,1e-05,0.01,0.968,0.9981827622014537,3878,3826
9,7804,10,100,1e-05,0.01,0.976,0.9993593029215787,3925,3879
9,7904,10,100,1e-05,0.01,0.966,0.996330971659919,3970,3934
9,8004,10,100,1e-05,0.01,0.97,0.9978760619690155,4024,3980
9,8104,10,100,1e-05,0.01,0.964,0.9938302073050346,4083,4021
9,8204,10,100,1e-05,0.01,0.974,0.9968308142369576,4136,4068
9,8304,10,100,1e-05,0.01,0.962,0.9909682080924855,4185,4119
9,8404,10,100,1e-05,0.01,0.964,0.9863160399809614,4235,4169
9,8504,10,100,1e-05,0.01,0.976,0.9960018814675446,4287,4217
9,8604,10,100,1e-05,0.01,0.984,0.9970943747094375,4330,4274
9,8704,10,100,1e-05,0.01,0.982,0.9993106617647058,4382,4322
9,8804,10,100,1e-05,0.01,0.98,0.9996592457973649,4437,4367
9,8904,10,100,1e-05,0.01,0.98,0.9991015274034142,4483,4421
9,9004,10,100,1e-05,0.01,0.972,0.998778320746335,4538,4466
9,9104,10,100,1e-05,0.01,0.98,0.9980228471001757,4593,4511
9,9204,10,100,1e-05,0.01,0.982,0.99793568013907,4646,4558
9,9304,10,100,1e-05,0.01,0.984,0.9990326741186586,4693,4611
9,9404,10,100,1e-05,0.01,0.984,0.9989366227137388,4740,4664
9,9504,10,100,1e-05,0.01,0.986,1.0,4791,4713
9,9604,10,100,1e-05,0.01,0.984,1.0,4837,4767
9,9704,10,100,1e-05,0.01,0.986,0.995671887881286,4882,4822
9,9804,10,100,1e-05,0.01,0.976,0.9946960424316605,4933,4871
9,9904,10,100,1e-05,0.01,0.99,0.9973747980613893,4990,4914
9,10004,10,100,1e-05,0.01,0.98,0.9964014394242303,5042,4962
9,10104,10,100,1e-05,0.01,0.98,0.9978226444972288,5089,5015
9,10204,10,100,1e-05,0.01,0.986,0.9951979615836927,5141,5063
9,10304,10,100,1e-05,0.01,0.978,0.9984472049689441,5190,5114
9,10404,10,100,1e-05,0.01,0.978,0.997597078046905,5235,5169
9,10504,10,100,1e-05,0.01,0.988,0.9987623762376238,5291,5213
9,10604,10,100,1e-05,0.01,0.988,0.9968879668049793,5337,5267
9,10704,10,100,1e-05,0.01,0.982,0.9971038863976084,5390,5314
9,10804,10,100,1e-05,0.01,0.984,0.9934283598667161,5445,5359
9,10904,10,100,1e-05,0.01,0.978,0.9980741012472487,5490,5414
9,11004,10,100,1e-05,0.01,0.99,0.9983642311886587,5544,5460
9,11104,10,100,1e-05,0.01,0.986,0.9977485590778098,5594,5510
9,11204,10,100,1e-05,0.01,0.988,0.9988397001071047,5648,5556
9,11304,10,100,1e-05,0.01,0.994,0.9994692144373672,5698,5606
9,11404,10,100,1e-05,0.01,0.984,0.9959663276043493,5741,5663
9,11504,10,100,1e-05,0.01,0.99,0.9993045897079277,5796,5708
9,11604,10,100,1e-05,0.01,0.998,0.9998276456394347,5845,5759
9,11704,10,100,1e-05,0.01,0.994,0.9999145591250854,5897,5807
9,11804,10,100,1e-05,0.01,0.994,0.998898678414097,5953,5851
9,11904,10,100,1e-05,0.01,0.994,0.9998319892473119,6002,5902
9,12004,10,100,1e-05,0.01,0.994,0.9992502499166944,6050,5954
9,12104,10,100,1e-05,0.01,0.988,0.9973562458691342,6106,5998
9,12204,10,100,1e-05,0.01,0.992,0.9978695509668961,6157,6047
9,12304,10,100,1e-05,0.01,0.994,0.9985370611183355,6200,6104
9,12404,10,100,1e-05,0.01,0.992,0.9994356659142212,6255,6149
9,12504,10,100,1e-05,0.01,0.992,0.9980806142034548,6298,6206
9,12604,10,100,1e-05,0.01,0.992,0.9982545223738496,6350,6254
9,12704,10,100,1e-05,0.01,0.992,0.9974023929471033,6400,6304
9,12804,10,100,1e-05,0.01,0.98,0.9915651358950328,6448,6356
9,12904,10,100,1e-05,0.01,0.994,0.9992250464972101,6492,6412
9,13004,10,100,1e-05,0.01,0.994,0.9999231005844356,6541,6463
9,13104,10,100,1e-05,0.01,0.994,1.0,6590,6514
9,13204,10,100,1e-05,0.01,0.994,1.0,6636,6568
9,13304,10,100,1e-05,0.01,0.994,0.9996993385447985,6682,6622
9,13404,10,100,1e-05,0.01,0.996,0.9999253954043569,6728,6676
9,13504,10,100,1e-05,0.01,0.996,1.0,6776,6728
9,13604,10,100,1e-05,0.01,0.996,1.0,6825,6779
9,13704,10,100,1e-05,0.01,0.996,1.0,6867,6837
9,13804,10,100,1e-05,0.01,0.996,1.0,6920,6884
9,13904,10,100,1e-05,0.01,0.996,1.0,6970,6934
9,14004,10,100,1e-05,0.01,0.996,1.0,7021,6983
9,14104,10,100,1e-05,0.01,0.996,1.0,7064,7040
9,14204,10,100,1e-05,0.01,0.996,0.9997183891861448,7114,7090
9,14304,10,100,1e-05,0.01,0.986,0.9944071588366891,7166,7138
9,14404,10,100,1e-05,0.01,0.978,0.9902804776450986,7213,7191
9,14504,10,100,1e-05,0.01,0.992,0.997173193601765,7269,7235
9,14604,10,100,1e-05,0.01,0.98,0.9923993426458505,7318,7286
9,14704,10,100,1e-05,0.01,0.986,0.9946953210010882,7367,7337
9,14804,10,100,1e-05,0.01,0.994,0.9982437179140773,7417,7387
9,14904,10,100,1e-05,0.01,0.998,0.9999329039184112,7466,7438
9,15004,10,100,1e-05,0.01,0.998,1.0,7505,7499
10,104,10,100,1e-05,0.01,0.498,0.4807692307692308,50,54
10,204,10,100,1e-05,0.01,0.524,0.6666666666666666,101,103
10,304,10,100,1e-05,0.01,0.494,0.5921052631578947,143,161
10,404,10,100,1e-05,0.01,0.508,0.6188118811881188,190,214
10,504,10,100,1e-05,0.01,0.522,0.6170634920634921,238,266
10,604,10,100,1e-05,0.01,0.514,0.6639072847682119,294,310
10,704,10,100,1e-05,0.01,0.492,0.65625,357,347
10,804,10,100,1e-05,0.01,0.482,0.6592039800995025,418,386
10,904,10,100,1e-05,0.01,0.518,0.6449115044247787,476,428
10,1004,10,100,1e-05,0.01,0.492,0.6593625498007968,518,486
10,1104,10,100,1e-05,0.01,0.51,0.6784420289855072,568,536
10,1204,10,100,1e-05,0.01,0.492,0.6951827242524917,622,582
10,1304,10,100,1e-05,0.01,0.51,0.6848159509202454,675,629
10,1404,10,100,1e-05,0.01,0.496,0.6602564102564102,725,679
10,1504,10,100,1e-05,0.01,0.494,0.7054521276595744,775,729
10,1604,10,100,1e-05,0.01,0.526,0.7531172069825436,827,777
10,1704,10,100,1e-05,0.01,0.542,0.7206572769953051,876,828
10,1804,10,100,1e-05,0.01,0.542,0.7549889135254989,933,871
10,1904,10,100,1e-05,0.01,0.554,0.7626050420168067,981,923
10,2004,10,100,1e-05,0.01,0.582,0.7884231536926147,1030,974
10,2104,10,100,1e-05,0.01,0.576,0.7395437262357415,1085,1019
10,2204,10,100,1e-05,0.01,0.596,0.7844827586206896,1142,1062
10,2304,10,100,1e-05,0.01,0.57,0.7829861111111112,1192,1112
10,2404,10,100,1e-05,0.01,0.582,0.790765391014975,1236,1168
10,2504,10,100,1e-05,0.01,0.586,0.8354632587859425,1285,1219
10,2604,10,100,1e-05,0.01,0.62,0.8725038402457758,1339,1265
10,2704,10,100,1e-05,0.01,0.63,0.8653846153846154,1391,1313
10,2804,10,100,1e-05,0.01,0.638,0.8634094151212554,1441,1363
10,2904,10,100,1e-05,0.01,0.628,0.8650137741046832,1491,1413
10,3004,10,100,1e-05,0.01,0.636,0.8591877496671105,1541,1463
10,3104,10,100,1e-05,0.01,0.678,0.8653350515463918,1586,1518
10,3204,10,100,1e-05,0.01,0.688,0.8795255930087391,1631,1573
10,3304,10,100,1e-05,0.01,0.712,0.902542372881356,1690,1614
10,3404,10,100,1e-05,0.01,0.716,0.9312573443008225,1737,1667
10,3504,10,100,1e-05,0.01,0.732,0.9489155251141552,1791,1713
10,3604,10,100,1e-05,0.01,0.764,0.9664261931187569,1837,1767
10,3704,10,100,1e-05,0.01,0.732,0.9333153347732182,1890,1814
10,3804,10,100,1e-05,0.01,0.766,0.9445320715036803,1936,1868
10,3904,10,100,1e-05,0.01,0.81,0.9741290983606558,1985,1919
10,4004,10,100,1e-05,0.01,0.822,0.977022977022977,2033,1971
10,4104,10,100,1e-05,0.01,0.8,0.9710038986354775,2076,2028
10,4204,10,100,1e-05,0.01,0.848,0.9840627973358707,2125,2079
10,4304,10,100,1e-05,0.01,0.878,0.9904739776951673,2178,2126
10,4404,10,100,1e-05,0.01,0.878,0.9918256130790191,2224,2180
10,4504,10,100,1e-05,0.01,0.894,0.9966696269982238,2274,2230
10,4604,10,100,1e-05,0.01,0.868,0.9932667245873154,2317,2287
10,4704,10,100,1e-05,0.01,0.898,0.9876700680272109,2373,2331
10,4804,10,100,1e-05,0.01,0.916,0.9979184013322231,2419,2385
10,4904,10,100,1e-05,0.01,0.912,0.9975530179445351,2473,2431
10,5004,10,100,1e-05,0.01,0.918,0.9950039968025579,2523,2481
10,5104,10,100,1e-05,0.01,0.908,0.9954937304075235,2582,2522
10,5204,10,100,1e-05,0.01,0.924,0.9930822444273636,2644,2560
10,5304,10,100,1e-05,0.01,0.948,0.9979260935143288,2698,2606
10,5404,10,100,1e-05,0.01,0.938,0.9950037009622502,2749,2655
10,5504,10,100,1e-05,0.01,0.93,0.9918241279069767,2798,2706
10,5604,10,100,1e-05,0.01,0.95,0.9957173447537473,2861,2743
10,5704,10,100,1e-05,0.01,0.952,0.998422159887798,2920,2784
10,5804,10,100,1e-05,0.01,0.948,0.9989662301860786,2983,2821
10,5904,10,100,1e-05,0.01,0.948,0.9903455284552846,3035,2869
10,6004,10,100,1e-05,0.01,0.972,0.9983344437041972,3083,2921
10,6104,10,100,1e-05,0.01,0.962,0.9981979030144168,3136,2968
10,6204,10,100,1e-05,0.01,0.956,0.9974210186976145,3186,3018
10,6304,10,100,1e-05,0.01,0.96,0.9982550761421319,3230,3074
10,6404,10,100,1e-05,0.01,0.954,0.9846970643347908,3277,3127
10,6504,10,100,1e-05,0.01,0.948,0.9849323493234933,3328,3176
10,6604,10,100,1e-05,0.01,0.95,0.985160508782556,3379,3225
10,6704,10,100,1e-05,0.01,0.976,0.9961217183770883,3435,3269
10,6804,10,100,1e-05,0.01,0.966,0.9972075249853027,3489,3315
10,6904,10,100,1e-05,0.01,0.966,0.9949304750869061,3536,3368
10,7004,10,100,1e-05,0.01,0.974,0.9988577955454027,3585,3419
10,7104,10,100,1e-05,0.01,0.974,0.9977477477477478,3632,3472
10,7204,10,100,1e-05,0.01,0.972,0.9990283176013326,3685,3519
10,7304,10,100,1e-05,0.01,0.974,0.9986308871851041,3732,3572
10,7404,10,100,1e-05,0.01,0.978,0.9921663965424095,3789,3615
10,7504,10,100,1e-05,0.01,0.972,0.9974680170575693,3844,3660
10,7604,10,100,1e-05,0.01,0.974,0.9913203577064703,3890,3714
10,7704,10,100,1e-05,0.01,0.976,0.9941588785046729,3938,3766
10,7804,10,100,1e-05,0.01,0.978,0.9916709379805229,3985,3819
10,7904,10,100,1e-05,0.01,0.968,0.9930414979757085,4034,3870
10,8004,10,100,1e-05,0.01,0.956,0.9792603698150925,4088,3916
10,8104,10,100,1e-05,0.01,0.948,0.9675468904244817,4135,3969
10,8204,10,100,1e-05,0.01,0.976,0.9920770355923939,4185,4019
10,8304,10,100,1e-05,0.01,0.978,0.9967485549132948,4231,4073
10,8404,10,100,1e-05,0.01,0.984,0.9995240361732508,4277,4127
10,8504,10,100,1e-05,0.01,0.982,0.9996472248353716,4339,4165
10,8604,10,100,1e-05,0.01,0.984,1.0,4383,4221
10,8704,10,100,1e-05,0.01,0.982,0.9994255514705882,4437,4267
10,8804,10,100,1e-05,0.01,0.978,0.9996592457973649,4490,4314
10,8904,10,100,1e-05,0.01,0.986,0.9996630727762803,4530,4374
10,9004,10,100,1e-05,0.01,0.986,0.9988893824966681,4579,4425
10,9104,10,100,1e-05,0.01,0.986,0.999890158172232,4634,4470
10,9204,10,100,1e-05,0.01,0.978,0.9973924380704041,4687,4517
10,9304,10,100,1e-05,0.01,0.982,0.9939810834049871,4735,4569
10,9404,10,100,1e-05,0.01,0.976,0.9945767758400681,4784,4620
10,9504,10,100,1e-05,0.01,0.978,0.9855850168350169,4835,4669
10,9604,10,100,1e-05,0.01,0.98,0.9975010412328197,4890,4714
10,9704,10,100,1e-05,0.01,0.986,0.998351195383347,4934,4770
10,9804,10,100,1e-05,0.01,0.986,0.996532027743778,4977,4827
10,9904,10,100,1e-05,0.01,0.982,0.9983844911147012,5020,4884
10,10004,10,100,1e-05,0.01,0.982,0.9992003198720512,5060,4944
10,10104,10,100,1e-05,0.01,0.992,0.9997030878859857,5102,5002
10,10204,10,100,1e-05,0.01,0.988,1.0,5153,5051
10,10304,10,100,1e-05,0.01,0.986,0.999611801242236,5203,5101
10,10404,10,100,1e-05,0.01,0.988,0.9999038831218762,5255,5149
10,10504,10,100,1e-05,0.01,0.988,1.0,5306,5198
10,10604,10,100,1e-05,0.01,0.988,1.0,5364,5240
10,10704,10,100,1e-05,0.01,0.986,0.9980381165919282,5412,5292
10,10804,10,100,1e-05,0.01,0.988,0.9967604590892262,5453,5351
10,10904,10,100,1e-05,0.01,0.976,0.9910124724871606,5500,5404
10,11004,10,100,1e-05,0.01,0.986,0.9913667757179208,5546,5458
10,11104,10,100,1e-05,0.01,0.988,0.9942363112391931,5593,5511
10,11204,10,100,1e-05,0.01,0.984,0.9949125312388433,5642,5562
10,11304,10,100,1e-05,0.01,0.99,0.9976999292285916,5684,5620
10,11404,10,100,1e-05,0.01,0.988,0.9989477376359173,5743,5661
10,11504,10,100,1e-05,0.01,0.992,0.9990438108484005,5799,5705
10,11604,10,100,1e-05,0.01,0.99,0.9989658738366081,5843,5761
10,11704,10,100,1e-05,0.01,0.99,0.9980348598769652,5894,5810
10,11804,10,100,1e-05,0.01,0.986,0.9976279227380549,5945,5859
10,11904,10,100,1e-05,0.01,0.988,0.9991599462365591,5993,5911
10,12004,10,100,1e-05,0.01,0.988,0.9990003332222592,6042,5962
10,12104,10,100,1e-05,0.01,0.99,0.9995042961004627,6099,6005
10,12204,10,100,1e-05,0.01,0.99,0.999918059652573,6143,6061
10,12304,10,100,1e-05,0.01,0.99,1.0,6200,6104
10,12404,10,100,1e-05,0.01,0.99,1.0,6252,6152
10,12504,10,100,1e-05,0.01,0.99,1.0,6299,6205
10,12604,10,100,1e-05,0.01,0.99,1.0,6343,6261
10,12704,10,100,1e-05,0.01,0.99,1.0,6386,6318
10,12804,10,100,1e-05,0.01,0.99,1.0,6432,6372
10,12904,10,100,1e-05,0.01,0.988,1.0,6483,6421
10,13004,10,100,1e-05,0.01,0.99,0.999461704091049,6534,6470
10,13104,10,100,1e-05,0.01,0.968,0.9781746031746031,6582,6522
10,13204,10,100,1e-05,0.01,0.986,0.9920478642835504,6625,6579
10,13304,10,100,1e-05,0.01,0.99,0.998947684906795,6670,6634
10,13404,10,100,1e-05,0.01,0.996,0.9998507908087139,6720,6684
10,13504,10,100,1e-05,0.01,0.994,1.0,6770,6734
10,13604,10,100,1e-05,0.01,0.994,1.0,6826,6778
10,13704,10,100,1e-05,0.01,0.994,1.0,6871,6833
10,13804,10,100,1e-05,0.01,0.992,1.0,6920,6884
10,13904,10,100,1e-05,0.01,0.992,1.0,6956,6948
10,14004,10,100,1e-05,0.01,0.992,1.0,7004,7000
10,14104,10,100,1e-05,0.01,0.992,0.9997872943845717,7056,7048
10,14204,10,100,1e-05,0.01,0.992,1.0,7102,7102
10,14304,10,100,1e-05,0.01,0.992,0.9994407158836689,7153,7151
10,14404,10,100,1e-05,0.01,0.994,0.9998611496806442,7206,7198
10,14504,10,100,1e-05,0.01,0.984,0.9960700496414782,7253,7251
10,14604,10,100,1e-05,0.01,0.988,0.9939742536291427,7303,7301
10,14704,10,100,1e-05,0.01,0.986,0.9978917301414582,7352,7352
10,14804,10,100,1e-05,0.01,0.99,0.9968251823831397,7403,7401
10,14904,10,100,1e-05,0.01,0.986,0.9962426194310252,7450,7454
10,15004,10,100,1e-05,0.01,0.99,0.9989336177019461,7503,7501
11,104,10,100,1e-05,0.01,0.524,0.7019230769230769,56,48
11,204,10,100,1e-05,0.01,0.492,0.5784313725490197,101,103
11,304,10,100,1e-05,0.01,0.51,0.6611842105263158,142,162
11,404,10,100,1e-05,0.01,0.508,0.5965346534653465,204,200
11,504,10,100,1e-05,0.01,0.502,0.6170634920634921,255,249
11,604,10,100,1e-05,0.01,0.502,0.640728476821192,303,301
11,704,10,100,1e-05,0.01,0.524,0.6321022727272727,353,351
11,804,10,100,1e-05,0.01,0.524,0.6467661691542289,406,398
11,904,10,100,1e-05,0.01,0.518,0.6449115044247787,454,450
11,1004,10,100,1e-05,0.01,0.502,0.6523904382470119,498,506
11,1104,10,100,1e-05,0.01,0.506,0.6711956521739131,552,552
11,1204,10,100,1e-05,0.01,0.49,0.6910299003322259,605,599
11,1304,10,100,1e-05,0.01,0.486,0.6947852760736196,654,650
11,1404,10,100,1e-05,0.01,0.48,0.7015669515669516,708,696
11,1504,10,100,1e-05,0.01,0.494,0.6555851063829787,758,746
11,1604,10,100,1e-05,0.01,0.502,0.7107231920199502,800,804
11,1704,10,100,1e-05,0.01,0.498,0.7142018779342723,846,858
11,1804,10,100,1e-05,0.01,0.508,0.700110864745011,892,912
11,1904,10,100,1e-05,0.01,0.514,0.7521008403361344,941,963
11,2004,10,100,1e-05,0.01,0.534,0.7684630738522954,994,1010
11,2104,10,100,1e-05,0.01,0.536,0.7889733840304183,1047,1057
11,2204,10,100,1e-05,0.01,0.556,0.8162431941923775,1095,1109
11,2304,10,100,1e-05,0.01,0.572,0.8324652777777778,1143,1161
11,2404,10,100,1e-05,0.01,0.532,0.8452579034941764,1194,1210
11,2504,10,100,1e-05,0.01,0.576,0.8518370607028753,1242,1262
11,2604,10,100,1e-05,0.01,0.604,0.8759600614439325,1294,1310
11,2704,10,100,1e-05,0.01,0.592,0.8816568047337278,1334,1370
11,2804,10,100,1e-05,0.01,0.62,0.8880171184022825,1385,1419
11,2904,10,100,1e-05,0.01,0.656,0.8670798898071626,1439,1465
11,3004,10,100,1e-05,0.01,0.648,0.8778295605858855,1491,1513
11,3104,10,100,1e-05,0.01,0.67,0.9052835051546392,1542,1562
11,3204,10,100,1e-05,0.01,0.724,0.9254057428214731,1589,1615
11,3304,10,100,1e-05,0.01,0.7,0.9394673123486683,1642,1662
11,3404,10,100,1e-05,0.01,0.744,0.9521151586368978,1687,1717
11,3504,10,100,1e-05,0.01,0.81,0.9697488584474886,1747,1757
11,3604,10,100,1e-05,0.01,0.786,0.947558268590455,1798,1806
11,3704,10,100,1e-05,0.01,0.826,0.9524838012958964,1848,1856
11,3804,10,100,1e-05,0.01,0.84,0.9776550998948476,1901,1903
11,3904,10,100,1e-05,0.01,0.848,0.9815573770491803,1947,1957
11,4004,10,100,1e-05,0.01,0.886,0.9902597402597403,1994,2010
11,4104,10,100,1e-05,0.01,0.872,0.9883040935672515,2036,2068
11,4204,10,100,1e-05,0.01,0.902,0.9957183634633682,2085,2119
11,4304,10,100,1e-05,0.01,0.898,0.9962825278810409,2133,2171
11,4404,10,100,1e-05,0.01,0.902,0.9954586739327884,2184,2220
11,4504,10,100,1e-05,0.01,0.91,0.9935612788632326,2231,2273
11,4604,10,100,1e-05,0.01,0.906,0.9897914856646395,2287,2317
11,4704,10,100,1e-05,0.01,0.914,0.9921343537414966,2338,2366
11,4804,10,100,1e-05,0.01,0.934,0.9939633638634471,2383,2421
11,4904,10,100,1e-05,0.01,0.934,0.9944942903752039,2432,2472
11,5004,10,100,1e-05,0.01,0.936,0.9940047961630696,2487,2517
11,5104,10,100,1e-05,0.01,0.942,0.9978448275862069,2548,2556
11,5204,10,100,1e-05,0.01,0.956,0.9976940814757879,2591,2613
11,5304,10,100,1e-05,0.01,0.948,0.995475113122172,2636,2668
11,5404,10,100,1e-05,0.01,0.95,0.9961139896373057,2693,2711
11,5504,10,100,1e-05,0.01,0.962,0.9994549418604651,2741,2763
11,5604,10,100,1e-05,0.01,0.952,0.9983940042826552,2796,2808
11,5704,10,100,1e-05,0.01,0.948,0.9957924263674615,2844,2860
11,5804,10,100,1e-05,0.01,0.948,0.9919021364576155,2890,2914
11,5904,10,100,1e-05,0.01,0.964,0.9949186991869918,2937,2967
11,6004,10,100,1e-05,0.01,0.926,0.9848434377081945,2986,3018
11,6104,10,100,1e-05,0.01,0.952,0.9867300131061599,3038,3066
11,6204,10,100,1e-05,0.01,0.958,0.9887169568020632,3093,3111
11,6304,10,100,1e-05,0.01,0.966,0.9974619289340102,3147,3157
11,6404,10,100,1e-05,0.01,0.968,0.9993753903810119,3191,3213
11,6504,10,100,1e-05,0.01,0.972,0.9996924969249692,3238,3266
11,6604,10,100,1e-05,0.01,0.968,1.0,3294,3310
11,6704,10,100,1e-05,0.01,0.97,0.9973150357995226,3348,3356
11,6804,10,100,1e-05,0.01,0.974,0.9997060552616108,3399,3405
11,6904,10,100,1e-05,0.01,0.98,0.9991309385863267,3455,3449
11,7004,10,100,1e-05,0.01,0.976,0.9992861222158766,3505,3499
11,7104,10,100,1e-05,0.01,0.98,0.9998592342342343,3555,3549
11,7204,10,100,1e-05,0.01,0.98,0.9990283176013326,3594,3610
11,7304,10,100,1e-05,0.01,0.978,0.9969879518072289,3647,3657
11,7404,10,100,1e-05,0.01,0.936,0.9619124797406807,3686,3718
11,7504,10,100,1e-05,0.01,0.95,0.976545842217484,3739,3765
11,7604,10,100,1e-05,0.01,0.982,0.9981588637559179,3790,3814
11,7704,10,100,1e-05,0.01,0.984,0.9997403946002077,3845,3859
11,7804,10,100,1e-05,0.01,0.982,0.9997437211686314,3890,3914
11,7904,10,100,1e-05,0.01,0.984,1.0,3931,3973
11,8004,10,100,1e-05,0.01,0.99,0.9997501249375312,3983,4021
11,8104,10,100,1e-05,0.01,0.99,0.9998766041461007,4035,4069
11,8204,10,100,1e-05,0.01,0.984,0.999512432959532,4085,4119
11,8304,10,100,1e-05,0.01,0.99,0.9998795761078998,4141,4163
11,8404,10,100,1e-05,0.01,0.986,1.0,4189,4215
11,8504,10,100,1e-05,0.01,0.986,1.0,4237,4267
11,8604,10,100,1e-05,0.01,0.99,1.0,4291,4313
11,8704,10,100,1e-05,0.01,0.99,0.9997702205882353,4338,4366
11,8804,10,100,1e-05,0.01,0.984,0.9997728305315765,4385,4419
11,8904,10,100,1e-05,0.01,0.988,0.9997753818508536,4430,4474
11,9004,10,100,1e-05,0.01,0.984,0.9996668147490004,4486,4518
11,9104,10,100,1e-05,0.01,0.982,0.9984622144112478,4522,4582
11,9204,10,100,1e-05,0.01,0.984,0.9982616253802694,4573,4631
11,9304,10,100,1e-05,0.01,0.978,0.9976354256233878,4631,4673
11,9404,10,100,1e-05,0.01,0.986,0.9987239472564866,4684,4720
11,9504,10,100,1e-05,0.01,0.986,0.9991582491582491,4743,4761
11,9604,10,100,1e-05,0.01,0.978,0.999271137026239,4796,4808
11,9704,10,100,1e-05,0.01,0.986,0.999484748557296,4854,4850
11,9804,10,100,1e-05,0.01,0.984,0.9972460220318238,4902,4902
11,9904,10,100,1e-05,0.01,0.974,0.9946486268174475,4961,4943
11,10004,10,100,1e-05,0.01,0.964,0.984406237504998,5017,4987
11,10104,10,100,1e-05,0.01,0.984,0.9970308788598575,5054,5050
11,10204,10,100,1e-05,0.01,0.986,0.9956879655037241,5094,5110
11,10304,10,100,1e-05,0.01,0.99,0.9980590062111802,5147,5157
11,10404,10,100,1e-05,0.01,0.982,0.9948096885813149,5193,5211
11,10504,10,100,1e-05,0.01,0.992,0.9984767707539984,5251,5253
11,10604,10,100,1e-05,0.01,0.992,0.9987740475292343,5295,5309
11,10704,10,100,1e-05,0.01,0.998,0.9997197309417041,5343,5361
11,10804,10,100,1e-05,0.01,0.998,1.0,5395,5409
11,10904,10,100,1e-05,0.01,0.996,1.0,5450,5454
11,11004,10,100,1e-05,0.01,0.996,1.0,5508,5496
11,11104,10,100,1e-05,0.01,0.994,1.0,5556,5548
11,11204,10,100,1e-05,0.01,0.996,1.0,5605,5599
11,11304,10,100,1e-05,0.01,0.996,1.0,5650,5654
11,11404,10,100,1e-05,0.01,0.994,1.0,5698,5706
11,11504,10,100,1e-05,0.01,0.998,1.0,5748,5756
11,11604,10,100,1e-05,0.01,0.998,1.0,5796,5808
11,11704,10,100,1e-05,0.01,0.994,1.0,5844,5860
11,11804,10,100,1e-05,0.01,0.994,1.0,5892,5912
11,11904,10,100,1e-05,0.01,0.994,1.0,5946,5958
11,12004,10,100,1e-05,0.01,0.994,1.0,5997,6007
11,12104,10,100,1e-05,0.01,0.994,1.0,6060,6044
11,12204,10,100,1e-05,0.01,0.99,0.9987708947885939,6101,6103
11,12304,10,100,1e-05,0.01,0.974,0.9791937581274383,6144,6160
11,12404,10,100,1e-05,0.01,0.984,0.9913737504030957,6194,6210
11,12504,10,100,1e-05,0.01,0.986,0.996001279590531,6241,6263
11,12604,10,100,1e-05,0.01,0.994,0.9993652808632181,6296,6308
11,12704,10,100,1e-05,0.01,0.994,0.9991341309823678,6352,6352
11,12804,10,100,1e-05,0.01,0.998,0.9999218994064355,6401,6403
11,12904,10,100,1e-05,0.01,0.996,0.999535027898326,6445,6459
11,13004,10,100,1e-05,0.01,0.996,0.9998462011688711,6497,6507
11,13104,10,100,1e-05,0.01,0.996,1.0,6547,6557
11,13204,10,100,1e-05,0.01,0.992,0.9996970614965162,6599,6605
11,13304,10,100,1e-05,0.01,0.996,0.9999248346361996,6649,6655
11,13404,10,100,1e-05,0.01,0.994,0.9996269770217845,6693,6711
11,13504,10,100,1e-05,0.01,0.992,0.9995556872037915,6738,6766
11,13604,10,100,1e-05,0.01,0.988,0.9973537194942664,6801,6803
11,13704,10,100,1e-05,0.01,0.984,0.9953298307063632,6858,6846
11,13804,10,100,1e-05,0.01,0.994,0.9962329759490003,6910,6894
11,13904,10,100,1e-05,0.01,0.992,0.9994246260069045,6962,6942
11,14004,10,100,1e-05,0.01,0.996,1.0,7008,6996
11,14104,10,100,1e-05,0.01,0.994,0.9999290981281905,7062,7042
11,14204,10,100,1e-05,0.01,0.992,1.0,7110,7094
11,14304,10,100,1e-05,0.01,0.992,1.0,7156,7148
11,14404,10,100,1e-05,0.01,0.992,0.9999305748403221,7207,7197
11,14504,10,100,1e-05,0.01,0.994,0.9989658025372311,7260,7244
11,14604,10,100,1e-05,0.01,0.988,0.994522048753766,7310,7294
11,14704,10,100,1e-05,0.01,0.99,0.9922470076169749,7358,7346
11,14804,10,100,1e-05,0.01,0.99,0.9965549851391515,7409,7395
11,14904,10,100,1e-05,0.01,0.99,0.9918142780461621,7458,7446
11,15004,10,100,1e-05,0.01,0.994,0.9993335110637164,7503,7501
12,104,10,100,1e-05,0.01,0.532,0.6730769230769231,50,54
12,204,10,100,1e-05,0.01,0.49,0.6911764705882353,96,108
12,304,10,100,1e-05,0.01,0.538,0.6513157894736842,141,163
12,404,10,100,1e-05,0.01,0.536,0.6831683168316832,186,218
12,504,10,100,1e-05,0.01,0.532,0.6646825396825397,243,261
12,604,10,100,1e-05,0.01,0.522,0.6672185430463576,296,308
12,704,10,100,1e-05,0.01,0.5,0.6761363636363636,352,352
12,804,10,100,1e-05,0.01,0.512,0.6890547263681592,403,401
12,904,10,100,1e-05,0.01,0.508,0.6847345132743363,457,447
12,1004,10,100,1e-05,0.01,0.494,0.7231075697211156,512,492
12,1104,10,100,1e-05,0.01,0.516,0.6766304347826086,561,543
12,1204,10,100,1e-05,0.01,0.5,0.6918604651162791,609,595
12,1304,10,100,1e-05,0.01,0.474,0.6457055214723927,657,647
12,1404,10,100,1e-05,0.01,0.476,0.6780626780626781,707,697
12,1504,10,100,1e-05,0.01,0.52,0.6888297872340425,756,748
12,1604,10,100,1e-05,0.01,0.514,0.7138403990024937,817,787
12,1704,10,100,1e-05,0.01,0.488,0.7276995305164319,867,837
12,1804,10,100,1e-05,0.01,0.496,0.7594235033259423,915,889
12,1904,10,100,1e-05,0.01,0.49,0.7515756302521008,959,945
12,2004,10,100,1e-05,0.01,0.51,0.7440119760479041,1004,1000
12,2104,10,100,1e-05,0.01,0.52,0.7718631178707225,1060,1044
12,2204,10,100,1e-05,0.01,0.544,0.8012704174228675,1118,1086
12,2304,10,100,1e-05,0.01,0.53,0.8138020833333334,1169,1135
12,2404,10,100,1e-05,0.01,0.582,0.85108153078203,1217,1187
12,2504,10,100,1e-05,0.01,0.584,0.8514376996805112,1275,1229
12,2604,10,100,1e-05,0.01,0.638,0.8755760368663594,1321,1283
12,2704,10,100,1e-05,0.01,0.656,0.8883136094674556,1375,1329
12,2804,10,100,1e-05,0.01,0.636,0.8534236804564908,1430,1374
12,2904,10,100,1e-05,0.01,0.658,0.8412534435261708,1477,1427
12,3004,10,100,1e-05,0.01,0.712,0.87982689747004,1520,1484
12,3104,10,100,1e-05,0.01,0.688,0.9110824742268041,1567,1537
12,3204,10,100,1e-05,0.01,0.702,0.9169787765293383,1614,1590
12,3304,10,100,1e-05,0.01,0.74,0.9004237288135594,1670,1634
12,3404,10,100,1e-05,0.01,0.748,0.9253819036427732,1715,1689
12,3504,10,100,1e-05,0.01,0.776,0.9529109589041096,1767,1737
12,3604,10,100,1e-05,0.01,0.752,0.9400665926748057,1832,1772
12,3704,10,100,1e-05,0.01,0.748,0.8914686825053996,1884,1820
12,3804,10,100,1e-05,0.01,0.758,0.9124605678233438,1931,1873
12,3904,10,100,1e-05,0.01,0.766,0.9188012295081968,1984,1920
12,4004,10,100,1e-05,0.01,0.782,0.961038961038961,2040,1964
12,4104,10,100,1e-05,0.01,0.82,0.9722222222222222,2087,2017
12,4204,10,100,1e-05,0.01,0.822,0.9740723120837298,2130,2074
12,4304,10,100,1e-05,0.01,0.816,0.974907063197026,2177,2127
12,4404,10,100,1e-05,0.01,0.824,0.9779745685740237,2228,2176
12,4504,10,100,1e-05,0.01,0.852,0.9853463587921847,2282,2222
12,4604,10,100,1e-05,0.01,0.838,0.987619461337967,2326,2278
12,4704,10,100,1e-05,0.01,0.854,0.9925595238095238,2377,2327
12,4804,10,100,1e-05,0.01,0.812,0.9525395503746877,2419,2385
12,4904,10,100,1e-05,0.01,0.842,0.9624796084828712,2472,2432
12,5004,10,100,1e-05,0.01,0.85,0.9788169464428457,2521,2483
12,5104,10,100,1e-05,0.01,0.856,0.9886363636363636,2565,2539
12,5204,10,100,1e-05,0.01,0.862,0.9938508839354343,2613,2591
12,5304,10,100,1e-05,0.01,0.874,0.9905731523378583,2659,2645
12,5404,10,100,1e-05,0.01,0.866,0.9924130273871207,2705,2699
12,5504,10,100,1e-05,0.01,0.866,0.9811046511627907,2756,2748
12,5604,10,100,1e-05,0.01,0.874,0.9926837972876517,2816,2788
12,5704,10,100,1e-05,0.01,0.85,0.9817671809256662,2871,2833
12,5804,10,100,1e-05,0.01,0.882,0.9844934527911785,2919,2885
12,5904,10,100,1e-05,0.01,0.85,0.9644308943089431,2970,2934
12,6004,10,100,1e-05,0.01,0.894,0.9865089940039974,3021,2983
12,6104,10,100,1e-05,0.01,0.92,0.9904980340760158,3073,3031
12,6204,10,100,1e-05,0.01,0.92,0.9964539007092199,3116,3088
12,6304,10,100,1e-05,0.01,0.918,0.9973032994923858,3168,3136
12,6404,10,100,1e-05,0.01,0.926,0.9976577139287945,3218,3186
12,6504,10,100,1e-05,0.01,0.932,0.9984624846248462,3254,3250
12,6604,10,100,1e-05,0.01,0.93,0.9995457298606905,3312,3292
12,6704,10,100,1e-05,0.01,0.938,0.9985083532219571,3359,3345
12,6804,10,100,1e-05,0.01,0.926,0.9952968841857731,3415,3389
12,6904,10,100,1e-05,0.01,0.94,0.9984067207415991,3462,3442
12,7004,10,100,1e-05,0.01,0.938,0.9961450599657339,3509,3495
12,7104,10,100,1e-05,0.01,0.936,0.9956362612612613,3561,3543
12,7204,10,100,1e-05,0.01,0.94,0.9931982232093282,3613,3591
12,7304,10,100,1e-05,0.01,0.938,0.9958926615553122,3660,3644
12,7404,10,100,1e-05,0.01,0.942,0.9964883846569422,3708,3696
12,7504,10,100,1e-05,0.01,0.944,0.9985341151385928,3756,3748
12,7604,10,100,1e-05,0.01,0.944,0.9992109416096792,3799,3805
12,7704,10,100,1e-05,0.01,0.934,0.9809190031152648,3851,3853
12,7804,10,100,1e-05,0.01,0.928,0.9923116350589442,3907,3897
12,7904,10,100,1e-05,0.01,0.95,0.9849443319838057,3949,3955
12,8004,10,100,1e-05,0.01,0.934,0.9900049975012494,4003,4001
12,8104,10,100,1e-05,0.01,0.954,0.9950641658440277,4055,4049
12,8204,10,100,1e-05,0.01,0.95,0.9912237932715748,4098,4106
12,8304,10,100,1e-05,0.01,0.958,0.9971098265895953,4149,4155
12,8404,10,100,1e-05,0.01,0.964,0.9990480723465016,4192,4212
12,8504,10,100,1e-05,0.01,0.958,0.9995296331138288,4237,4267
12,8604,10,100,1e-05,0.01,0.962,0.9975592747559274,4277,4327
12,8704,10,100,1e-05,0.01,0.962,0.9974724264705882,4330,4374
12,8804,10,100,1e-05,0.01,0.96,0.999204906860518,4381,4423
12,8904,10,100,1e-05,0.01,0.964,0.9991015274034142,4426,4478
12,9004,10,100,1e-05,0.01,0.954,0.9966681474900044,4483,4521
12,9104,10,100,1e-05,0.01,0.954,0.9962653778558875,4534,4570
12,9204,10,100,1e-05,0.01,0.956,0.9935897435897436,4591,4613
12,9304,10,100,1e-05,0.01,0.952,0.9914015477214101,4633,4671
12,9404,10,100,1e-05,0.01,0.962,0.9910676307954062,4678,4726
12,9504,10,100,1e-05,0.01,0.972,0.9964225589225589,4735,4769
12,9604,10,100,1e-05,0.01,0.964,0.9951062057476051,4784,4820
12,9704,10,100,1e-05,0.01,0.958,0.9938169826875515,4830,4874
12,9804,10,100,1e-05,0.01,0.97,0.9981640146878825,4886,4918
12,9904,10,100,1e-05,0.01,0.974,0.9992932148626817,4932,4972
12,10004,10,100,1e-05,0.01,0.974,0.998500599760096,4979,5025
12,10104,10,100,1e-05,0.01,0.978,0.9984164687252574,5031,5073
12,10204,10,100,1e-05,0.01,0.982,0.9997059976479812,5081,5123
12,10304,10,100,1e-05,0.01,0.978,0.999805900621118,5125,5179
12,10404,10,100,1e-05,0.01,0.976,0.9993271818531334,5175,5229
12,10504,10,100,1e-05,0.01,0.978,0.9993335872048743,5229,5275
12,10604,10,100,1e-05,0.01,0.958,0.99622783855149,5281,5323
12,10704,10,100,1e-05,0.01,0.98,0.9938340807174888,5340,5364
12,10804,10,100,1e-05,0.01,0.972,0.9950944094779711,5388,5416
12,10904,10,100,1e-05,0.01,0.976,0.9972487160674982,5444,5460
12,11004,10,100,1e-05,0.01,0.972,0.9972737186477645,5495,5509
12,11104,10,100,1e-05,0.01,0.972,0.9978386167146974,5548,5556
12,11204,10,100,1e-05,0.01,0.964,0.9945555158871832,5597,5607
12,11304,10,100,1e-05,0.01,0.962,0.9955767869780608,5656,5648
12,11404,10,100,1e-05,0.01,0.982,0.9981585408628552,5702,5702
12,11504,10,100,1e-05,0.01,0.974,0.9993915159944368,5752,5752
12,11604,10,100,1e-05,0.01,0.976,0.9989658738366081,5797,5807
12,11704,10,100,1e-05,0.01,0.982,0.9999145591250854,5849,5855
12,11804,10,100,1e-05,0.01,0.982,0.9993222636394442,5901,5903
12,11904,10,100,1e-05,0.01,0.976,0.9973958333333334,5948,5956
12,12004,10,100,1e-05,0.01,0.976,0.996917694101966,5997,6007
12,12104,10,100,1e-05,0.01,0.978,0.9900033046926636,6047,6057
12,12204,10,100,1e-05,0.01,0.978,0.9981973123566044,6096,6108
12,12304,10,100,1e-05,0.01,0.982,0.9978055916775033,6159,6145
12,12404,10,100,1e-05,0.01,0.98,0.9983876168977749,6205,6199
12,12504,10,100,1e-05,0.01,0.982,0.9980006397952655,6245,6259
12,12604,10,100,1e-05,0.01,0.98,0.9961123452872104,6297,6307
12,12704,10,100,1e-05,0.01,0.98,0.9977172544080605,6341,6363
12,12804,10,100,1e-05,0.01,0.982,0.9968759762574195,6391,6413
12,12904,10,100,1e-05,0.01,0.978,0.9974426534407935,6444,6460
12,13004,10,100,1e-05,0.01,0.96,0.9898492771454936,6490,6514
12,13104,10,100,1e-05,0.01,0.976,0.999465811965812,6544,6560
12,13204,10,100,1e-05,0.01,0.98,0.9994698576189034,6594,6610
12,13304,10,100,1e-05,0.01,0.982,0.9990228502705953,6640,6664
12,13404,10,100,1e-05,0.01,0.982,1.0,6692,6712
12,13504,10,100,1e-05,0.01,0.982,0.9999259478672986,6756,6748
12,13604,10,100,1e-05,0.01,0.982,0.9998529844163482,6810,6794
12,13704,10,100,1e-05,0.01,0.982,0.9999270286047869,6862,6842
12,13804,10,100,1e-05,0.01,0.982,0.9995653433787308,6914,6890
12,13904,10,100,1e-05,0.01,0.982,0.9994246260069045,6961,6943
12,14004,10,100,1e-05,0.01,0.98,0.999071693801771,7013,6991
12,14104,10,100,1e-05,0.01,0.986,0.9949659671015315,7062,7042
12,14204,10,100,1e-05,0.01,0.978,0.9880315404111518,7112,7092
12,14304,10,100,1e-05,0.01,0.986,0.9989513422818792,7158,7146
12,14404,10,100,1e-05,0.01,0.984,0.9993057484032213,7215,7189
12,14504,10,100,1e-05,0.01,0.982,0.9986900165471594,7270,7234
12,14604,10,100,1e-05,0.01,0.986,0.9997261024376883,7323,7281
12,14704,10,100,1e-05,0.01,0.986,1.0,7375,7329
12,14804,10,100,1e-05,0.01,0.986,1.0,7423,7381
12,14904,10,100,1e-05,0.01,0.986,1.0,7463,7441
12,15004,10,100,1e-05,0.01,0.97,0.9916022394028259,7517,7487
13,104,10,100,1e-05,0.01,0.522,0.7596153846153846,56,48
13,204,10,100,1e-05,0.01,0.534,0.6911764705882353,104,100
13,304,10,100,1e-05,0.01,0.51,0.625,151,153
13,404,10,100,1e-05,0.01,0.492,0.6608910891089109,201,203
13,504,10,100,1e-05,0.01,0.496,0.6626984126984127,260,244
13,604,10,100,1e-05,0.01,0.496,0.6572847682119205,310,294
13,704,10,100,1e-05,0.01,0.522,0.6349431818181818,358,346
13,804,10,100,1e-05,0.01,0.478,0.6442786069651741,411,393
13,904,10,100,1e-05,0.01,0.516,0.6117256637168141,454,450
13,1004,10,100,1e-05,0.01,0.512,0.6792828685258964,505,499
13,1104,10,100,1e-05,0.01,0.522,0.6657608695652174,562,542
13,1204,10,100,1e-05,0.01,0.518,0.7009966777408638,611,593
13,1304,10,100,1e-05,0.01,0.512,0.6763803680981595,658,646
13,1404,10,100,1e-05,0.01,0.536,0.7236467236467237,704,700
13,1504,10,100,1e-05,0.01,0.532,0.7406914893617021,760,744
13,1604,10,100,1e-05,0.01,0.544,0.7443890274314214,805,799
13,1704,10,100,1e-05,0.01,0.548,0.7411971830985915,855,849
13,1804,10,100,1e-05,0.01,0.524,0.761640798226164,900,904
13,1904,10,100,1e-05,0.01,0.566,0.7563025210084033,948,956
13,2004,10,100,1e-05,0.01,0.536,0.7964071856287425,996,1008
13,2104,10,100,1e-05,0.01,0.562,0.7970532319391636,1041,1063
13,2204,10,100,1e-05,0.01,0.568,0.8325771324863884,1086,1118
13,2304,10,100,1e-05,0.01,0.584,0.8519965277777778,1139,1165
13,2404,10,100,1e-05,0.01,0.6,0.8668885191347754,1186,1218
13,2504,10,100,1e-05,0.01,0.644,0.8937699680511182,1239,1265
13,2604,10,100,1e-05,0.01,0.644,0.9124423963133641,1297,1307
13,2704,10,100,1e-05,0.01,0.638,0.9219674556213018,1346,1358
13,2804,10,100,1e-05,0.01,0.638,0.9044222539229672,1406,1398
13,2904,10,100,1e-05,0.01,0.676,0.928374655647383,1453,1451
13,3004,10,100,1e-05,0.01,0.698,0.9444074567243675,1500,1504
13,3104,10,100,1e-05,0.01,0.694,0.9423324742268041,1547,1557
13,3204,10,100,1e-05,0.01,0.7,0.9463171036204744,1591,1613
13,3304,10,100,1e-05,0.01,0.734,0.9555084745762712,1642,1662
13,3404,10,100,1e-05,0.01,0.71,0.9474148061104583,1691,1713
13,3504,10,100,1e-05,0.01,0.74,0.9058219178082192,1736,1768
13,3604,10,100,1e-05,0.01,0.78,0.9456159822419534,1787,1817
13,3704,10,100,1e-05,0.01,0.804,0.968682505399568,1843,1861
13,3804,10,100,1e-05,0.01,0.796,0.9784437434279706,1886,1918
13,3904,10,100,1e-05,0.01,0.826,0.9879610655737705,1944,1960
13,4004,10,100,1e-05,0.01,0.846,0.9845154845154845,2007,1997
13,4104,10,100,1e-05,0.01,0.834,0.9819688109161794,2055,2049
13,4204,10,100,1e-05,0.01,0.852,0.9845385347288297,2106,2098
13,4304,10,100,1e-05,0.01,0.868,0.987685873605948,2157,2147
13,4404,10,100,1e-05,0.01,0.852,0.9795640326975477,2206,2198
13,4504,10,100,1e-05,0.01,0.876,0.9891207815275311,2258,2246
13,4604,10,100,1e-05,0.01,0.868,0.9728496959165943,2302,2302
13,4704,10,100,1e-05,0.01,0.856,0.96875,2350,2354
13,4804,10,100,1e-05,0.01,0.898,0.9845961698584513,2408,2396
13,4904,10,100,1e-05,0.01,0.876,0.9765497553017944,2454,2450
13,5004,10,100,1e-05,0.01,0.886,0.978617106314948,2503,2501
13,5104,10,100,1e-05,0.01,0.898,0.9890282131661442,2551,2553
13,5204,10,100,1e-05,0.01,0.924,0.9925057647963106,2602,2602
13,5304,10,100,1e-05,0.01,0.928,0.997737556561086,2661,2643
13,5404,10,100,1e-05,0.01,0.922,0.9966691339748335,2709,2695
13,5504,10,100,1e-05,0.01,0.904,0.9838299418604651,2760,2744
13,5604,10,100,1e-05,0.01,0.928,0.9880442541042113,2810,2794
13,5704,10,100,1e-05,0.01,0.914,0.979663394109397,2858,2846
13,5804,10,100,1e-05,0.01,0.926,0.9848380427291523,2902,2902
13,5904,10,100,1e-05,0.01,0.938,0.9930555555555556,2950,2954
13,6004,10,100,1e-05,0.01,0.92,0.9913391072618255,2993,3011
13,6104,10,100,1e-05,0.01,0.948,0.9959043250327654,3043,3061
13,6204,10,100,1e-05,0.01,0.954,0.9954867827208252,3086,3118
13,6304,10,100,1e-05,0.01,0.954,0.9957170050761421,3135,3169
13,6404,10,100,1e-05,0.01,0.952,0.9967207995003123,3187,3217
13,6504,10,100,1e-05,0.01,0.954,0.997539975399754,3230,3274
13,6604,10,100,1e-05,0.01,0.948,0.9942459115687462,3287,3317
13,6704,10,100,1e-05,0.01,0.964,0.9962708830548926,3342,3362
13,6804,10,100,1e-05,0.01,0.956,0.9955908289241623,3388,3416
13,6904,10,100,1e-05,0.01,0.966,0.9994206257242179,3436,3468
13,7004,10,100,1e-05,0.01,0.962,0.9985722444317533,3482,3522
13,7104,10,100,1e-05,0.01,0.982,0.9984515765765766,3534,3570
13,7204,10,100,1e-05,0.01,0.968,0.9966685174902832,3579,3625
13,7304,10,100,1e-05,0.01,0.954,0.9913745892661555,3635,3669
13,7404,10,100,1e-05,0.01,0.95,0.9800108049702864,3679,3725
13,7504,10,100,1e-05,0.01,0.966,0.9852078891257996,3734,3770
13,7604,10,100,1e-05,0.01,0.972,0.9960547080483956,3772,3832
13,7704,10,100,1e-05,0.01,0.966,0.995846313603323,3828,3876
13,7804,10,100,1e-05,0.01,0.976,0.9987186058431573,3882,3922
13,7904,10,100,1e-05,0.01,0.982,0.999746963562753,3937,3967
13,8004,10,100,1e-05,0.01,0.984,0.9995002498750625,3979,4025
13,8104,10,100,1e-05,0.01,0.982,1.0,4030,4074
13,8204,10,100,1e-05,0.01,0.982,0.9984154071184788,4080,4124
13,8304,10,100,1e-05,0.01,0.966,0.9934971098265896,4132,4172
13,8404,10,100,1e-05,0.01,0.98,0.9973821989528796,4185,4219
13,8504,10,100,1e-05,0.01,0.976,0.9960018814675446,4234,4270
13,8604,10,100,1e-05,0.01,0.97,0.9875639237563923,4286,4318
13,8704,10,100,1e-05,0.01,0.978,0.9929917279411765,4339,4365
13,8804,10,100,1e-05,0.01,0.986,0.9939800090867787,4393,4411
13,8904,10,100,1e-05,0.01,0.972,0.9953953279424977,4446,4458
13,9004,10,100,1e-05,0.01,0.98,0.992225677476677,4489,4515
13,9104,10,100,1e-05,0.01,0.986,0.9973637961335676,4542,4562
13,9204,10,100,1e-05,0.01,0.976,0.9976097348978705,4592,4612
13,9304,10,100,1e-05,0.01,0.988,0.9984952708512468,4645,4659
13,9404,10,100,1e-05,0.01,0.986,0.9933007230965547,4690,4714
13,9504,10,100,1e-05,0.01,0.988,0.9942129629629629,4735,4769
13,9604,10,100,1e-05,0.01,0.984,0.9936484798000833,4786,4818
13,9704,10,100,1e-05,0.01,0.99,0.9977328936521023,4846,4858
13,9804,10,100,1e-05,0.01,0.988,0.998062015503876,4898,4906
13,9904,10,100,1e-05,0.01,0.994,0.9985864297253635,4937,4967
13,10004,10,100,1e-05,0.01,0.99,0.999500199920032,4986,5018
13,10104,10,100,1e-05,0.01,0.988,1.0,5027,5077
13,10204,10,100,1e-05,0.01,0.99,0.9999019992159938,5066,5138
13,10304,10,100,1e-05,0.01,0.988,0.9984472049689441,5118,5186
13,10404,10,100,1e-05,0.01,0.992,0.9994232987312572,5167,5237
13,10504,10,100,1e-05,0.01,0.99,0.9988575780654989,5222,5282
13,10604,10,100,1e-05,0.01,0.984,0.9959449264428517,5277,5327
13,10704,10,100,1e-05,0.01,0.988,0.9928064275037369,5326,5378
13,10804,10,100,1e-05,0.01,0.978,0.993891151425398,5382,5422
13,10904,10,100,1e-05,0.01,0.976,0.9894534115920763,5434,5470
13,11004,10,100,1e-05,0.01,0.992,0.9967284623773174,5480,5524
13,11104,10,100,1e-05,0.01,0.992,0.9985590778097982,5531,5573
13,11204,10,100,1e-05,0.01,0.99,0.9990182077829347,5586,5618
13,11304,10,100,1e-05,0.01,0.992,0.9985845718329794,5636,5668
13,11404,10,100,1e-05,0.01,0.99,0.9953525078919677,5691,5713
13,11504,10,100,1e-05,0.01,0.986,0.9925243393602226,5738,5766
13,11604,10,100,1e-05,0.01,0.976,0.9854360565322303,5793,5811
13,11704,10,100,1e-05,0.01,0.994,0.9994019138755981,5839,5865
13,11804,10,100,1e-05,0.01,0.996,1.0,5905,5899
13,11904,10,100,1e-05,0.01,0.988,0.9999159946236559,5952,5952
13,12004,10,100,1e-05,0.01,0.988,0.9997500833055648,6006,5998
13,12104,10,100,1e-05,0.01,0.988,0.9995869134170522,6057,6047
13,12204,10,100,1e-05,0.01,0.994,0.998934775483448,6098,6106
13,12304,10,100,1e-05,0.01,0.984,0.9947984395318595,6152,6152
13,12404,10,100,1e-05,0.01,0.99,0.9925830377297646,6204,6200
13,12504,10,100,1e-05,0.01,0.996,0.9955214331413947,6253,6251
13,12604,10,100,1e-05,0.01,0.988,0.9957156458267217,6309,6295
13,12704,10,100,1e-05,0.01,0.996,0.9983469773299748,6364,6340
13,12804,10,100,1e-05,0.01,0.992,0.9985941893158388,6411,6393
13,12904,10,100,1e-05,0.01,0.996,0.9992250464972101,6469,6435
13,13004,10,100,1e-05,0.01,0.996,0.9996155029221778,6519,6485
13,13104,10,100,1e-05,0.01,0.998,1.0,6569,6535
13,13204,10,100,1e-05,0.01,0.996,1.0,6611,6593
13,13304,10,100,1e-05,0.01,0.996,1.0,6664,6640
13,13404,10,100,1e-05,0.01,0.996,1.0,6705,6699
13,13504,10,100,1e-05,0.01,0.998,0.9998518957345972,6758,6746
13,13604,10,100,1e-05,0.01,0.994,0.9936048221111438,6807,6797
13,13704,10,100,1e-05,0.01,0.986,0.9921190893169878,6853,6851
13,13804,10,100,1e-05,0.01,0.992,0.9980440452042886,6904,6900
13,13904,10,100,1e-05,0.01,0.996,0.999928078250863,6951,6953
13,14004,10,100,1e-05,0.01,0.994,1.0,7005,6999
13,14104,10,100,1e-05,0.01,0.994,1.0,7047,7057
13,14204,10,100,1e-05,0.01,0.998,0.9985919459307238,7095,7109
13,14304,10,100,1e-05,0.01,0.996,0.9995106263982103,7144,7160
13,14404,10,100,1e-05,0.01,0.994,0.9960427658983616,7197,7207
13,14504,10,100,1e-05,0.01,0.998,0.9966216216216216,7246,7258
13,14604,10,100,1e-05,0.01,0.994,0.9965078060805259,7295,7309
13,14704,10,100,1e-05,0.01,0.996,0.9985038084874864,7349,7355
13,14804,10,100,1e-05,0.01,0.998,0.9983112672250744,7397,7407
13,14904,10,100,1e-05,0.01,0.996,0.9992619431025228,7448,7456
13,15004,10,100,1e-05,0.01,0.996,0.9998000533191149,7495,7509
14,104,10,100,1e-05,0.01,0.506,0.5192307692307693,54,50
14,204,10,100,1e-05,0.01,0.524,0.6078431372549019,103,101
14,304,10,100,1e-05,0.01,0.512,0.6151315789473685,155,149
14,404,10,100,1e-05,0.01,0.48,0.6262376237623762,205,199
14,504,10,100,1e-05,0.01,0.5,0.6150793650793651,251,253
14,604,10,100,1e-05,0.01,0.5,0.6473509933774835,297,307
14,704,10,100,1e-05,0.01,0.48,0.6463068181818182,349,355
14,804,10,100,1e-05,0.01,0.522,0.6703980099502488,401,403
14,904,10,100,1e-05,0.01,0.542,0.6548672566371682,446,458
14,1004,10,100,1e-05,0.01,0.534,0.6922310756972112,500,504
14,1104,10,100,1e-05,0.01,0.51,0.6757246376811594,539,565
14,1204,10,100,1e-05,0.01,0.528,0.6370431893687708,588,616
14,1304,10,100,1e-05,0.01,0.496,0.6656441717791411,636,668
14,1404,10,100,1e-05,0.01,0.504,0.6894586894586895,682,722
14,1504,10,100,1e-05,0.01,0.484,0.7034574468085106,735,769
14,1604,10,100,1e-05,0.01,0.518,0.7288029925187033,785,819
14,1704,10,100,1e-05,0.01,0.53,0.7306338028169014,836,868
14,1804,10,100,1e-05,0.01,0.51,0.7732815964523282,890,914
14,1904,10,100,1e-05,0.01,0.528,0.7736344537815126,944,960
14,2004,10,100,1e-05,0.01,0.536,0.7789421157684631,990,1014
14,2104,10,100,1e-05,0.01,0.554,0.8003802281368821,1040,1064
14,2204,10,100,1e-05,0.01,0.546,0.8112522686025408,1098,1106
14,2304,10,100,1e-05,0.01,0.576,0.7986111111111112,1152,1152
14,2404,10,100,1e-05,0.01,0.584,0.836522462562396,1202,1202
14,2504,10,100,1e-05,0.01,0.578,0.8019169329073482,1252,1252
14,2604,10,100,1e-05,0.01,0.63,0.8398617511520737,1308,1296
14,2704,10,100,1e-05,0.01,0.6,0.8276627218934911,1361,1343
14,2804,10,100,1e-05,0.01,0.638,0.8862339514978602,1400,1404
14,2904,10,100,1e-05,0.01,0.664,0.8942837465564738,1458,1446
14,3004,10,100,1e-05,0.01,0.682,0.9304260985352862,1504,1500
14,3104,10,100,1e-05,0.01,0.682,0.9172036082474226,1559,1545
14,3204,10,100,1e-05,0.01,0.69,0.9453807740324595,1607,1597
14,3304,10,100,1e-05,0.01,0.72,0.9430992736077481,1660,1644
14,3404,10,100,1e-05,0.01,0.754,0.9644535840188014,1701,1703
14,3504,10,100,1e-05,0.01,0.75,0.9714611872146118,1750,1754
14,3604,10,100,1e-05,0.01,0.786,0.9636514983351832,1796,1808
14,3704,10,100,1e-05,0.01,0.78,0.9816414686825053,1853,1851
14,3804,10,100,1e-05,0.01,0.796,0.980546792849632,1895,1909
14,3904,10,100,1e-05,0.01,0.79,0.9651639344262295,1951,1953
14,4004,10,100,1e-05,0.01,0.816,0.9837662337662337,2009,1995
14,4104,10,100,1e-05,0.01,0.844,0.99317738791423,2059,2045
14,4204,10,100,1e-05,0.01,0.852,0.9950047573739296,2107,2097
14,4304,10,100,1e-05,0.01,0.848,0.9925650557620818,2154,2150
14,4404,10,100,1e-05,0.01,0.852,0.9940962761126249,2209,2195
14,4504,10,100,1e-05,0.01,0.876,0.9946714031971581,2263,2241
14,4604,10,100,1e-05,0.01,0.864,0.9889226759339704,2312,2292
14,4704,10,100,1e-05,0.01,0.852,0.9897959183673469,2359,2345
14,4804,10,100,1e-05,0.01,0.858,0.9883430474604497,2407,2397
14,4904,10,100,1e-05,0.01,0.882,0.983278955954323,2458,2446
14,5004,10,100,1e-05,0.01,0.88,0.9782174260591526,2507,2497
14,5104,10,100,1e-05,0.01,0.85,0.9586598746081505,2562,2542
14,5204,10,100,1e-05,0.01,0.872,0.9832820906994619,2618,2586
14,5304,10,100,1e-05,0.01,0.88,0.9760558069381599,2666,2638
14,5404,10,100,1e-05,0.01,0.874,0.959659511472983,2707,2697
14,5504,10,100,1e-05,0.01,0.876,0.9351380813953488,2767,2737
14,5604,10,100,1e-05,0.01,0.904,0.9757316202712348,2809,2795
14,5704,10,100,1e-05,0.01,0.918,0.9901823281907434,2868,2836
14,5804,10,100,1e-05,0.01,0.928,0.9939696760854583,2911,2893
14,5904,10,100,1e-05,0.01,0.944,0.9954268292682927,2959,2945
14,6004,10,100,1e-05,0.01,0.946,0.9963357761492339,3013,2991
14,6104,10,100,1e-05,0.01,0.944,0.9990170380078637,3060,3044
14,6204,10,100,1e-05,0.01,0.94,0.9974210186976145,3116,3088
14,6304,10,100,1e-05,0.01,0.944,0.9979378172588832,3162,3142
14,6404,10,100,1e-05,0.01,0.946,0.9975015615240475,3206,3198
14,6504,10,100,1e-05,0.01,0.938,0.998769987699877,3255,3249
14,6604,10,100,1e-05,0.01,0.942,0.9980314960629921,3296,3308
14,6704,10,100,1e-05,0.01,0.94,0.9971658711217184,3343,3361
14,6804,10,100,1e-05,0.01,0.95,0.9982363315696648,3395,3409
14,6904,10,100,1e-05,0.01,0.938,0.996234067207416,3437,3467
14,7004,10,100,1e-05,0.01,0.942,0.9988577955454027,3483,3521
14,7104,10,100,1e-05,0.01,0.95,0.9998592342342343,3535,3569
14,7204,10,100,1e-05,0.01,0.95,0.9991671293725708,3583,3621
14,7304,10,100,1e-05,0.01,0.954,0.9998630887185104,3641,3663
14,7404,10,100,1e-05,0.01,0.946,0.9989195029713668,3693,3711
14,7504,10,100,1e-05,0.01,0.952,0.9969349680170576,3737,3767
14,7604,10,100,1e-05,0.01,0.946,0.9917148869016307,3794,3810
14,7704,10,100,1e-05,0.01,0.884,0.9500259605399792,3850,3854
14,7804,10,100,1e-05,0.01,0.938,0.9851358277806254,3899,3905
14,7904,10,100,1e-05,0.01,0.938,0.9898785425101214,3947,3957
14,8004,10,100,1e-05,0.01,0.944,0.9956271864067966,4005,3999
14,8104,10,100,1e-05,0.01,0.96,0.9995064165844028,4056,4048
14,8204,10,100,1e-05,0.01,0.962,0.999756216479766,4110,4094
14,8304,10,100,1e-05,0.01,0.972,0.9989161849710982,4154,4150
14,8404,10,100,1e-05,0.01,0.966,0.9997620180866255,4202,4202
14,8504,10,100,1e-05,0.01,0.972,0.9998824082784572,4244,4260
14,8604,10,100,1e-05,0.01,0.974,0.9998837749883775,4301,4303
14,8704,10,100,1e-05,0.01,0.97,0.9998851102941176,4358,4346
14,8804,10,100,1e-05,0.01,0.964,0.9997728305315765,4396,4408
14,8904,10,100,1e-05,0.01,0.966,0.9992138364779874,4449,4455
14,9004,10,100,1e-05,0.01,0.958,0.9948911594846734,4499,4505
14,9104,10,100,1e-05,0.01,0.962,0.9957161687170475,4555,4549
14,9204,10,100,1e-05,0.01,0.958,0.9951108213820078,4607,4597
14,9304,10,100,1e-05,0.01,0.958,0.9863499570077386,4665,4639
14,9404,10,100,1e-05,0.01,0.958,0.9973415567843471,4721,4683
14,9504,10,100,1e-05,0.01,0.974,0.999263468013468,4771,4733
14,9604,10,100,1e-05,0.01,0.968,0.9993752603082049,4823,4781
14,9704,10,100,1e-05,0.01,0.962,0.998351195383347,4875,4829
14,9804,10,100,1e-05,0.01,0.954,0.99265605875153,4931,4873
14,9904,10,100,1e-05,0.01,0.948,0.9809168012924071,4973,4931
14,10004,10,100,1e-05,0.01,0.966,0.9949020391843263,5017,4987
14,10104,10,100,1e-05,0.01,0.98,0.9987133808392715,5067,5037
14,10204,10,100,1e-05,0.01,0.98,0.9986279890239121,5117,5087
14,10304,10,100,1e-05,0.01,0.982,0.99902950310559,5167,5137
14,10404,10,100,1e-05,0.01,0.982,0.9998077662437524,5220,5184
14,10504,10,100,1e-05,0.01,0.982,0.9997143945163747,5276,5228
14,10604,10,100,1e-05,0.01,0.982,0.998113919275745,5320,5284
14,10704,10,100,1e-05,0.01,0.974,0.9980381165919282,5364,5340
14,10804,10,100,1e-05,0.01,0.982,0.9991669751943725,5405,5399
14,10904,10,100,1e-05,0.01,0.984,0.9994497432134997,5458,5446
14,11004,10,100,1e-05,0.01,0.98,0.9997273718647764,5514,5490
14,11104,10,100,1e-05,0.01,0.984,0.9999099423631124,5566,5538
14,11204,10,100,1e-05,0.01,0.986,0.9992859692966798,5607,5597
14,11304,10,100,1e-05,0.01,0.98,1.0,5662,5642
14,11404,10,100,1e-05,0.01,0.982,1.0,5716,5688
14,11504,10,100,1e-05,0.01,0.98,0.9953929068150209,5761,5743
14,11604,10,100,1e-05,0.01,0.972,0.9928472940365392,5804,5800
14,11704,10,100,1e-05,0.01,0.968,0.9896616541353384,5853,5851
14,11804,10,100,1e-05,0.01,0.968,0.9971196204676381,5901,5903
14,11904,10,100,1e-05,0.01,0.976,0.9972278225806451,5956,5948
14,12004,10,100,1e-05,0.01,0.974,0.9980006664445185,6009,5995
14,12104,10,100,1e-05,0.01,0.982,0.9991738268341044,6057,6047
14,12204,10,100,1e-05,0.01,0.95,0.9836938708620124,6110,6094
14,12304,10,100,1e-05,0.01,0.962,0.9829323797139142,6172,6132
14,12404,10,100,1e-05,0.01,0.974,0.9915349887133182,6232,6172
14,12504,10,100,1e-05,0.01,0.984,0.997680742162508,6276,6228
14,12604,10,100,1e-05,0.01,0.986,0.9984132021580451,6324,6280
14,12704,10,100,1e-05,0.01,0.99,0.9993702770780857,6370,6334
14,12804,10,100,1e-05,0.01,0.988,0.9992189940643549,6433,6371
14,12904,10,100,1e-05,0.01,0.988,0.9993800371977681,6482,6422
14,13004,10,100,1e-05,0.01,0.988,0.9986927099354045,6528,6476
14,13104,10,100,1e-05,0.01,0.986,0.9995421245421245,6570,6534
14,13204,10,100,1e-05,0.01,0.986,0.9993941229930324,6628,6576
14,13304,10,100,1e-05,0.01,0.984,0.997294046903187,6678,6626
14,13404,10,100,1e-05,0.01,0.984,0.993509400179051,6735,6669
14,13504,10,100,1e-05,0.01,0.976,0.9968898104265402,6793,6711
14,13604,10,100,1e-05,0.01,0.984,0.9981623052043517,6837,6767
14,13704,10,100,1e-05,0.01,0.984,0.9992702860478693,6879,6825
14,13804,10,100,1e-05,0.01,0.984,0.9995653433787308,6928,6876
14,13904,10,100,1e-05,0.01,0.986,0.999928078250863,6977,6927
14,14004,10,100,1e-05,0.01,0.988,1.0,7029,6975
14,14104,10,100,1e-05,0.01,0.986,0.9997872943845717,7078,7026
14,14204,10,100,1e-05,0.01,0.99,0.9998591945930724,7124,7080
14,14304,10,100,1e-05,0.01,0.99,0.9998601789709173,7170,7134
14,14404,10,100,1e-05,0.01,0.992,0.9998611496806442,7213,7191
14,14504,10,100,1e-05,0.01,0.994,1.0,7264,7240
14,14604,10,100,1e-05,0.01,0.994,1.0,7314,7290
14,14704,10,100,1e-05,0.01,0.994,1.0,7364,7340
14,14804,10,100,1e-05,0.01,0.986,0.9987165630910565,7407,7397
14,14904,10,100,1e-05,0.01,0.988,0.9943639291465378,7455,7449
14,15004,10,100,1e-05,0.01,0.982,0.9923353772327379,7502,7502
15,104,10,100,1e-05,0.01,0.5,0.7307692307692307,55,49
15,204,10,100,1e-05,0.01,0.518,0.6715686274509803,97,107
15,304,10,100,1e-05,0.01,0.51,0.6677631578947368,145,159
15,404,10,100,1e-05,0.01,0.526,0.7004950495049505,189,215
15,504,10,100,1e-05,0.01,0.486,0.6686507936507936,242,262
15,604,10,100,1e-05,0.01,0.538,0.7003311258278145,289,315
15,704,10,100,1e-05,0.01,0.504,0.6633522727272727,344,360
15,804,10,100,1e-05,0.01,0.498,0.6741293532338308,396,408
15,904,10,100,1e-05,0.01,0.544,0.6537610619469026,449,455
15,1004,10,100,1e-05,0.01,0.532,0.6862549800796812,496,508
15,1104,10,100,1e-05,0.01,0.552,0.6702898550724637,540,564
15,1204,10,100,1e-05,0.01,0.518,0.6785714285714286,594,610
15,1304,10,100,1e-05,0.01,0.55,0.6993865030674846,645,659
15,1404,10,100,1e-05,0.01,0.524,0.7122507122507122,696,708
15,1504,10,100,1e-05,0.01,0.522,0.706781914893617,745,759
15,1604,10,100,1e-05,0.01,0.544,0.7256857855361596,799,805
15,1704,10,100,1e-05,0.01,0.528,0.7136150234741784,850,854
15,1804,10,100,1e-05,0.01,0.534,0.717849223946785,893,911
15,1904,10,100,1e-05,0.01,0.544,0.7463235294117647,950,954
15,2004,10,100,1e-05,0.01,0.564,0.7759481037924152,1002,1002
15,2104,10,100,1e-05,0.01,0.566,0.7709125475285171,1046,1058
15,2204,10,100,1e-05,0.01,0.552,0.8148820326678766,1095,1109
15,2304,10,100,1e-05,0.01,0.554,0.8229166666666666,1140,1164
15,2404,10,100,1e-05,0.01,0.602,0.8340266222961731,1182,1222
15,2504,10,100,1e-05,0.01,0.608,0.8306709265175719,1237,1267
15,2604,10,100,1e-05,0.01,0.6,0.8559907834101382,1281,1323
15,2704,10,100,1e-05,0.01,0.616,0.8176775147928994,1331,1373
15,2804,10,100,1e-05,0.01,0.648,0.8459343794579173,1383,1421
15,2904,10,100,1e-05,0.01,0.674,0.821625344352617,1437,1467
15,3004,10,100,1e-05,0.01,0.692,0.8764980026631158,1494,1510
15,3104,10,100,1e-05,0.01,0.704,0.8795103092783505,1537,1567
15,3204,10,100,1e-05,0.01,0.732,0.9179151061173533,1590,1614
15,3304,10,100,1e-05,0.01,0.734,0.9461259079903148,1636,1668
15,3404,10,100,1e-05,0.01,0.752,0.9529964747356052,1687,1717
15,3504,10,100,1e-05,0.01,0.782,0.9315068493150684,1743,1761
15,3604,10,100,1e-05,0.01,0.788,0.9531076581576027,1800,1804
15,3704,10,100,1e-05,0.01,0.796,0.9578833693304536,1842,1862
15,3804,10,100,1e-05,0.01,0.818,0.9716088328075709,1895,1909
15,3904,10,100,1e-05,0.01,0.83,0.9800204918032787,1953,1951
15,4004,10,100,1e-05,0.01,0.812,0.985014985014985,2001,2003
15,4104,10,100,1e-05,0.01,0.79,0.9519980506822612,2048,2056
15,4204,10,100,1e-05,0.01,0.826,0.9683634633682208,2101,2103
15,4304,10,100,1e-05,0.01,0.846,0.9867565055762082,2144,2160
15,4404,10,100,1e-05,0.01,0.824,0.9722979109900091,2197,2207
15,4504,10,100,1e-05,0.01,0.868,0.9882326820603907,2253,2251
15,4604,10,100,1e-05,0.01,0.858,0.9713292788879235,2297,2307
15,4704,10,100,1e-05,0.01,0.848,0.9436649659863946,2355,2349
15,4804,10,100,1e-05,0.01,0.866,0.9698168193172356,2399,2405
15,4904,10,100,1e-05,0.01,0.886,0.984910277324633,2444,2460
15,5004,10,100,1e-05,0.01,0.864,0.9836131095123901,2491,2513
15,5104,10,100,1e-05,0.01,0.854,0.9727664576802508,2535,2569
15,5204,10,100,1e-05,0.01,0.894,0.9878939277478862,2579,2625
15,5304,10,100,1e-05,0.01,0.896,0.995475113122172,2641,2663
15,5404,10,100,1e-05,0.01,0.902,0.9944485566247224,2689,2715
15,5504,10,100,1e-05,0.01,0.91,0.9963662790697675,2745,2759
15,5604,10,100,1e-05,0.01,0.916,0.9966095645967167,2792,2812
15,5704,10,100,1e-05,0.01,0.912,0.9973702664796634,2845,2859
15,5804,10,100,1e-05,0.01,0.906,0.9946588559614059,2902,2902
15,5904,10,100,1e-05,0.01,0.918,0.9940718157181572,2945,2959
15,6004,10,100,1e-05,0.01,0.91,0.9951698867421719,2988,3016
15,6104,10,100,1e-05,0.01,0.924,0.9960681520314548,3039,3065
15,6204,10,100,1e-05,0.01,0.932,0.9970986460348162,3091,3113
15,6304,10,100,1e-05,0.01,0.934,0.9961928934010152,3141,3163
15,6404,10,100,1e-05,0.01,0.926,0.9925046845721424,3189,3215
15,6504,10,100,1e-05,0.01,0.928,0.9849323493234933,3242,3262
15,6604,10,100,1e-05,0.01,0.908,0.9860690490611751,3288,3316
15,6704,10,100,1e-05,0.01,0.912,0.9540572792362768,3335,3369
15,6804,10,100,1e-05,0.01,0.936,0.9864785420340976,3379,3425
15,6904,10,100,1e-05,0.01,0.95,0.9923232908458864,3426,3478
15,7004,10,100,1e-05,0.01,0.936,0.991719017704169,3482,3522
15,7104,10,100,1e-05,0.01,0.944,0.9969031531531531,3535,3569
15,7204,10,100,1e-05,0.01,0.944,0.9983342587451416,3584,3620
15,7304,10,100,1e-05,0.01,0.934,0.9938389923329682,3630,3674
15,7404,10,100,1e-05,0.01,0.958,0.9967585089141004,3684,3720
15,7504,10,100,1e-05,0.01,0.956,0.9968017057569296,3733,3771
15,7604,10,100,1e-05,0.01,0.96,0.9963177275118359,3778,3826
15,7704,10,100,1e-05,0.01,0.958,0.9968847352024922,3823,3881
15,7804,10,100,1e-05,0.01,0.95,0.9967965146078934,3872,3932
15,7904,10,100,1e-05,0.01,0.942,0.9825404858299596,3929,3975
15,8004,10,100,1e-05,0.01,0.964,0.992503748125937,3977,4027
15,8104,10,100,1e-05,0.01,0.962,0.9977788746298124,4025,4079
15,8204,10,100,1e-05,0.01,0.966,0.9964651389566065,4076,4128
15,8304,10,100,1e-05,0.01,0.962,0.997471098265896,4135,4169
15,8404,10,100,1e-05,0.01,0.962,0.9958353165159448,4187,4217
15,8504,10,100,1e-05,0.01,0.964,0.9978833490122295,4233,4271
15,8604,10,100,1e-05,0.01,0.954,0.9941887494188749,4283,4321
15,8704,10,100,1e-05,0.01,0.97,0.998046875,4335,4369
15,8804,10,100,1e-05,0.01,0.974,0.9994320763289414,4381,4423
15,8904,10,100,1e-05,0.01,0.97,0.9973045822102425,4427,4477
15,9004,10,100,1e-05,0.01,0.97,0.997001332741004,4474,4530
15,9104,10,100,1e-05,0.01,0.97,0.9989015817223199,4533,4571
15,9204,10,100,1e-05,0.01,0.982,0.9989135158626684,4584,4620
15,9304,10,100,1e-05,0.01,0.978,0.9995700773860705,4631,4673
15,9404,10,100,1e-05,0.01,0.972,1.0,4672,4732
15,9504,10,100,1e-05,0.01,0.978,1.0,4721,4783
15,9604,10,100,1e-05,0.01,0.96,0.9846938775510204,4773,4831
15,9704,10,100,1e-05,0.01,0.948,0.9833058532563891,4822,4882
15,9804,10,100,1e-05,0.01,0.95,0.9773561811505508,4877,4927
15,9904,10,100,1e-05,0.01,0.956,0.990407915993538,4930,4974
15,10004,10,100,1e-05,0.01,0.968,0.9926029588164734,4978,5026
15,10104,10,100,1e-05,0.01,0.976,0.9985154394299287,5020,5084
15,10204,10,100,1e-05,0.01,0.982,0.9994119952959624,5067,5137
15,10304,10,100,1e-05,0.01,0.976,0.999708850931677,5114,5190
15,10404,10,100,1e-05,0.01,0.97,0.9961553248750481,5164,5240
15,10504,10,100,1e-05,0.01,0.964,0.990955826351866,5216,5288
15,10604,10,100,1e-05,0.01,0.97,0.9937759336099585,5261,5343
15,10704,10,100,1e-05,0.01,0.972,0.9974775784753364,5316,5388
15,10804,10,100,1e-05,0.01,0.974,0.9953720844131803,5367,5437
15,10904,10,100,1e-05,0.01,0.968,0.9950476889214968,5418,5486
15,11004,10,100,1e-05,0.01,0.972,0.9984551072337332,5465,5539
15,11104,10,100,1e-05,0.01,0.976,0.9980187319884726,5515,5589
15,11204,10,100,1e-05,0.01,0.974,0.9994644769725098,5569,5635
15,11304,10,100,1e-05,0.01,0.972,0.9982307147912244,5616,5688
15,11404,10,100,1e-05,0.01,0.984,0.997369344089793,5661,5743
15,11504,10,100,1e-05,0.01,0.978,0.9970445062586927,5705,5799
15,11604,10,100,1e-05,0.01,0.982,0.9967252671492589,5752,5852
15,11704,10,100,1e-05,0.01,0.984,0.9984620642515379,5807,5897
15,11804,10,100,1e-05,0.01,0.986,0.9911047102677059,5856,5948
15,11904,10,100,1e-05,0.01,0.98,0.9938676075268817,5904,6000
15,12004,10,100,1e-05,0.01,0.966,0.9911696101299566,5957,6047
15,12104,10,100,1e-05,0.01,0.972,0.9965300727032386,6015,6089
15,12204,10,100,1e-05,0.01,0.976,0.9971320878400525,6076,6128
15,12304,10,100,1e-05,0.01,0.978,0.9973992197659298,6122,6182
15,12404,10,100,1e-05,0.01,0.986,0.9985488552079974,6167,6237
15,12504,10,100,1e-05,0.01,0.986,0.9980006397952655,6220,6284
15,12604,10,100,1e-05,0.01,0.988,0.9989685814027293,6270,6334
15,12704,10,100,1e-05,0.01,0.984,0.9995277078085643,6318,6386
15,12804,10,100,1e-05,0.01,0.984,0.9981255857544518,6370,6434
15,12904,10,100,1e-05,0.01,0.978,0.9945753254804711,6435,6469
15,13004,10,100,1e-05,0.01,0.98,0.9946939403260535,6486,6518
15,13104,10,100,1e-05,0.01,0.98,0.9945054945054945,6539,6565
15,13204,10,100,1e-05,0.01,0.986,0.9987125113601939,6598,6606
15,13304,10,100,1e-05,0.01,0.988,0.998947684906795,6650,6654
15,13404,10,100,1e-05,0.01,0.986,0.9993285586392122,6705,6699
15,13504,10,100,1e-05,0.01,0.986,0.9991113744075829,6754,6750
15,13604,10,100,1e-05,0.01,0.988,0.9997794766245222,6808,6796
15,13704,10,100,1e-05,0.01,0.988,0.9998540572095739,6858,6846
15,13804,10,100,1e-05,0.01,0.988,0.9996377861489424,6907,6897
15,13904,10,100,1e-05,0.01,0.988,0.9998561565017261,6959,6945
15,14004,10,100,1e-05,0.01,0.978,0.995144244501571,7019,6985
15,14104,10,100,1e-05,0.01,0.988,0.9996454906409529,7066,7038
15,14204,10,100,1e-05,0.01,0.99,1.0,7109,7095
15,14304,10,100,1e-05,0.01,0.99,0.9990911633109619,7168,7136
15,14404,10,100,1e-05,0.01,0.988,0.9922938072757568,7211,7193
15,14504,10,100,1e-05,0.01,0.972,0.9867622724765582,7271,7233
15,14604,10,100,1e-05,0.01,0.982,0.994590523144344,7317,7287
15,14704,10,100,1e-05,0.01,0.988,0.9974156692056583,7361,7343
15,14804,10,100,1e-05,0.01,0.982,0.9982437179140773,7419,7385
15,14904,10,100,1e-05,0.01,0.986,0.999194847020934,7463,7441
15,15004,10,100,1e-05,0.01,0.988,0.9998667022127433,7525,7479
16,104,10,100,1e-05,0.01,0.508,0.7403846153846154,58,46
16,204,10,100,1e-05,0.01,0.458,0.6666666666666666,100,104
16,304,10,100,1e-05,0.01,0.494,0.618421052631579,146,158
16,404,10,100,1e-05,0.01,0.474,0.6534653465346535,199,205
16,504,10,100,1e-05,0.01,0.486,0.6309523809523809,245,259
16,604,10,100,1e-05,0.01,0.47,0.6307947019867549,291,313
16,704,10,100,1e-05,0.01,0.488,0.6079545454545454,333,371
16,804,10,100,1e-05,0.01,0.486,0.5932835820895522,375,429
16,904,10,100,1e-05,0.01,0.51,0.6415929203539823,423,481
16,1004,10,100,1e-05,0.01,0.5,0.6284860557768924,479,525
16,1104,10,100,1e-05,0.01,0.524,0.6512681159420289,533,571
16,1204,10,100,1e-05,0.01,0.512,0.6802325581395349,582,622
16,1304,10,100,1e-05,0.01,0.488,0.6771472392638037,622,682
16,1404,10,100,1e-05,0.01,0.502,0.7122507122507122,683,721
16,1504,10,100,1e-05,0.01,0.488,0.6675531914893617,729,775
16,1604,10,100,1e-05,0.01,0.514,0.7275561097256857,782,822
16,1704,10,100,1e-05,0.01,0.482,0.7188967136150235,834,870
16,1804,10,100,1e-05,0.01,0.482,0.766629711751663,879,925
16,1904,10,100,1e-05,0.01,0.52,0.7400210084033614,933,971
16,2004,10,100,1e-05,0.01,0.524,0.7634730538922155,987,1017
16,2104,10,100,1e-05,0.01,0.534,0.75,1035,1069
16,2204,10,100,1e-05,0.01,0.542,0.7958257713248639,1084,1120
16,2304,10,100,1e-05,0.01,0.512,0.7816840277777778,1135,1169
16,2404,10,100,1e-05,0.01,0.528,0.7978369384359401,1187,1217
16,2504,10,100,1e-05,0.01,0.542,0.78314696485623,1242,1262
16,2604,10,100,1e-05,0.01,0.546,0.814900153609831,1298,1306
16,2704,10,100,1e-05,0.01,0.556,0.8446745562130178,1347,1357
16,2804,10,100,1e-05,0.01,0.588,0.862339514978602,1399,1405
16,2904,10,100,1e-05,0.01,0.592,0.8419421487603306,1454,1450
16,3004,10,100,1e-05,0.01,0.61,0.8881491344873502,1515,1489
16,3104,10,100,1e-05,0.01,0.632,0.9101159793814433,1567,1537
16,3204,10,100,1e-05,0.01,0.656,0.9269662921348315,1617,1587
16,3304,10,100,1e-05,0.01,0.698,0.9291767554479419,1669,1635
16,3404,10,100,1e-05,0.01,0.686,0.9430082256169212,1717,1687
16,3504,10,100,1e-05,0.01,0.694,0.961472602739726,1774,1730
16,3604,10,100,1e-05,0.01,0.702,0.9594894561598224,1825,1779
16,3704,10,100,1e-05,0.01,0.74,0.9738120950323974,1870,1834
16,3804,10,100,1e-05,0.01,0.778,0.9768664563617245,1918,1886
16,3904,10,100,1e-05,0.01,0.786,0.9805327868852459,1973,1931
16,4004,10,100,1e-05,0.01,0.784,0.9675324675324676,2017,1987
16,4104,10,100,1e-05,0.01,0.738,0.9037524366471735,2067,2037
16,4204,10,100,1e-05,0.01,0.792,0.9400570884871551,2122,2082
16,4304,10,100,1e-05,0.01,0.812,0.9493494423791822,2170,2134
16,4404,10,100,1e-05,0.01,0.81,0.9618528610354223,2221,2183
16,4504,10,100,1e-05,0.01,0.834,0.9820159857904085,2276,2228
16,4604,10,100,1e-05,0.01,0.858,0.9869678540399652,2330,2274
16,4704,10,100,1e-05,0.01,0.862,0.9927721088435374,2379,2325
16,4804,10,100,1e-05,0.01,0.874,0.9898001665278934,2429,2375
16,4904,10,100,1e-05,0.01,0.848,0.9653344208809136,2480,2424
16,5004,10,100,1e-05,0.01,0.878,0.9890087929656275,2533,2471
16,5104,10,100,1e-05,0.01,0.892,0.9939263322884012,2585,2519
16,5204,10,100,1e-05,0.01,0.876,0.9950038431975403,2630,2574
16,5304,10,100,1e-05,0.01,0.898,0.996606334841629,2677,2627
16,5404,10,100,1e-05,0.01,0.894,0.9975943745373798,2723,2681
16,5504,10,100,1e-05,0.01,0.908,0.9974563953488372,2778,2726
16,5604,10,100,1e-05,0.01,0.896,0.9985724482512491,2830,2774
16,5704,10,100,1e-05,0.01,0.902,0.9987727910238429,2890,2814
16,5804,10,100,1e-05,0.01,0.906,0.9910406616126809,2938,2866
16,5904,10,100,1e-05,0.01,0.914,0.9940718157181572,2985,2919
16,6004,10,100,1e-05,0.01,0.91,0.9936708860759493,3031,2973
16,6104,10,100,1e-05,0.01,0.926,0.997870249017038,3079,3025
16,6204,10,100,1e-05,0.01,0.918,0.9977433913604127,3131,3073
16,6304,10,100,1e-05,0.01,0.918,0.9947652284263959,3174,3130
16,6404,10,100,1e-05,0.01,0.916,0.995315427857589,3229,3175
16,6504,10,100,1e-05,0.01,0.924,0.998769987699877,3282,3222
16,6604,10,100,1e-05,0.01,0.936,0.9987886129618413,3320,3284
16,6704,10,100,1e-05,0.01,0.92,0.9937350835322196,3369,3335
16,6804,10,100,1e-05,0.01,0.916,0.9839800117577895,3420,3384
16,6904,10,100,1e-05,0.01,0.912,0.9862398609501738,3472,3432
16,7004,10,100,1e-05,0.01,0.922,0.9760137064534552,3527,3477
16,7104,10,100,1e-05,0.01,0.932,0.9914132882882883,3576,3528
16,7204,10,100,1e-05,0.01,0.928,0.9950027762354248,3621,3583
16,7304,10,100,1e-05,0.01,0.93,0.9982201533406353,3675,3629
16,7404,10,100,1e-05,0.01,0.944,0.999054565099946,3721,3683
16,7504,10,100,1e-05,0.01,0.944,0.9996002132196162,3766,3738
16,7604,10,100,1e-05,0.01,0.946,0.9998684902682798,3817,3787
16,7704,10,100,1e-05,0.01,0.946,0.9994807892004154,3863,3841
16,7804,10,100,1e-05,0.01,0.94,0.9997437211686314,3909,3895
16,7904,10,100,1e-05,0.01,0.95,0.9996204453441295,3957,3947
16,8004,10,100,1e-05,0.01,0.942,0.9981259370314842,4022,3982
16,8104,10,100,1e-05,0.01,0.954,0.9997532082922014,4072,4032
16,8204,10,100,1e-05,0.01,0.946,0.9941491955143832,4126,4078
16,8304,10,100,1e-05,0.01,0.946,0.9939788053949904,4175,4129
16,8404,10,100,1e-05,0.01,0.938,0.9866730128510233,4223,4181
16,8504,10,100,1e-05,0.01,0.948,0.9868297271872061,4275,4229
16,8604,10,100,1e-05,0.01,0.95,0.9954672245467224,4317,4287
16,8704,10,100,1e-05,0.01,0.96,0.9985064338235294,4364,4340
16,8804,10,100,1e-05,0.01,0.952,0.9986369831894594,4422,4382
16,8904,10,100,1e-05,0.01,0.96,0.9996630727762803,4480,4424
16,9004,10,100,1e-05,0.01,0.956,0.9984451354953354,4537,4467
16,9104,10,100,1e-05,0.01,0.962,0.9981326889279437,4592,4512
16,9204,10,100,1e-05,0.01,0.958,0.9969578444154715,4643,4561
16,9304,10,100,1e-05,0.01,0.964,0.9976354256233878,4695,4609
16,9404,10,100,1e-05,0.01,0.938,0.9963845172267121,4748,4656
16,9504,10,100,1e-05,0.01,0.96,0.993476430976431,4799,4705
16,9604,10,100,1e-05,0.01,0.954,0.9951062057476051,4858,4746
16,9704,10,100,1e-05,0.01,0.97,0.9953627370156637,4908,4796
16,9804,10,100,1e-05,0.01,0.938,0.9892900856793145,4957,4847
16,9904,10,100,1e-05,0.01,0.962,0.993840872374798,5006,4898
16,10004,10,100,1e-05,0.01,0.978,0.998000799680128,5053,4951
16,10104,10,100,1e-05,0.01,0.966,0.9967339667458432,5107,4997
16,10204,10,100,1e-05,0.01,0.966,0.9972559780478244,5150,5054
16,10304,10,100,1e-05,0.01,0.966,0.998641304347826,5206,5098
16,10404,10,100,1e-05,0.01,0.972,0.9994232987312572,5255,5149
16,10504,10,100,1e-05,0.01,0.974,0.9992383853769993,5297,5207
16,10604,10,100,1e-05,0.01,0.972,0.996982270841192,5345,5259
16,10704,10,100,1e-05,0.01,0.972,0.9989723467862481,5396,5308
16,10804,10,100,1e-05,0.01,0.968,0.996482784154017,5440,5364
16,10904,10,100,1e-05,0.01,0.968,0.9955979457079971,5491,5413
16,11004,10,100,1e-05,0.01,0.974,0.9989094874591058,5532,5472
16,11104,10,100,1e-05,0.01,0.982,0.9905439481268011,5575,5529
16,11204,10,100,1e-05,0.01,0.962,0.9868796858264905,5626,5578
16,11304,10,100,1e-05,0.01,0.97,0.9951344656758669,5682,5622
16,11404,10,100,1e-05,0.01,0.962,0.9919326552086987,5727,5677
16,11504,10,100,1e-05,0.01,0.968,0.9960013908205841,5773,5731
16,11604,10,100,1e-05,0.01,0.982,0.9993967597380213,5819,5785
16,11704,10,100,1e-05,0.01,0.978,0.9993164730006835,5861,5843
16,11804,10,100,1e-05,0.01,0.978,0.9999152829549305,5912,5892
16,11904,10,100,1e-05,0.01,0.98,0.9994119623655914,5956,5948
16,12004,10,100,1e-05,0.01,0.984,1.0,6005,5999
16,12104,10,100,1e-05,0.01,0.984,1.0,6051,6053
16,12204,10,100,1e-05,0.01,0.982,1.0,6106,6098
16,12304,10,100,1e-05,0.01,0.982,0.9996749024707412,6156,6148
16,12404,10,100,1e-05,0.01,0.988,0.9992744276039988,6204,6200
16,12504,10,100,1e-05,0.01,0.986,0.9995201535508638,6246,6258
16,12604,10,100,1e-05,0.01,0.986,0.999682640431609,6295,6309
16,12704,10,100,1e-05,0.01,0.984,1.0,6343,6361
16,12804,10,100,1e-05,0.01,0.984,1.0,6387,6417
16,12904,10,100,1e-05,0.01,0.984,0.9992250464972101,6440,6464
16,13004,10,100,1e-05,0.01,0.982,0.9952322362350046,6492,6512
16,13104,10,100,1e-05,0.01,0.968,0.9841269841269841,6538,6566
16,13204,10,100,1e-05,0.01,0.968,0.9826567706755529,6592,6612
16,13304,10,100,1e-05,0.01,0.982,0.9880487071557427,6637,6667
16,13404,10,100,1e-05,0.01,0.978,0.994330050731125,6687,6717
16,13504,10,100,1e-05,0.01,0.986,0.9993335308056872,6749,6755
16,13604,10,100,1e-05,0.01,0.988,0.9992649220817407,6794,6810
16,13704,10,100,1e-05,0.01,0.984,0.9997081144191476,6837,6867
16,13804,10,100,1e-05,0.01,0.986,0.999855114459577,6893,6911
16,13904,10,100,1e-05,0.01,0.988,0.999928078250863,6943,6961
16,14004,10,100,1e-05,0.01,0.982,0.9997143673236218,6994,7010
16,14104,10,100,1e-05,0.01,0.984,0.9995745887691435,7045,7059
16,14204,10,100,1e-05,0.01,0.984,0.9999295972965362,7089,7115
16,14304,10,100,1e-05,0.01,0.984,0.9998601789709173,7140,7164
16,14404,10,100,1e-05,0.01,0.982,0.999514023882255,7191,7213
16,14504,10,100,1e-05,0.01,0.986,0.9993105350248207,7242,7262
16,14604,10,100,1e-05,0.01,0.982,0.998219665844974,7286,7318
16,14704,10,100,1e-05,0.01,0.99,0.999727965179543,7348,7356
16,14804,10,100,1e-05,0.01,0.988,0.9999324506890029,7400,7404
16,14904,10,100,1e-05,0.01,0.988,0.9993290391841116,7452,7452
16,15004,10,100,1e-05,0.01,0.976,0.9918688349773394,7499,7505
17,104,10,100,1e-05,0.01,0.508,0.4519230769230769,46,58
17,204,10,100,1e-05,0.01,0.49,0.5686274509803921,92,112
17,304,10,100,1e-05,0.01,0.474,0.5789473684210527,150,154
17,404,10,100,1e-05,0.01,0.52,0.5693069306930693,195,209
17,504,10,100,1e-05,0.01,0.524,0.5773809523809523,242,262
17,604,10,100,1e-05,0.01,0.534,0.6026490066225165,290,314
17,704,10,100,1e-05,0.01,0.518,0.6079545454545454,335,369
17,804,10,100,1e-05,0.01,0.514,0.6106965174129353,388,416
17,904,10,100,1e-05,0.01,0.506,0.6117256637168141,440,464
17,1004,10,100,1e-05,0.01,0.492,0.6404382470119522,490,514
17,1104,10,100,1e-05,0.01,0.504,0.6240942028985508,548,556
17,1204,10,100,1e-05,0.01,0.512,0.6569767441860465,598,606
17,1304,10,100,1e-05,0.01,0.54,0.6533742331288344,644,660
17,1404,10,100,1e-05,0.01,0.532,0.665954415954416,693,711
17,1504,10,100,1e-05,0.01,0.522,0.6894946808510638,746,758
17,1604,10,100,1e-05,0.01,0.53,0.7213216957605985,800,804
17,1704,10,100,1e-05,0.01,0.542,0.6960093896713615,850,854
17,1804,10,100,1e-05,0.01,0.518,0.738359201773836,905,899
17,1904,10,100,1e-05,0.01,0.56,0.7521008403361344,954,950
17,2004,10,100,1e-05,0.01,0.564,0.7759481037924152,1004,1000
17,2104,10,100,1e-05,0.01,0.588,0.7732889733840305,1062,1042
17,2204,10,100,1e-05,0.01,0.6,0.7903811252268602,1110,1094
17,2304,10,100,1e-05,0.01,0.62,0.8315972222222222,1153,1151
17,2404,10,100,1e-05,0.01,0.662,0.8456738768718802,1198,1206
17,2504,10,100,1e-05,0.01,0.636,0.8482428115015974,1251,1253
17,2604,10,100,1e-05,0.01,0.658,0.858678955453149,1297,1307
17,2704,10,100,1e-05,0.01,0.658,0.863905325443787,1347,1357
17,2804,10,100,1e-05,0.01,0.71,0.9072753209700428,1398,1406
17,2904,10,100,1e-05,0.01,0.73,0.928030303030303,1452,1452
17,3004,10,100,1e-05,0.01,0.748,0.9384154460719041,1503,1501
17,3104,10,100,1e-05,0.01,0.766,0.9635953608247423,1559,1545
17,3204,10,100,1e-05,0.01,0.774,0.964107365792759,1604,1600
17,3304,10,100,1e-05,0.01,0.79,0.9763922518159807,1648,1656
17,3404,10,100,1e-05,0.01,0.798,0.9700352526439483,1702,1702
17,3504,10,100,1e-05,0.01,0.794,0.976027397260274,1757,1747
17,3604,10,100,1e-05,0.01,0.83,0.9783573806881243,1810,1794
17,3704,10,100,1e-05,0.01,0.828,0.9851511879049676,1856,1848
17,3804,10,100,1e-05,0.01,0.846,0.9876445846477392,1910,1894
17,3904,10,100,1e-05,0.01,0.842,0.9861680327868853,1961,1943
17,4004,10,100,1e-05,0.01,0.848,0.984015984015984,2015,1989
17,4104,10,100,1e-05,0.01,0.852,0.9887914230019493,2061,2043
17,4204,10,100,1e-05,0.01,0.87,0.9892959086584205,2100,2104
17,4304,10,100,1e-05,0.01,0.874,0.9960501858736059,2151,2153
17,4404,10,100,1e-05,0.01,0.874,0.984786557674841,2200,2204
17,4504,10,100,1e-05,0.01,0.87,0.9908969804618117,2242,2262
17,4604,10,100,1e-05,0.01,0.902,0.9932667245873154,2286,2318
17,4704,10,100,1e-05,0.01,0.908,0.9934098639455783,2338,2366
17,4804,10,100,1e-05,0.01,0.898,0.9829308909242298,2387,2417
17,4904,10,100,1e-05,0.01,0.896,0.9800163132137031,2443,2461
17,5004,10,100,1e-05,0.01,0.896,0.9900079936051159,2490,2514
17,5104,10,100,1e-05,0.01,0.924,0.9949059561128527,2542,2562
17,5204,10,100,1e-05,0.01,0.92,0.9963489623366641,2592,2612
17,5304,10,100,1e-05,0.01,0.918,0.9956636500754148,2640,2664
17,5404,10,100,1e-05,0.01,0.922,0.9938934122871946,2684,2720
17,5504,10,100,1e-05,0.01,0.932,0.9972747093023255,2730,2774
17,5604,10,100,1e-05,0.01,0.942,0.9983940042826552,2775,2829
17,5704,10,100,1e-05,0.01,0.916,0.9829943899018233,2822,2882
17,5804,10,100,1e-05,0.01,0.93,0.9898345968297726,2869,2935
17,5904,10,100,1e-05,0.01,0.948,0.9950880758807588,2918,2986
17,6004,10,100,1e-05,0.01,0.954,0.9948367754830113,2965,3039
17,6104,10,100,1e-05,0.01,0.902,0.9734600262123198,3024,3080
17,6204,10,100,1e-05,0.01,0.956,0.9880722114764668,3072,3132
17,6304,10,100,1e-05,0.01,0.962,0.9946065989847716,3124,3180
17,6404,10,100,1e-05,0.01,0.958,0.9976577139287945,3178,3226
17,6504,10,100,1e-05,0.01,0.97,0.9992312423124231,3230,3274
17,6604,10,100,1e-05,0.01,0.97,0.9974258025439128,3279,3325
17,6704,10,100,1e-05,0.01,0.97,0.9982100238663485,3326,3378
17,6804,10,100,1e-05,0.01,0.964,0.9982363315696648,3381,3423
17,6904,10,100,1e-05,0.01,0.974,0.9972479721900348,3427,3477
17,7004,10,100,1e-05,0.01,0.974,0.9985722444317533,3483,3521
17,7104,10,100,1e-05,0.01,0.978,0.9991554054054054,3535,3569
17,7204,10,100,1e-05,0.01,0.978,0.999305941143809,3586,3618
17,7304,10,100,1e-05,0.01,0.98,0.9994523548740416,3636,3668
17,7404,10,100,1e-05,0.01,0.982,0.9998649378714208,3684,3720
17,7504,10,100,1e-05,0.01,0.984,1.0,3738,3766
17,7604,10,100,1e-05,0.01,0.982,0.9997369805365597,3791,3813
17,7704,10,100,1e-05,0.01,0.982,0.9997403946002077,3847,3857
17,7804,10,100,1e-05,0.01,0.986,0.9992311635058944,3890,3914
17,7904,10,100,1e-05,0.01,0.98,0.9938006072874493,3951,3953
17,8004,10,100,1e-05,0.01,0.966,0.9863818090954523,4001,4003
17,8104,10,100,1e-05,0.01,0.97,0.9953109575518263,4052,4052
17,8204,10,100,1e-05,0.01,0.95,0.969892735251097,4102,4102
17,8304,10,100,1e-05,0.01,0.958,0.9727842003853564,4146,4158
17,8404,10,100,1e-05,0.01,0.968,0.9908376963350786,4195,4209
17,8504,10,100,1e-05,0.01,0.978,0.9976481655691439,4241,4263
17,8604,10,100,1e-05,0.01,0.98,0.99907019990702,4288,4316
17,8704,10,100,1e-05,0.01,0.982,0.9997702205882353,4334,4370
17,8804,10,100,1e-05,0.01,0.986,0.999204906860518,4381,4423
17,8904,10,100,1e-05,0.01,0.986,0.9998876909254267,4432,4472
17,9004,10,100,1e-05,0.01,0.982,0.9995557529986673,4486,4518
17,9104,10,100,1e-05,0.01,0.982,0.9995606326889279,4543,4561
17,9204,10,100,1e-05,0.01,0.99,0.9998913515862669,4593,4611
17,9304,10,100,1e-05,0.01,0.988,0.9988177128116938,4637,4667
17,9404,10,100,1e-05,0.01,0.986,0.9992556358996172,4689,4715
17,9504,10,100,1e-05,0.01,0.992,0.9996843434343434,4737,4767
17,9604,10,100,1e-05,0.01,0.986,0.9980216576426489,4799,4805
17,9704,10,100,1e-05,0.01,0.988,0.9982481450948063,4856,4848
17,9804,10,100,1e-05,0.01,0.984,0.994390044879641,4908,4896
17,9904,10,100,1e-05,0.01,0.976,0.9884894991922456,4952,4952
17,10004,10,100,1e-05,0.01,0.978,0.9956017592962815,4999,5005
17,10104,10,100,1e-05,0.01,0.982,0.9963380839271576,5046,5058
17,10204,10,100,1e-05,0.01,0.988,0.9994119952959624,5093,5111
17,10304,10,100,1e-05,0.01,0.988,0.999708850931677,5143,5161
17,10404,10,100,1e-05,0.01,0.988,1.0,5190,5214
17,10504,10,100,1e-05,0.01,0.988,1.0,5233,5271
17,10604,10,100,1e-05,0.01,0.988,0.9990569596378726,5278,5326
17,10704,10,100,1e-05,0.01,0.992,0.9997197309417041,5330,5374
17,10804,10,100,1e-05,0.01,0.986,0.9999074416882636,5382,5422
17,10904,10,100,1e-05,0.01,0.992,0.9998165810711666,5433,5471
17,11004,10,100,1e-05,0.01,0.99,0.9999091239549255,5498,5506
17,11104,10,100,1e-05,0.01,0.992,0.9999099423631124,5548,5556
17,11204,10,100,1e-05,0.01,0.99,0.9990182077829347,5595,5609
17,11304,10,100,1e-05,0.01,0.992,0.9992922859164898,5644,5660
17,11404,10,100,1e-05,0.01,0.988,0.9966678358470712,5690,5714
17,11504,10,100,1e-05,0.01,0.978,0.9874826147426982,5744,5760
17,11604,10,100,1e-05,0.01,0.976,0.9850913478110996,5787,5817
17,11704,10,100,1e-05,0.01,0.992,0.9973513328776487,5834,5870
17,11804,10,100,1e-05,0.01,0.99,0.9984750931887496,5888,5916
17,11904,10,100,1e-05,0.01,0.992,0.9994119623655914,5934,5970
17,12004,10,100,1e-05,0.01,0.998,1.0,5984,6020
17,12104,10,100,1e-05,0.01,0.996,1.0,6041,6063
17,12204,10,100,1e-05,0.01,0.996,1.0,6098,6106
17,12304,10,100,1e-05,0.01,0.996,1.0,6154,6150
17,12404,10,100,1e-05,0.01,0.996,1.0,6202,6202
17,12504,10,100,1e-05,0.01,0.992,0.9992002559181062,6250,6254
17,12604,10,100,1e-05,0.01,0.988,0.9980958425896541,6301,6303
17,12704,10,100,1e-05,0.01,0.988,0.9974023929471033,6345,6359
17,12804,10,100,1e-05,0.01,0.99,0.9987503905029679,6396,6408
17,12904,10,100,1e-05,0.01,0.992,0.9991475511469312,6442,6462
17,13004,10,100,1e-05,0.01,0.99,0.9963088280529068,6495,6509
17,13104,10,100,1e-05,0.01,0.99,0.9991605616605617,6554,6550
17,13204,10,100,1e-05,0.01,0.994,0.9989397152378068,6607,6597
17,13304,10,100,1e-05,0.01,0.994,0.9992483463619964,6650,6654
17,13404,10,100,1e-05,0.01,0.982,0.9971650253655625,6697,6707
17,13504,10,100,1e-05,0.01,0.992,0.9999259478672986,6751,6753
17,13604,10,100,1e-05,0.01,0.994,1.0,6795,6809
17,13704,10,100,1e-05,0.01,0.992,1.0,6850,6854
17,13804,10,100,1e-05,0.01,0.994,0.9968849608809041,6897,6907
17,13904,10,100,1e-05,0.01,0.99,0.99647583429229,6943,6961
17,14004,10,100,1e-05,0.01,0.992,0.9977149385889745,6997,7007
17,14104,10,100,1e-05,0.01,0.99,0.9977311401020987,7056,7048
17,14204,10,100,1e-05,0.01,0.996,0.998873556744579,7106,7098
17,14304,10,100,1e-05,0.01,0.992,0.9993708053691275,7154,7150
17,14404,10,100,1e-05,0.01,0.994,0.9988891974451541,7206,7198
17,14504,10,100,1e-05,0.01,0.994,0.9999310535024821,7256,7248
17,14604,10,100,1e-05,0.01,0.992,0.9995891536565324,7303,7301
17,14704,10,100,1e-05,0.01,0.992,1.0,7353,7351
17,14804,10,100,1e-05,0.01,0.996,0.9995947041340179,7397,7407
17,14904,10,100,1e-05,0.01,0.994,0.9997316156736447,7449,7455
17,15004,10,100,1e-05,0.01,0.99,0.9993335110637164,7497,7507
18,104,10,100,1e-05,0.01,0.482,0.5480769230769231,48,56
18,204,10,100,1e-05,0.01,0.508,0.7009803921568627,101,103
18,304,10,100,1e-05,0.01,0.52,0.6052631578947368,149,155
18,404,10,100,1e-05,0.01,0.53,0.6089108910891089,204,200
18,504,10,100,1e-05,0.01,0.526,0.6130952380952381,258,246
18,604,10,100,1e-05,0.01,0.558,0.6440397350993378,307,297
18,704,10,100,1e-05,0.01,0.56,0.6576704545454546,359,345
18,804,10,100,1e-05,0.01,0.52,0.6865671641791045,411,393
18,904,10,100,1e-05,0.01,0.522,0.6792035398230089,461,443
18,1004,10,100,1e-05,0.01,0.54,0.700199203187251,511,493
18,1104,10,100,1e-05,0.01,0.554,0.6911231884057971,564,540
18,1204,10,100,1e-05,0.01,0.536,0.7167774086378738,622,582
18,1304,10,100,1e-05,0.01,0.52,0.7154907975460123,681,623
18,1404,10,100,1e-05,0.01,0.532,0.7556980056980057,733,671
18,1504,10,100,1e-05,0.01,0.524,0.723404255319149,781,723
18,1604,10,100,1e-05,0.01,0.522,0.7425187032418953,835,769
18,1704,10,100,1e-05,0.01,0.506,0.7464788732394366,879,825
18,1804,10,100,1e-05,0.01,0.526,0.7827050997782705,927,877
18,1904,10,100,1e-05,0.01,0.526,0.7830882352941176,976,928
18,2004,10,100,1e-05,0.01,0.502,0.780439121756487,1022,982
18,2104,10,100,1e-05,0.01,0.534,0.7694866920152091,1075,1029
18,2204,10,100,1e-05,0.01,0.5,0.808076225045372,1118,1086
18,2304,10,100,1e-05,0.01,0.56,0.7717013888888888,1169,1135
18,2404,10,100,1e-05,0.01,0.54,0.8219633943427621,1216,1188
18,2504,10,100,1e-05,0.01,0.59,0.8390575079872205,1261,1243
18,2604,10,100,1e-05,0.01,0.608,0.8410138248847926,1306,1298
18,2704,10,100,1e-05,0.01,0.584,0.8653846153846154,1350,1354
18,2804,10,100,1e-05,0.01,0.618,0.8994293865905849,1397,1407
18,2904,10,100,1e-05,0.01,0.632,0.8863636363636364,1447,1457
18,3004,10,100,1e-05,0.01,0.636,0.9077896138482024,1495,1509
18,3104,10,100,1e-05,0.01,0.656,0.9172036082474226,1537,1567
18,3204,10,100,1e-05,0.01,0.654,0.9260299625468165,1583,1621
18,3304,10,100,1e-05,0.01,0.69,0.940677966101695,1630,1674
18,3404,10,100,1e-05,0.01,0.69,0.9447708578143361,1679,1725
18,3504,10,100,1e-05,0.01,0.688,0.9203767123287672,1721,1783
18,3604,10,100,1e-05,0.01,0.706,0.943118756936737,1772,1832
18,3704,10,100,1e-05,0.01,0.71,0.9481641468682506,1819,1885
18,3804,10,100,1e-05,0.01,0.74,0.9587276550998949,1868,1936
18,3904,10,100,1e-05,0.01,0.71,0.9013831967213115,1923,1981
18,4004,10,100,1e-05,0.01,0.72,0.9353146853146853,1965,2039
18,4104,10,100,1e-05,0.01,0.754,0.9420077972709552,2007,2097
18,4204,10,100,1e-05,0.01,0.776,0.969790675547098,2044,2160
18,4304,10,100,1e-05,0.01,0.78,0.9814126394052045,2096,2208
18,4404,10,100,1e-05,0.01,0.8,0.9825158946412352,2142,2262
18,4504,10,100,1e-05,0.01,0.766,0.9682504440497336,2206,2298
18,4604,10,100,1e-05,0.01,0.79,0.9824066029539531,2251,2353
18,4704,10,100,1e-05,0.01,0.762,0.9649234693877551,2305,2399
18,4804,10,100,1e-05,0.01,0.772,0.9804329725228976,2355,2449
18,4904,10,100,1e-05,0.01,0.814,0.9885807504078303,2404,2500
18,5004,10,100,1e-05,0.01,0.796,0.9762190247801759,2441,2563
18,5104,10,100,1e-05,0.01,0.8,0.9882445141065831,2487,2617
18,5204,10,100,1e-05,0.01,0.814,0.9813604919292852,2544,2660
18,5304,10,100,1e-05,0.01,0.812,0.9773755656108597,2607,2697
18,5404,10,100,1e-05,0.01,0.822,0.9781643227239082,2649,2755
18,5504,10,100,1e-05,0.01,0.83,0.9869186046511628,2711,2793
18,5604,10,100,1e-05,0.01,0.848,0.9787651677373305,2767,2837
18,5704,10,100,1e-05,0.01,0.844,0.9810659186535764,2819,2885
18,5804,10,100,1e-05,0.01,0.854,0.989145416953825,2872,2932
18,5904,10,100,1e-05,0.01,0.848,0.9935636856368564,2930,2974
18,6004,10,100,1e-05,0.01,0.87,0.9948367754830113,2979,3025
18,6104,10,100,1e-05,0.01,0.87,0.995740498034076,3027,3077
18,6204,10,100,1e-05,0.01,0.864,0.9874274661508704,3082,3122
18,6304,10,100,1e-05,0.01,0.826,0.9793781725888325,3127,3177
18,6404,10,100,1e-05,0.01,0.868,0.9839163023110555,3180,3224
18,6504,10,100,1e-05,0.01,0.866,0.9813960639606396,3231,3273
18,6604,10,100,1e-05,0.01,0.862,0.9922774076317383,3278,3326
18,6704,10,100,1e-05,0.01,0.86,0.9858293556085919,3335,3369
18,6804,10,100,1e-05,0.01,0.854,0.9638447971781305,3386,3418
18,6904,10,100,1e-05,0.01,0.754,0.8503765932792584,3441,3463
18,7004,10,100,1e-05,0.01,0.828,0.9291833238149628,3496,3508
18,7104,10,100,1e-05,0.01,0.85,0.9500281531531531,3546,3558
18,7204,10,100,1e-05,0.01,0.848,0.9579400333148251,3594,3610
18,7304,10,100,1e-05,0.01,0.86,0.9812431544359255,3638,3666
18,7404,10,100,1e-05,0.01,0.846,0.974203133441383,3691,3713
18,7504,10,100,1e-05,0.01,0.856,0.9606876332622601,3740,3764
18,7604,10,100,1e-05,0.01,0.876,0.9797475013150974,3792,3812
18,7704,10,100,1e-05,0.01,0.888,0.9855919003115264,3841,3863
18,7804,10,100,1e-05,0.01,0.894,0.989364428498206,3895,3909
18,7904,10,100,1e-05,0.01,0.898,0.9911437246963563,3944,3960
18,8004,10,100,1e-05,0.01,0.908,0.9947526236881559,3990,4014
18,8104,10,100,1e-05,0.01,0.904,0.9927196446199408,4042,4062
18,8204,10,100,1e-05,0.01,0.894,0.9926864943929791,4094,4110
18,8304,10,100,1e-05,0.01,0.894,0.9889210019267822,4150,4154
18,8404,10,100,1e-05,0.01,0.904,0.9888148500713946,4203,4201
18,8504,10,100,1e-05,0.01,0.898,0.9824788334901223,4243,4261
18,8604,10,100,1e-05,0.01,0.882,0.9827986982798699,4286,4318
18,8704,10,100,1e-05,0.01,0.88,0.9862132352941176,4334,4370
18,8804,10,100,1e-05,0.01,0.912,0.9955701953657429,4381,4423
18,8904,10,100,1e-05,0.01,0.922,0.9960691823899371,4428,4476
18,9004,10,100,1e-05,0.01,0.914,0.9883385162150156,4479,4525
18,9104,10,100,1e-05,0.01,0.91,0.9914323374340949,4525,4579
18,9204,10,100,1e-05,0.01,0.91,0.9845719252498913,4577,4627
18,9304,10,100,1e-05,0.01,0.908,0.9881771281169389,4624,4680
18,9404,10,100,1e-05,0.01,0.92,0.9929817099106764,4677,4727
18,9504,10,100,1e-05,0.01,0.942,0.9938973063973064,4719,4785
18,9604,10,100,1e-05,0.01,0.934,0.9920866305705955,4763,4841
18,9704,10,100,1e-05,0.01,0.936,0.9926834295136027,4813,4891
18,9804,10,100,1e-05,0.01,0.93,0.9976540187678499,4865,4939
18,9904,10,100,1e-05,0.01,0.94,0.9951534733441034,4917,4987
18,10004,10,100,1e-05,0.01,0.936,0.993702518992403,4969,5035
18,10104,10,100,1e-05,0.01,0.95,0.9959422011084719,5022,5082
18,10204,10,100,1e-05,0.01,0.948,0.9953939631517053,5068,5136
18,10304,10,100,1e-05,0.01,0.94,0.9967003105590062,5127,5177
18,10404,10,100,1e-05,0.01,0.952,0.9958669742406767,5182,5222
18,10504,10,100,1e-05,0.01,0.954,0.9983815689261234,5232,5272
18,10604,10,100,1e-05,0.01,0.956,0.9986797434930215,5276,5328
18,10704,10,100,1e-05,0.01,0.962,0.9987855007473841,5323,5381
18,10804,10,100,1e-05,0.01,0.946,0.9921325435024065,5376,5428
18,10904,10,100,1e-05,0.01,0.958,0.9909207630227439,5424,5480
18,11004,10,100,1e-05,0.01,0.954,0.9949109414758269,5475,5529
18,11104,10,100,1e-05,0.01,0.95,0.9927053314121037,5527,5577
18,11204,10,100,1e-05,0.01,0.96,0.9842913245269547,5581,5623
18,11304,10,100,1e-05,0.01,0.96,0.9904458598726115,5629,5675
18,11404,10,100,1e-05,0.01,0.962,0.9936864258155034,5681,5723
18,11504,10,100,1e-05,0.01,0.968,0.9971314325452016,5733,5771
18,11604,10,100,1e-05,0.01,0.968,0.9968976215098242,5781,5823
18,11704,10,100,1e-05,0.01,0.976,0.9989747095010253,5833,5871
18,11804,10,100,1e-05,0.01,0.98,0.998898678414097,5885,5919
18,11904,10,100,1e-05,0.01,0.972,0.999075940860215,5936,5968
18,12004,10,100,1e-05,0.01,0.976,0.9985838053982006,5979,6025
18,12104,10,100,1e-05,0.01,0.978,0.999256444150694,6033,6071
18,12204,10,100,1e-05,0.01,0.974,0.9987708947885939,6078,6126
18,12304,10,100,1e-05,0.01,0.978,0.9972366710013004,6130,6174
18,12404,10,100,1e-05,0.01,0.978,0.9986294743631087,6182,6222
18,12504,10,100,1e-05,0.01,0.978,0.9926423544465771,6229,6275
18,12604,10,100,1e-05,0.01,0.962,0.9894477943509997,6278,6326
18,12704,10,100,1e-05,0.01,0.966,0.9924433249370277,6328,6376
18,12804,10,100,1e-05,0.01,0.966,0.9960168697282099,6378,6426
18,12904,10,100,1e-05,0.01,0.968,0.9976751394916304,6429,6475
18,13004,10,100,1e-05,0.01,0.976,0.9981544140264534,6481,6523
18,13104,10,100,1e-05,0.01,0.978,0.998550061050061,6529,6575
18,13204,10,100,1e-05,0.01,0.978,0.9994698576189034,6576,6628
18,13304,10,100,1e-05,0.01,0.978,0.9996241731809982,6626,6678
18,13404,10,100,1e-05,0.01,0.982,0.9995523724261415,6683,6721
18,13504,10,100,1e-05,0.01,0.986,0.9989632701421801,6737,6767
18,13604,10,100,1e-05,0.01,0.98,0.9987503675389592,6786,6818
18,13704,10,100,1e-05,0.01,0.972,0.9959136018680678,6837,6867
18,13804,10,100,1e-05,0.01,0.976,0.9981889307447117,6895,6909
18,13904,10,100,1e-05,0.01,0.96,0.9946777905638665,6944,6960
18,14004,10,100,1e-05,0.01,0.978,0.9941445301342473,7001,7003
18,14104,10,100,1e-05,0.01,0.982,0.9975184344866704,7053,7051
18,14204,10,100,1e-05,0.01,0.98,0.9917628836947339,7098,7106
18,14304,10,100,1e-05,0.01,0.982,0.9962248322147651,7152,7152
18,14404,10,100,1e-05,0.01,0.984,0.9990280477645098,7193,7211
18,14504,10,100,1e-05,0.01,0.978,0.9995173745173745,7250,7254
18,14604,10,100,1e-05,0.01,0.986,0.9988359353601753,7308,7296
18,14704,10,100,1e-05,0.01,0.982,0.9990478781284005,7344,7360
18,14804,10,100,1e-05,0.01,0.976,0.9971629289381249,7394,7410
18,14904,10,100,1e-05,0.01,0.976,0.9930220075147611,7442,7462
18,15004,10,100,1e-05,0.01,0.98,0.9929352172753932,7492,7512
19,104,10,100,1e-05,0.01,0.496,0.7403846153846154,54,50
19,204,10,100,1e-05,0.01,0.49,0.6519607843137255,102,102
19,304,10,100,1e-05,0.01,0.462,0.5921052631578947,151,153
19,404,10,100,1e-05,0.01,0.496,0.599009900990099,209,195
19,504,10,100,1e-05,0.01,0.48,0.5793650793650794,265,239
19,604,10,100,1e-05,0.01,0.476,0.6241721854304636,313,291
19,704,10,100,1e-05,0.01,0.476,0.6207386363636364,363,341
19,804,10,100,1e-05,0.01,0.504,0.6206467661691543,412,392
19,904,10,100,1e-05,0.01,0.514,0.625,464,440
19,1004,10,100,1e-05,0.01,0.492,0.6643426294820717,505,499
19,1104,10,100,1e-05,0.01,0.522,0.6376811594202898,556,548
19,1204,10,100,1e-05,0.01,0.506,0.6445182724252492,603,601
19,1304,10,100,1e-05,0.01,0.506,0.6388036809815951,653,651
19,1404,10,100,1e-05,0.01,0.496,0.6666666666666666,706,698
19,1504,10,100,1e-05,0.01,0.526,0.6396276595744681,758,746
19,1604,10,100,1e-05,0.01,0.524,0.7019950124688279,803,801
19,1704,10,100,1e-05,0.01,0.52,0.7065727699530516,860,844
19,1804,10,100,1e-05,0.01,0.508,0.7200665188470067,904,900
19,1904,10,100,1e-05,0.01,0.53,0.7258403361344538,954,950
19,2004,10,100,1e-05,0.01,0.534,0.7719560878243513,1009,995
19,2104,10,100,1e-05,0.01,0.544,0.7271863117870723,1057,1047
19,2204,10,100,1e-05,0.01,0.572,0.7699637023593466,1104,1100
19,2304,10,100,1e-05,0.01,0.596,0.8025173611111112,1156,1148
19,2404,10,100,1e-05,0.01,0.602,0.8094841930116472,1197,1207
19,2504,10,100,1e-05,0.01,0.596,0.786741214057508,1247,1257
19,2604,10,100,1e-05,0.01,0.638,0.8402457757296466,1294,1310
19,2704,10,100,1e-05,0.01,0.674,0.8694526627218935,1349,1355
19,2804,10,100,1e-05,0.01,0.704,0.8762482168330956,1395,1409
19,2904,10,100,1e-05,0.01,0.732,0.8884297520661157,1449,1455
19,3004,10,100,1e-05,0.01,0.778,0.9314247669773635,1500,1504
19,3104,10,100,1e-05,0.01,0.78,0.9033505154639175,1547,1557
19,3204,10,100,1e-05,0.01,0.784,0.9138576779026217,1603,1601
19,3304,10,100,1e-05,0.01,0.818,0.9203995157384988,1649,1655
19,3404,10,100,1e-05,0.01,0.852,0.9588719153936546,1704,1700
19,3504,10,100,1e-05,0.01,0.89,0.9651826484018264,1751,1753
19,3604,10,100,1e-05,0.01,0.888,0.9733629300776915,1797,1807
19,3704,10,100,1e-05,0.01,0.896,0.9778617710583153,1844,1860
19,3804,10,100,1e-05,0.01,0.918,0.9860672975814931,1889,1915
19,3904,10,100,1e-05,0.01,0.926,0.9948770491803278,1945,1959
19,4004,10,100,1e-05,0.01,0.926,0.9935064935064936,1993,2011
19,4104,10,100,1e-05,0.01,0.924,0.9951267056530214,2038,2066
19,4204,10,100,1e-05,0.01,0.94,0.9964319695528069,2081,2123
19,4304,10,100,1e-05,0.01,0.934,0.9981412639405205,2143,2161
19,4404,10,100,1e-05,0.01,0.944,0.9965940054495913,2197,2207
19,4504,10,100,1e-05,0.01,0.934,0.997113676731794,2246,2258
19,4604,10,100,1e-05,0.01,0.942,0.9967419635099913,2299,2305
19,4704,10,100,1e-05,0.01,0.942,0.9965986394557823,2342,2362
19,4804,10,100,1e-05,0.01,0.94,0.9947960033305578,2390,2414
19,4904,10,100,1e-05,0.01,0.938,0.9940864600326265,2440,2464
19,5004,10,100,1e-05,0.01,0.93,0.9886091127098321,2486,2518
19,5104,10,100,1e-05,0.01,0.924,0.9647335423197492,2535,2569
19,5204,10,100,1e-05,0.01,0.936,0.9790545734050731,2585,2619
19,5304,10,100,1e-05,0.01,0.936,0.9817119155354449,2637,2667
19,5404,10,100,1e-05,0.01,0.878,0.9431902294596595,2689,2715
19,5504,10,100,1e-05,0.01,0.9,0.9411337209302325,2743,2761
19,5604,10,100,1e-05,0.01,0.952,0.9848322626695217,2792,2812
19,5704,10,100,1e-05,0.01,0.96,0.9936886395511921,2846,2858
19,5804,10,100,1e-05,0.01,0.958,0.9972432804962095,2911,2893
19,5904,10,100,1e-05,0.01,0.958,0.9979674796747967,2958,2946
19,6004,10,100,1e-05,0.01,0.966,0.9986675549633578,3001,3003
19,6104,10,100,1e-05,0.01,0.964,0.9991808650065531,3047,3057
19,6204,10,100,1e-05,0.01,0.968,0.9993552546744036,3093,3111
19,6304,10,100,1e-05,0.01,0.968,0.9992068527918782,3142,3162
19,6404,10,100,1e-05,0.01,0.966,0.999531542785759,3191,3213
19,6504,10,100,1e-05,0.01,0.97,0.9995387453874539,3248,3256
19,6604,10,100,1e-05,0.01,0.974,0.9974258025439128,3302,3302
19,6704,10,100,1e-05,0.01,0.966,0.9950775656324582,3354,3350
19,6804,10,100,1e-05,0.01,0.976,0.9986772486772487,3405,3399
19,6904,10,100,1e-05,0.01,0.972,0.9975376593279258,3461,3443
19,7004,10,100,1e-05,0.01,0.972,0.9992861222158766,3513,3491
19,7104,10,100,1e-05,0.01,0.976,0.9988738738738738,3567,3537
19,7204,10,100,1e-05,0.01,0.98,0.9997223764575236,3617,3587
19,7304,10,100,1e-05,0.01,0.972,0.9995892661555312,3671,3633
19,7404,10,100,1e-05,0.01,0.978,0.9995948136142626,3725,3679
19,7504,10,100,1e-05,0.01,0.972,0.996268656716418,3772,3732
19,7604,10,100,1e-05,0.01,0.972,0.9953971593897949,3824,3780
19,7704,10,100,1e-05,0.01,0.99,0.9968847352024922,3870,3834
19,7804,10,100,1e-05,0.01,0.976,0.9948744233726294,3916,3888
19,7904,10,100,1e-05,0.01,0.97,0.9953188259109311,3964,3940
19,8004,10,100,1e-05,0.01,0.978,0.9977511244377811,4011,3993
19,8104,10,100,1e-05,0.01,0.982,0.9985192497532083,4053,4051
19,8204,10,100,1e-05,0.01,0.978,0.9984154071184788,4101,4103
19,8304,10,100,1e-05,0.01,0.982,0.998795761078998,4143,4161
19,8404,10,100,1e-05,0.01,0.98,0.9986910994764397,4194,4210
19,8504,10,100,1e-05,0.01,0.98,0.9965898400752587,4238,4266
19,8604,10,100,1e-05,0.01,0.976,0.996048349604835,4281,4323
19,8704,10,100,1e-05,0.01,0.978,0.9933363970588235,4321,4383
19,8804,10,100,1e-05,0.01,0.98,0.9972739663789186,4370,4434
19,8904,10,100,1e-05,0.01,0.98,0.9987646001796945,4413,4491
19,9004,10,100,1e-05,0.01,0.986,0.9997778764993336,4461,4543
19,9104,10,100,1e-05,0.01,0.986,0.999780316344464,4516,4588
19,9204,10,100,1e-05,0.01,0.98,0.9976097348978705,4570,4634
19,9304,10,100,1e-05,0.01,0.982,0.9992476354256233,4622,4682
19,9404,10,100,1e-05,0.01,0.978,0.999042960442365,4678,4726
19,9504,10,100,1e-05,0.01,0.978,0.9989478114478114,4728,4776
19,9604,10,100,1e-05,0.01,0.98,0.9995835068721366,4776,4828
19,9704,10,100,1e-05,0.01,0.978,0.9948474855729597,4835,4869
19,9804,10,100,1e-05,0.01,0.986,0.9979600163198694,4881,4923
19,9904,10,100,1e-05,0.01,0.976,0.9934369951534734,4936,4968
19,10004,10,100,1e-05,0.01,0.906,0.9304278288684527,4989,5015
19,10104,10,100,1e-05,0.01,0.956,0.9547703879651623,5045,5059
19,10204,10,100,1e-05,0.01,0.978,0.9895139161113289,5100,5104
19,10304,10,100,1e-05,0.01,0.99,0.9960209627329193,5143,5161
19,10404,10,100,1e-05,0.01,0.982,0.9975009611687813,5204,5200
19,10504,10,100,1e-05,0.01,0.992,0.9972391469916222,5253,5251
19,10604,10,100,1e-05,0.01,0.988,0.9978310071671067,5303,5301
19,10704,10,100,1e-05,0.01,0.992,0.999626307922272,5353,5351
19,10804,10,100,1e-05,0.01,0.992,0.9984265087004813,5400,5404
19,10904,10,100,1e-05,0.01,0.992,0.9965150403521643,5445,5459
19,11004,10,100,1e-05,0.01,0.988,0.9974554707379135,5493,5511
19,11104,10,100,1e-05,0.01,0.994,0.9978386167146974,5544,5560
19,11204,10,100,1e-05,0.01,0.992,0.9978579078900393,5593,5611
19,11304,10,100,1e-05,0.01,0.99,0.9981422505307855,5642,5662
19,11404,10,100,1e-05,0.01,0.986,0.9968432129077517,5692,5712
19,11504,10,100,1e-05,0.01,0.99,0.9987830319888734,5739,5765
19,11604,10,100,1e-05,0.01,0.99,0.9986211651154774,5784,5820
19,11704,10,100,1e-05,0.01,0.992,0.9986329460013671,5827,5877
19,11804,10,100,1e-05,0.01,0.988,0.9996611318197222,5881,5923
19,11904,10,100,1e-05,0.01,0.986,0.9949596774193549,5925,5979
19,12004,10,100,1e-05,0.01,0.986,0.9970009996667777,5984,6020
19,12104,10,100,1e-05,0.01,0.996,0.9990085922009253,6037,6067
19,12204,10,100,1e-05,0.01,0.988,0.9977876106194691,6091,6113
19,12304,10,100,1e-05,0.01,0.994,0.9992685305591678,6141,6163
19,12404,10,100,1e-05,0.01,0.992,0.999677523379555,6196,6208
19,12504,10,100,1e-05,0.01,0.992,1.0,6244,6260
19,12604,10,100,1e-05,0.01,0.994,1.0,6294,6310
19,12704,10,100,1e-05,0.01,0.992,1.0,6339,6365
19,12804,10,100,1e-05,0.01,0.992,0.999843798812871,6394,6410
19,12904,10,100,1e-05,0.01,0.992,0.9996900185988841,6443,6461
19,13004,10,100,1e-05,0.01,0.992,0.9980006151953246,6489,6515
19,13104,10,100,1e-05,0.01,0.992,0.9967185592185592,6544,6560
19,13204,10,100,1e-05,0.01,0.986,0.9945471069372918,6601,6603
19,13304,10,100,1e-05,0.01,0.99,0.9963168971737824,6655,6649
19,13404,10,100,1e-05,0.01,0.992,0.9970904207699194,6704,6700
19,13504,10,100,1e-05,0.01,0.996,0.9982227488151659,6752,6752
19,13604,10,100,1e-05,0.01,0.99,0.9982358129961776,6805,6799
19,13704,10,100,1e-05,0.01,0.994,0.9973730297723292,6858,6846
19,13804,10,100,1e-05,0.01,0.996,0.9999275572297884,6904,6900
19,13904,10,100,1e-05,0.01,0.996,0.999928078250863,6954,6950
19,14004,10,100,1e-05,0.01,0.996,0.9992859183090546,7009,6995
19,14104,10,100,1e-05,0.01,0.994,1.0,7065,7039
19,14204,10,100,1e-05,0.01,0.994,1.0,7114,7090
19,14304,10,100,1e-05,0.01,0.994,1.0,7157,7147
19,14404,10,100,1e-05,0.01,0.996,0.9997222993612885,7200,7204
19,14504,10,100,1e-05,0.01,0.994,1.0,7243,7261
19,14604,10,100,1e-05,0.01,0.996,0.9994522048753766,7299,7305
19,14704,10,100,1e-05,0.01,0.994,0.9995919477693145,7357,7347
19,14804,10,100,1e-05,0.01,0.99,0.9982437179140773,7409,7395
19,14904,10,100,1e-05,0.01,0.976,0.9823537305421364,7458,7446
19,15004,10,100,1e-05,0.01,0.984,0.9963343108504399,7501,7503
20,104,10,100,1e-05,0.01,0.49,0.5769230769230769,44,60
20,204,10,100,1e-05,0.01,0.5,0.5931372549019608,103,101
20,304,10,100,1e-05,0.01,0.512,0.625,152,152
20,404,10,100,1e-05,0.01,0.526,0.5891089108910891,202,202
20,504,10,100,1e-05,0.01,0.486,0.6011904761904762,256,248
20,604,10,100,1e-05,0.01,0.488,0.6175496688741722,308,296
20,704,10,100,1e-05,0.01,0.514,0.6221590909090909,361,343
20,804,10,100,1e-05,0.01,0.484,0.6281094527363185,415,389
20,904,10,100,1e-05,0.01,0.468,0.5851769911504425,465,439
20,1004,10,100,1e-05,0.01,0.49,0.6364541832669323,506,498
20,1104,10,100,1e-05,0.01,0.504,0.6177536231884058,554,550
20,1204,10,100,1e-05,0.01,0.536,0.6395348837209303,602,602
20,1304,10,100,1e-05,0.01,0.534,0.6449386503067485,662,642
20,1404,10,100,1e-05,0.01,0.52,0.6680911680911681,724,680
20,1504,10,100,1e-05,0.01,0.556,0.6628989361702128,770,734
20,1604,10,100,1e-05,0.01,0.512,0.6882793017456359,821,783
20,1704,10,100,1e-05,0.01,0.55,0.6977699530516432,870,834
20,1804,10,100,1e-05,0.01,0.58,0.725609756097561,923,881
20,1904,10,100,1e-05,0.01,0.604,0.7426470588235294,966,938
20,2004,10,100,1e-05,0.01,0.61,0.7654690618762475,1017,987
20,2104,10,100,1e-05,0.01,0.672,0.7723384030418251,1063,1041
20,2204,10,100,1e-05,0.01,0.702,0.8284936479128857,1112,1092
20,2304,10,100,1e-05,0.01,0.714,0.8454861111111112,1166,1138
20,2404,10,100,1e-05,0.01,0.706,0.8643926788685524,1210,1194
20,2504,10,100,1e-05,0.01,0.772,0.8738019169329073,1256,1248
20,2604,10,100,1e-05,0.01,0.78,0.8678955453149002,1311,1293
20,2704,10,100,1e-05,0.01,0.798,0.8635355029585798,1363,1341
20,2804,10,100,1e-05,0.01,0.776,0.8559201141226819,1412,1392
20,2904,10,100,1e-05,0.01,0.804,0.856404958677686,1462,1442
20,3004,10,100,1e-05,0.01,0.836,0.8931424766977364,1505,1499
20,3104,10,100,1e-05,0.01,0.842,0.9197809278350515,1556,1548
20,3204,10,100,1e-05,0.01,0.874,0.9285268414481898,1602,1602
20,3304,10,100,1e-05,0.01,0.828,0.937046004842615,1663,1641
20,3404,10,100,1e-05,0.01,0.828,0.8654524089306698,1713,1691
20,3504,10,100,1e-05,0.01,0.804,0.8544520547945206,1768,1736
20,3604,10,100,1e-05,0.01,0.824,0.8953940066592675,1820,1784
20,3704,10,100,1e-05,0.01,0.83,0.8979481641468683,1867,1837
20,3804,10,100,1e-05,0.01,0.876,0.9263932702418507,1917,1887
20,3904,10,100,1e-05,0.01,0.882,0.938780737704918,1968,1936
20,4004,10,100,1e-05,0.01,0.892,0.9502997002997003,2007,1997
20,4104,10,100,1e-05,0.01,0.91,0.9707602339181286,2063,2041
20,4204,10,100,1e-05,0.01,0.88,0.9529019980970505,2114,2090
20,4304,10,100,1e-05,0.01,0.902,0.9563197026022305,2152,2152
20,4404,10,100,1e-05,0.01,0.922,0.9722979109900091,2209,2195
20,4504,10,100,1e-05,0.01,0.912,0.9753552397868561,2259,2245
20,4604,10,100,1e-05,0.01,0.926,0.977845351867941,2315,2289
20,4704,10,100,1e-05,0.01,0.908,0.9621598639455783,2365,2339
20,4804,10,100,1e-05,0.01,0.916,0.958368026644463,2407,2397
20,4904,10,100,1e-05,0.01,0.918,0.9453507340946167,2458,2446
20,5004,10,100,1e-05,0.01,0.914,0.9664268585131894,2503,2501
20,5104,10,100,1e-05,0.01,0.934,0.9747257053291536,2558,2546
20,5204,10,100,1e-05,0.01,0.948,0.97847809377402,2601,2603
20,5304,10,100,1e-05,0.01,0.932,0.9664404223227753,2650,2654
20,5404,10,100,1e-05,0.01,0.944,0.979459659511473,2702,2702
20,5504,10,100,1e-05,0.01,0.952,0.981468023255814,2754,2750
20,5604,10,100,1e-05,0.01,0.946,0.988401142041399,2813,2791
20,5704,10,100,1e-05,0.01,0.952,0.9889551192145862,2866,2838
20,5804,10,100,1e-05,0.01,0.956,0.9934527911784976,2914,2890
20,5904,10,100,1e-05,0.01,0.966,0.9964430894308943,2961,2943
20,6004,10,100,1e-05,0.01,0.956,0.9915056628914057,3012,2992
20,6104,10,100,1e-05,0.01,0.966,0.9947575360419397,3061,3043
20,6204,10,100,1e-05,0.01,0.972,0.9961315280464217,3105,3099
20,6304,10,100,1e-05,0.01,0.964,0.995241116751269,3156,3148
20,6404,10,100,1e-05,0.01,0.96,0.9884447220487196,3196,3208
20,6504,10,100,1e-05,0.01,0.954,0.9730934809348093,3249,3255
20,6604,10,100,1e-05,0.01,0.97,0.9906117504542702,3296,3308
20,6704,10,100,1e-05,0.01,0.966,0.9926909307875895,3344,3360
20,6804,10,100,1e-05,0.01,0.97,0.9901528512639624,3398,3406
20,6904,10,100,1e-05,0.01,0.974,0.9955098493626883,3443,3461
20,7004,10,100,1e-05,0.01,0.976,0.9941462021701885,3486,3518
20,7104,10,100,1e-05,0.01,0.976,0.9977477477477478,3533,3571
20,7204,10,100,1e-05,0.01,0.98,0.998611882287618,3581,3623
20,7304,10,100,1e-05,0.01,0.976,0.9990416210295728,3630,3674
20,7404,10,100,1e-05,0.01,0.97,0.9891950297136682,3678,3726
20,7504,10,100,1e-05,0.01,0.968,0.9890724946695096,3717,3787
20,7604,10,100,1e-05,0.01,0.97,0.9807995791688585,3754,3850
20,7704,10,100,1e-05,0.01,0.964,0.981048805815161,3803,3901
20,7804,10,100,1e-05,0.01,0.962,0.9891081496668375,3855,3949
20,7904,10,100,1e-05,0.01,0.98,0.9940536437246964,3903,4001
20,8004,10,100,1e-05,0.01,0.982,0.9940029985007496,3953,4051
20,8104,10,100,1e-05,0.01,0.97,0.9928430404738401,4005,4099
20,8204,10,100,1e-05,0.01,0.982,0.9978059483178937,4053,4151
20,8304,10,100,1e-05,0.01,0.984,0.998795761078998,4093,4211
20,8404,10,100,1e-05,0.01,0.986,0.9955973346025702,4137,4267
20,8504,10,100,1e-05,0.01,0.978,0.9961194731890874,4189,4315
20,8604,10,100,1e-05,0.01,0.98,0.9963970246397025,4236,4368
20,8704,10,100,1e-05,0.01,0.986,0.9987362132352942,4287,4417
20,8804,10,100,1e-05,0.01,0.98,0.9817128577919128,4330,4474
20,8904,10,100,1e-05,0.01,0.972,0.9909029649595688,4384,4520
20,9004,10,100,1e-05,0.01,0.976,0.9956685917370057,4437,4567
20,9104,10,100,1e-05,0.01,0.976,0.9945079086115993,4493,4611
20,9204,10,100,1e-05,0.01,0.986,0.9946762277270752,4539,4665
20,9304,10,100,1e-05,0.01,0.974,0.9911865864144453,4585,4719
20,9404,10,100,1e-05,0.01,0.976,0.9864951084644832,4638,4766
20,9504,10,100,1e-05,0.01,0.978,0.9902146464646465,4691,4813
20,9604,10,100,1e-05,0.01,0.978,0.9946897126197418,4748,4856
20,9704,10,100,1e-05,0.01,0.98,0.9963932399010718,4794,4910
20,9804,10,100,1e-05,0.01,0.972,0.9933700530395757,4843,4961
20,9904,10,100,1e-05,0.01,0.986,0.99828352180937,4901,5003
20,10004,10,100,1e-05,0.01,0.988,0.9993002798880448,4953,5051
20,10104,10,100,1e-05,0.01,0.988,0.9983174980205859,5006,5098
20,10204,10,100,1e-05,0.01,0.982,0.9961779694237554,5055,5149
20,10304,10,100,1e-05,0.01,0.978,0.9974767080745341,5116,5188
20,10404,10,100,1e-05,0.01,0.98,0.9959630911188004,5160,5244
20,10504,10,100,1e-05,0.01,0.976,0.9957159177456207,5207,5297
20,10604,10,100,1e-05,0.01,0.98,0.9940588457185967,5257,5347
20,10704,10,100,1e-05,0.01,0.956,0.9697309417040358,5308,5396
20,10804,10,100,1e-05,0.01,0.978,0.9863939281747501,5364,5440
20,10904,10,100,1e-05,0.01,0.982,0.9952311078503302,5421,5483
20,11004,10,100,1e-05,0.01,0.988,0.9968193384223919,5465,5539
20,11104,10,100,1e-05,0.01,0.978,0.9874819884726225,5514,5590
20,11204,10,100,1e-05,0.01,0.984,0.9978579078900393,5565,5639
20,11304,10,100,1e-05,0.01,0.982,0.9992038216560509,5606,5698
20,11404,10,100,1e-05,0.01,0.984,0.9995615573482989,5657,5747
20,11504,10,100,1e-05,0.01,0.982,0.9980876216968011,5711,5793
20,11604,10,100,1e-05,0.01,0.984,0.9991382281971734,5764,5840
20,11704,10,100,1e-05,0.01,0.986,0.9996582365003418,5817,5887
20,11804,10,100,1e-05,0.01,0.992,0.9994069806845137,5866,5938
20,11904,10,100,1e-05,0.01,0.968,0.9870631720430108,5919,5985
20,12004,10,100,1e-05,0.01,0.996,0.9952515828057314,5972,6032
20,12104,10,100,1e-05,0.01,0.994,0.997769332452082,6021,6083
20,12204,10,100,1e-05,0.01,0.99,0.9940183546378236,6072,6132
20,12304,10,100,1e-05,0.01,0.99,0.9985370611183355,6128,6176
20,12404,10,100,1e-05,0.01,0.98,0.9979845211222187,6175,6229
20,12504,10,100,1e-05,0.01,0.984,0.9962412028150992,6230,6274
20,12604,10,100,1e-05,0.01,0.99,0.9967470644239924,6276,6328
20,12704,10,100,1e-05,0.01,0.988,0.9971662468513854,6321,6383
20,12804,10,100,1e-05,0.01,0.994,0.9990627928772259,6373,6431
20,12904,10,100,1e-05,0.01,0.992,0.9996125232486051,6419,6485
20,13004,10,100,1e-05,0.01,0.988,0.9964626268840356,6475,6529
20,13104,10,100,1e-05,0.01,0.99,0.9980921855921856,6527,6577
20,13204,10,100,1e-05,0.01,0.992,0.9980308997273554,6580,6624
20,13304,10,100,1e-05,0.01,0.994,0.998947684906795,6628,6676
20,13404,10,100,1e-05,0.01,0.986,0.9874664279319606,6687,6717
20,13504,10,100,1e-05,0.01,0.99,0.9971860189573459,6740,6764
20,13604,10,100,1e-05,0.01,0.994,0.9951484857394883,6789,6815
20,13704,10,100,1e-05,0.01,0.982,0.9884705195563339,6835,6869
20,13804,10,100,1e-05,0.01,0.982,0.9868878585917126,6884,6920
20,13904,10,100,1e-05,0.01,0.98,0.9910817031070196,6933,6971
20,14004,10,100,1e-05,0.01,0.99,0.9967866323907455,6977,7027
20,14104,10,100,1e-05,0.01,0.996,0.9989364719228587,7030,7074
20,14204,10,100,1e-05,0.01,0.998,0.9994367783722895,7081,7123
20,14304,10,100,1e-05,0.01,0.996,0.9985318791946308,7133,7171
20,14404,10,100,1e-05,0.01,0.996,0.9993751735628992,7190,7214
20,14504,10,100,1e-05,0.01,0.998,0.9991726420297848,7250,7254
20,14604,10,100,1e-05,0.01,0.998,0.9997261024376883,7301,7303
20,14704,10,100,1e-05,0.01,0.996,0.9997959738846572,7349,7355
20,14804,10,100,1e-05,0.01,0.996,1.0,7400,7404
20,14904,10,100,1e-05,0.01,0.998,0.9998658078368223,7454,7450
20,15004,10,100,1e-05,0.01,0.988,0.9990002665955745,7497,7507
1,104,10,100,0.0001,0.01,0.498,0.7019230769230769,48,56
1,204,10,100,0.0001,0.01,0.5,0.6911764705882353,96,108
1,304,10,100,0.0001,0.01,0.494,0.6677631578947368,150,154
1,404,10,100,0.0001,0.01,0.512,0.693069306930693,207,197
1,504,10,100,0.0001,0.01,0.49,0.6765873015873016,262,242
1,604,10,100,0.0001,0.01,0.49,0.6655629139072847,307,297
1,704,10,100,0.0001,0.01,0.504,0.6491477272727273,353,351
1,804,10,100,0.0001,0.01,0.53,0.6691542288557214,393,411
1,904,10,100,0.0001,0.01,0.522,0.6714601769911505,442,462
1,1004,10,100,0.0001,0.01,0.546,0.6812749003984063,487,517
1,1104,10,100,0.0001,0.01,0.52,0.7083333333333334,534,570
1,1204,10,100,0.0001,0.01,0.528,0.7009966777408638,586,618
1,1304,10,100,0.0001,0.01,0.54,0.6848159509202454,630,674
1,1404,10,100,0.0001,0.01,0.504,0.7207977207977208,678,726
1,1504,10,100,0.0001,0.01,0.5,0.6908244680851063,724,780
1,1604,10,100,0.0001,0.01,0.542,0.7456359102244389,771,833
1,1704,10,100,0.0001,0.01,0.518,0.7453051643192489,820,884
1,1804,10,100,0.0001,0.01,0.508,0.7372505543237251,871,933
1,1904,10,100,0.0001,0.01,0.576,0.7253151260504201,905,999
1,2004,10,100,0.0001,0.01,0.558,0.782435129740519,944,1060
1,2104,10,100,0.0001,0.01,0.524,0.748574144486692,998,1106
1,2204,10,100,0.0001,0.01,0.576,0.8067150635208712,1041,1163
1,2304,10,100,0.0001,0.01,0.556,0.8133680555555556,1095,1209
1,2404,10,100,0.0001,0.01,0.586,0.8406821963394343,1143,1261
1,2504,10,100,0.0001,0.01,0.586,0.8402555910543131,1194,1310
1,2604,10,100,0.0001,0.01,0.598,0.8114439324116743,1254,1350
1,2704,10,100,0.0001,0.01,0.618,0.823594674556213,1309,1395
1,2804,10,100,0.0001,0.01,0.626,0.8612696148359487,1357,1447
1,2904,10,100,0.0001,0.01,0.61,0.8794765840220385,1412,1492
1,3004,10,100,0.0001,0.01,0.664,0.8981358189081226,1472,1532
1,3104,10,100,0.0001,0.01,0.68,0.9033505154639175,1515,1589
1,3204,10,100,0.0001,0.01,0.694,0.9207240948813983,1565,1639
1,3304,10,100,0.0001,0.01,0.688,0.9010290556900726,1613,1691
1,3404,10,100,0.0001,0.01,0.728,0.9515276145710928,1661,1743
1,3504,10,100,0.0001,0.01,0.69,0.939783105022831,1708,1796
1,3604,10,100,0.0001,0.01,0.728,0.9486681465038845,1761,1843
1,3704,10,100,0.0001,0.01,0.75,0.9665226781857451,1803,1901
1,3804,10,100,0.0001,0.01,0.784,0.9768664563617245,1848,1956
1,3904,10,100,0.0001,0.01,0.798,0.9879610655737705,1893,2011
1,4004,10,100,0.0001,0.01,0.796,0.9725274725274725,1942,2062
1,4104,10,100,0.0001,0.01,0.798,0.9610136452241715,1993,2111
1,4204,10,100,0.0001,0.01,0.804,0.9852521408182683,2048,2156
1,4304,10,100,0.0001,0.01,0.84,0.9890799256505576,2096,2208
1,4404,10,100,0.0001,0.01,0.848,0.9888737511353315,2148,2256
1,4504,10,100,0.0001,0.01,0.848,0.9915630550621669,2208,2296
1,4604,10,100,0.0001,0.01,0.872,0.9960903562119896,2255,2349
1,4704,10,100,0.0001,0.01,0.876,0.9948979591836735,2307,2397
1,4804,10,100,0.0001,0.01,0.882,0.9748126561199001,2360,2444
1,4904,10,100,0.0001,0.01,0.87,0.9751223491027733,2413,2491
1,5004,10,100,0.0001,0.01,0.904,0.9888089528377298,2464,2540
1,5104,10,100,0.0001,0.01,0.892,0.9907915360501567,2514,2590
1,5204,10,100,0.0001,0.01,0.912,0.9934665641813989,2573,2631
1,5304,10,100,0.0001,0.01,0.932,0.998868778280543,2620,2684
1,5404,10,100,0.0001,0.01,0.938,0.999259807549963,2677,2727
1,5504,10,100,0.0001,0.01,0.948,0.9994549418604651,2722,2782
1,5604,10,100,0.0001,0.01,0.936,0.9992862241256245,2765,2839
1,5704,10,100,0.0001,0.01,0.944,0.9945652173913043,2813,2891
1,5804,10,100,0.0001,0.01,0.942,0.9981047553411441,2862,2942
1,5904,10,100,0.0001,0.01,0.936,0.9964430894308943,2906,2998
1,6004,10,100,0.0001,0.01,0.944,0.9975016655562958,2953,3051
1,6104,10,100,0.0001,0.01,0.946,0.9990170380078637,3011,3093
1,6204,10,100,0.0001,0.01,0.936,0.9937137330754352,3066,3138
1,6304,10,100,0.0001,0.01,0.962,0.9990482233502538,3116,3188
1,6404,10,100,0.0001,0.01,0.938,0.9960961898813242,3162,3242
1,6504,10,100,0.0001,0.01,0.948,0.9946186961869619,3217,3287
1,6604,10,100,0.0001,0.01,0.944,0.99076317383404,3277,3327
1,6704,10,100,0.0001,0.01,0.946,0.9928400954653938,3324,3380
1,6804,10,100,0.0001,0.01,0.964,0.9951499118165785,3378,3426
1,6904,10,100,0.0001,0.01,0.968,0.9992757821552724,3428,3476
1,7004,10,100,0.0001,0.01,0.966,0.9960022844089091,3477,3527
1,7104,10,100,0.0001,0.01,0.972,0.9967623873873874,3528,3576
1,7204,10,100,0.0001,0.01,0.97,0.9969461410327596,3573,3631
1,7304,10,100,0.0001,0.01,0.976,0.9994523548740416,3629,3675
1,7404,10,100,0.0001,0.01,0.974,0.998109130199892,3674,3730
1,7504,10,100,0.0001,0.01,0.962,0.9938699360341151,3722,3782
1,7604,10,100,0.0001,0.01,0.968,0.9972382956338769,3765,3839
1,7704,10,100,0.0001,0.01,0.958,0.9801401869158879,3823,3881
1,7804,10,100,0.0001,0.01,0.964,0.996155817529472,3871,3933
1,7904,10,100,0.0001,0.01,0.972,0.996330971659919,3922,3982
1,8004,10,100,0.0001,0.01,0.978,0.9995002498750625,3974,4030
1,8104,10,100,0.0001,0.01,0.976,0.9998766041461007,4032,4072
1,8204,10,100,0.0001,0.01,0.98,0.999390541199415,4077,4127
1,8304,10,100,0.0001,0.01,0.976,1.0,4126,4178
1,8404,10,100,0.0001,0.01,0.974,0.9994050452165636,4178,4226
1,8504,10,100,0.0001,0.01,0.98,0.9998824082784572,4229,4275
1,8604,10,100,0.0001,0.01,0.98,1.0,4275,4329
1,8704,10,100,0.0001,0.01,0.986,0.9998851102941176,4319,4385
1,8804,10,100,0.0001,0.01,0.984,1.0,4367,4437
1,8904,10,100,0.0001,0.01,0.982,0.9996630727762803,4422,4482
1,9004,10,100,0.0001,0.01,0.974,0.9996668147490004,4462,4542
1,9104,10,100,0.0001,0.01,0.974,0.9985720562390158,4514,4590
1,9204,10,100,0.0001,0.01,0.972,0.9956540634506736,4564,4640
1,9304,10,100,0.0001,0.01,0.96,0.9883920894239037,4617,4687
1,9404,10,100,0.0001,0.01,0.972,0.9846873670778392,4670,4734
1,9504,10,100,0.0001,0.01,0.986,0.9931607744107744,4720,4784
1,9604,10,100,0.0001,0.01,0.972,0.9960433152852978,4774,4830
1,9704,10,100,0.0001,0.01,0.984,0.9984542456718879,4815,4889
1,9804,10,100,0.0001,0.01,0.982,0.9995920032639739,4856,4948
1,9904,10,100,0.0001,0.01,0.986,0.9997980613893377,4901,5003
1,10004,10,100,0.0001,0.01,0.982,0.9997001199520192,4953,5051
1,10104,10,100,0.0001,0.01,0.984,0.9995051464766429,5008,5096
1,10204,10,100,0.0001,0.01,0.984,0.9998039984319874,5052,5152
1,10304,10,100,0.0001,0.01,0.984,1.0,5106,5198
1,10404,10,100,0.0001,0.01,0.984,0.9999038831218762,5158,5246
1,10504,10,100,0.0001,0.01,0.99,0.9999047981721249,5217,5287
1,10604,10,100,0.0001,0.01,0.992,0.999622783855149,5262,5342
1,10704,10,100,0.0001,0.01,0.99,0.9988789237668162,5307,5397
1,10804,10,100,0.0001,0.01,0.976,0.9963902258422807,5368,5436
1,10904,10,100,0.0001,0.01,0.976,0.9955979457079971,5417,5487
1,11004,10,100,0.0001,0.01,0.98,0.9960923300617958,5471,5533
1,11104,10,100,0.0001,0.01,0.984,0.9975684438040345,5518,5586
1,11204,10,100,0.0001,0.01,0.974,0.9936629775080329,5566,5638
1,11304,10,100,0.0001,0.01,0.97,0.9836341118188252,5619,5685
1,11404,10,100,0.0001,0.01,0.984,0.9969309014380919,5676,5728
1,11504,10,100,0.0001,0.01,0.988,0.9988699582753825,5724,5780
1,11604,10,100,0.0001,0.01,0.99,0.999224405377456,5782,5822
1,11704,10,100,0.0001,0.01,0.988,0.9992310321257689,5832,5872
1,11804,10,100,0.0001,0.01,0.988,0.9993222636394442,5876,5928
1,11904,10,100,0.0001,0.01,0.992,0.9995799731182796,5939,5965
1,12004,10,100,0.0001,0.01,0.992,0.9998333888703765,5992,6012
1,12104,10,100,0.0001,0.01,0.992,0.9997521480502314,6047,6057
1,12204,10,100,0.0001,0.01,0.988,0.9968043264503441,6089,6115
1,12304,10,100,0.0001,0.01,0.992,0.9991872561768531,6144,6160
1,12404,10,100,0.0001,0.01,0.992,0.9994356659142212,6200,6204
1,12504,10,100,0.0001,0.01,0.98,0.9934420985284709,6254,6250
1,12604,10,100,0.0001,0.01,0.988,0.995001586797842,6303,6301
1,12704,10,100,0.0001,0.01,0.988,0.9976385390428212,6350,6354
1,12804,10,100,0.0001,0.01,0.992,0.9985160887222743,6401,6403
1,12904,10,100,0.0001,0.01,0.992,0.999922504649721,6444,6460
1,13004,10,100,0.0001,0.01,0.992,0.9999231005844356,6499,6505
1,13104,10,100,0.0001,0.01,0.992,0.9999236874236874,6555,6549
1,13204,10,100,0.0001,0.01,0.992,0.999924265374129,6604,6600
1,13304,10,100,0.0001,0.01,0.992,0.9999248346361996,6651,6653
1,13404,10,100,0.0001,0.01,0.99,0.9998507908087139,6704,6700
1,13504,10,100,0.0001,0.01,0.99,0.9991854265402843,6753,6751
1,13604,10,100,0.0001,0.01,0.986,0.995589532490444,6807,6797
1,13704,10,100,0.0001,0.01,0.992,0.9987594862813777,6853,6851
1,13804,10,100,0.0001,0.01,0.992,0.9994204578383077,6907,6897
1,13904,10,100,0.0001,0.01,0.992,0.9977704257767549,6953,6951
1,14004,10,100,0.0001,0.01,0.992,0.9997143673236218,7000,7004
1,14104,10,100,0.0001,0.01,0.992,0.9994327850255247,7044,7060
1,14204,10,100,0.0001,0.01,0.99,0.9997183891861448,7099,7105
1,14304,10,100,0.0001,0.01,0.992,0.9998601789709173,7150,7154
1,14404,10,100,0.0001,0.01,0.99,0.9997917245209664,7195,7209
1,14504,10,100,0.0001,0.01,0.99,0.9999310535024821,7246,7258
1,14604,10,100,0.0001,0.01,0.99,1.0,7285,7319
1,14704,10,100,0.0001,0.01,0.992,0.9985038084874864,7341,7363
1,14804,10,100,0.0001,0.01,0.988,0.9995271548230208,7394,7410
1,14904,10,100,0.0001,0.01,0.99,0.9997987117552335,7450,7454
1,15004,10,100,0.0001,0.01,0.994,0.9998667022127433,7499,7505
2,104,10,100,0.0001,0.01,0.442,0.7884615384615384,46,58
2,204,10,100,0.0001,0.01,0.49,0.7254901960784313,87,117
2,304,10,100,0.0001,0.01,0.512,0.6644736842105263,134,170
2,404,10,100,0.0001,0.01,0.514,0.6905940594059405,184,220
2,504,10,100,0.0001,0.01,0.53,0.7182539682539683,244,260
2,604,10,100,0.0001,0.01,0.538,0.7052980132450332,292,312
2,704,10,100,0.0001,0.01,0.51,0.6690340909090909,341,363
2,804,10,100,0.0001,0.01,0.49,0.681592039800995,394,410
2,904,10,100,0.0001,0.01,0.534,0.6736725663716814,446,458
2,1004,10,100,0.0001,0.01,0.522,0.6792828685258964,498,506
2,1104,10,100,0.0001,0.01,0.528,0.6521739130434783,545,559
2,1204,10,100,0.0001,0.01,0.536,0.6893687707641196,608,596
2,1304,10,100,0.0001,0.01,0.522,0.6955521472392638,663,641
2,1404,10,100,0.0001,0.01,0.55,0.7186609686609686,720,684
2,1504,10,100,0.0001,0.01,0.538,0.7147606382978723,773,731
2,1604,10,100,0.0001,0.01,0.554,0.6583541147132169,822,782
2,1704,10,100,0.0001,0.01,0.552,0.7282863849765259,866,838
2,1804,10,100,0.0001,0.01,0.576,0.7644124168514412,917,887
2,1904,10,100,0.0001,0.01,0.582,0.779936974789916,966,938
2,2004,10,100,0.0001,0.01,0.566,0.7674650698602794,1016,988
2,2104,10,100,0.0001,0.01,0.608,0.7770912547528517,1065,1039
2,2204,10,100,0.0001,0.01,0.632,0.8062613430127041,1109,1095
2,2304,10,100,0.0001,0.01,0.628,0.8081597222222222,1158,1146
2,2404,10,100,0.0001,0.01,0.672,0.8261231281198004,1204,1200
2,2504,10,100,0.0001,0.01,0.672,0.8510383386581469,1250,1254
2,2604,10,100,0.0001,0.01,0.68,0.8125960061443932,1291,1313
2,2704,10,100,0.0001,0.01,0.65,0.8043639053254438,1346,1358
2,2804,10,100,0.0001,0.01,0.736,0.8559201141226819,1395,1409
2,2904,10,100,0.0001,0.01,0.736,0.8966942148760331,1447,1457
2,3004,10,100,0.0001,0.01,0.798,0.9104527296937417,1496,1508
2,3104,10,100,0.0001,0.01,0.798,0.9355670103092784,1543,1561
2,3204,10,100,0.0001,0.01,0.814,0.9378901373283396,1593,1611
2,3304,10,100,0.0001,0.01,0.83,0.9506658595641646,1647,1657
2,3404,10,100,0.0001,0.01,0.848,0.9612220916568742,1707,1697
2,3504,10,100,0.0001,0.01,0.86,0.9765981735159818,1763,1741
2,3604,10,100,0.0001,0.01,0.892,0.9836293007769146,1809,1795
2,3704,10,100,0.0001,0.01,0.862,0.9808315334773218,1855,1849
2,3804,10,100,0.0001,0.01,0.878,0.9739747634069401,1903,1901
2,3904,10,100,0.0001,0.01,0.876,0.9756659836065574,1948,1956
2,4004,10,100,0.0001,0.01,0.878,0.9827672327672328,1991,2013
2,4104,10,100,0.0001,0.01,0.906,0.9839181286549707,2049,2055
2,4204,10,100,0.0001,0.01,0.904,0.9928639391056137,2099,2105
2,4304,10,100,0.0001,0.01,0.906,0.9921003717472119,2144,2160
2,4404,10,100,0.0001,0.01,0.918,0.995685740236149,2196,2208
2,4504,10,100,0.0001,0.01,0.92,0.9944493783303731,2242,2262
2,4604,10,100,0.0001,0.01,0.924,0.9923979148566464,2303,2301
2,4704,10,100,0.0001,0.01,0.944,0.9961734693877551,2360,2344
2,4804,10,100,0.0001,0.01,0.926,0.9968776019983348,2416,2388
2,4904,10,100,0.0001,0.01,0.942,0.9957177814029364,2471,2433
2,5004,10,100,0.0001,0.01,0.912,0.9738209432454037,2524,2480
2,5104,10,100,0.0001,0.01,0.91,0.9731583072100314,2578,2526
2,5204,10,100,0.0001,0.01,0.928,0.9857801691006918,2632,2572
2,5304,10,100,0.0001,0.01,0.93,0.9920814479638009,2674,2630
2,5404,10,100,0.0001,0.01,0.95,0.9966691339748335,2720,2684
2,5504,10,100,0.0001,0.01,0.948,0.9965479651162791,2774,2730
2,5604,10,100,0.0001,0.01,0.948,0.9921484653818701,2834,2770
2,5704,10,100,0.0001,0.01,0.944,0.9961430575035063,2887,2817
2,5804,10,100,0.0001,0.01,0.944,0.9936250861474845,2937,2867
2,5904,10,100,0.0001,0.01,0.96,0.994410569105691,2990,2914
2,6004,10,100,0.0001,0.01,0.952,0.9843437708194537,3032,2972
2,6104,10,100,0.0001,0.01,0.95,0.9929554390563565,3084,3020
2,6204,10,100,0.0001,0.01,0.954,0.9969374597034172,3142,3062
2,6304,10,100,0.0001,0.01,0.972,0.9984137055837563,3189,3115
2,6404,10,100,0.0001,0.01,0.962,0.9959400374765771,3237,3167
2,6504,10,100,0.0001,0.01,0.96,0.9961562115621156,3284,3220
2,6604,10,100,0.0001,0.01,0.944,0.9895517867958813,3331,3273
2,6704,10,100,0.0001,0.01,0.946,0.9911992840095465,3379,3325
2,6804,10,100,0.0001,0.01,0.976,0.9944150499706055,3436,3368
2,6904,10,100,0.0001,0.01,0.964,0.9955098493626883,3492,3412
2,7004,10,100,0.0001,0.01,0.966,0.9952884066247858,3541,3463
2,7104,10,100,0.0001,0.01,0.964,0.998170045045045,3588,3516
2,7204,10,100,0.0001,0.01,0.952,0.9869516935036091,3644,3560
2,7304,10,100,0.0001,0.01,0.968,0.997946330777656,3678,3626
2,7404,10,100,0.0001,0.01,0.964,0.9909508373851972,3725,3679
2,7504,10,100,0.0001,0.01,0.956,0.9830756929637526,3773,3731
2,7604,10,100,0.0001,0.01,0.97,0.9926354550236718,3816,3788
2,7704,10,100,0.0001,0.01,0.968,0.9970145379023884,3865,3839
2,7804,10,100,0.0001,0.01,0.968,0.9976934905176832,3916,3888
2,7904,10,100,0.0001,0.01,0.968,0.9959514170040485,3973,3931
2,8004,10,100,0.0001,0.01,0.976,0.999375312343828,4020,3984
2,8104,10,100,0.0001,0.01,0.978,0.9998766041461007,4069,4035
2,8204,10,100,0.0001,0.01,0.974,1.0,4122,4082
2,8304,10,100,0.0001,0.01,0.978,1.0,4172,4132
2,8404,10,100,0.0001,0.01,0.978,1.0,4217,4187
2,8504,10,100,0.0001,0.01,0.976,0.9998824082784572,4271,4233
2,8604,10,100,0.0001,0.01,0.974,0.998372849837285,4318,4286
2,8704,10,100,0.0001,0.01,0.976,0.9914981617647058,4372,4332
2,8804,10,100,0.0001,0.01,0.976,0.9975011358473421,4425,4379
2,8904,10,100,0.0001,0.01,0.976,0.9968553459119497,4474,4430
2,9004,10,100,0.0001,0.01,0.986,0.9996668147490004,4519,4485
2,9104,10,100,0.0001,0.01,0.988,1.0,4569,4535
2,9204,10,100,0.0001,0.01,0.988,0.9998913515862669,4623,4581
2,9304,10,100,0.0001,0.01,0.986,1.0,4674,4630
2,9404,10,100,0.0001,0.01,0.988,1.0,4720,4684
2,9504,10,100,0.0001,0.01,0.982,0.9984217171717171,4765,4739
2,9604,10,100,0.0001,0.01,0.976,0.9895876718034152,4819,4785
2,9704,10,100,0.0001,0.01,0.974,0.9891797197032152,4866,4838
2,9804,10,100,0.0001,0.01,0.984,0.9933700530395757,4917,4887
2,9904,10,100,0.0001,0.01,0.984,0.9970718901453958,4967,4937
2,10004,10,100,0.0001,0.01,0.96,0.9716113554578168,5016,4988
2,10104,10,100,0.0001,0.01,0.972,0.9817893903404592,5065,5039
2,10204,10,100,0.0001,0.01,0.986,0.9970599764798118,5109,5095
2,10304,10,100,0.0001,0.01,0.986,0.9977678571428571,5148,5156
2,10404,10,100,0.0001,0.01,0.986,0.999519415609381,5197,5207
2,10504,10,100,0.0001,0.01,0.988,0.9997143945163747,5256,5248
2,10604,10,100,0.0001,0.01,0.988,0.9998113919275745,5292,5312
2,10704,10,100,0.0001,0.01,0.986,0.9990657698056801,5342,5362
2,10804,10,100,0.0001,0.01,0.99,0.9998148833765272,5392,5412
2,10904,10,100,0.0001,0.01,0.99,0.9999082905355833,5452,5452
2,11004,10,100,0.0001,0.01,0.988,0.9999091239549255,5500,5504
2,11104,10,100,0.0001,0.01,0.988,0.9998198847262247,5544,5560
2,11204,10,100,0.0001,0.01,0.978,0.9913423777222421,5592,5612
2,11304,10,100,0.0001,0.01,0.984,0.9968152866242038,5642,5662
2,11404,10,100,0.0001,0.01,0.986,0.9953525078919677,5700,5704
2,11504,10,100,0.0001,0.01,0.986,0.9980876216968011,5751,5753
2,11604,10,100,0.0001,0.01,0.986,0.9963805584281282,5805,5799
2,11704,10,100,0.0001,0.01,0.986,0.9932501708817498,5853,5851
2,11804,10,100,0.0001,0.01,0.992,0.9972043375127075,5904,5900
2,11904,10,100,0.0001,0.01,0.988,0.9996639784946236,5954,5950
2,12004,10,100,0.0001,0.01,0.99,0.9997500833055648,6001,6003
2,12104,10,100,0.0001,0.01,0.998,0.9998347653668209,6049,6055
2,12204,10,100,0.0001,0.01,0.992,0.9997541789577188,6101,6103
2,12304,10,100,0.0001,0.01,0.996,0.9995123537061118,6144,6160
2,12404,10,100,0.0001,0.01,0.996,1.0,6201,6203
2,12504,10,100,0.0001,0.01,0.99,0.9996801023672425,6248,6256
2,12604,10,100,0.0001,0.01,0.992,1.0,6306,6298
2,12704,10,100,0.0001,0.01,0.986,0.9985044080604534,6354,6350
2,12804,10,100,0.0001,0.01,0.994,1.0,6403,6401
2,12904,10,100,0.0001,0.01,0.996,0.9992250464972101,6451,6453
2,13004,10,100,0.0001,0.01,0.994,0.997385419870809,6494,6510
2,13104,10,100,0.0001,0.01,0.98,0.9948107448107448,6539,6565
2,13204,10,100,0.0001,0.01,0.966,0.9762950621023933,6589,6615
2,13304,10,100,0.0001,0.01,0.978,0.9933854479855683,6636,6668
2,13404,10,100,0.0001,0.01,0.994,0.9970904207699194,6684,6720
2,13504,10,100,0.0001,0.01,0.998,0.9995556872037915,6738,6766
2,13604,10,100,0.0001,0.01,0.998,0.9999264922081741,6782,6822
2,13704,10,100,0.0001,0.01,0.998,1.0,6838,6866
2,13804,10,100,0.0001,0.01,0.998,0.9992755722978847,6886,6918
2,13904,10,100,0.0001,0.01,0.998,1.0,6937,6967
2,14004,10,100,0.0001,0.01,0.998,1.0,6990,7014
2,14104,10,100,0.0001,0.01,0.998,1.0,7036,7068
2,14204,10,100,0.0001,0.01,0.998,1.0,7086,7118
2,14304,10,100,0.0001,0.01,1.0,1.0,7134,7170
2,14404,10,100,0.0001,0.01,0.998,1.0,7187,7217
2,14504,10,100,0.0001,0.01,0.994,0.9988279095421952,7237,7267
2,14604,10,100,0.0001,0.01,0.98,0.9896603670227335,7286,7318
2,14704,10,100,0.0001,0.01,0.96,0.9640233949945594,7331,7373
2,14804,10,100,0.0001,0.01,0.996,0.9979059713590921,7384,7420
2,14904,10,100,0.0001,0.01,0.998,0.9978529253891573,7436,7468
2,15004,10,100,0.0001,0.01,0.996,0.9999333511063716,7489,7515
3,104,10,100,0.0001,0.01,0.476,0.5673076923076923,47,57
3,204,10,100,0.0001,0.01,0.512,0.5686274509803921,102,102
3,304,10,100,0.0001,0.01,0.53,0.5921052631578947,159,145
3,404,10,100,0.0001,0.01,0.51,0.6608910891089109,213,191
3,504,10,100,0.0001,0.01,0.488,0.6468253968253969,261,243
3,604,10,100,0.0001,0.01,0.52,0.6158940397350994,308,296
3,704,10,100,0.0001,0.01,0.522,0.59375,358,346
3,804,10,100,0.0001,0.01,0.53,0.6206467661691543,412,392
3,904,10,100,0.0001,0.01,0.524,0.6139380530973452,461,443
3,1004,10,100,0.0001,0.01,0.528,0.6673306772908366,511,493
3,1104,10,100,0.0001,0.01,0.562,0.657608695652174,564,540
3,1204,10,100,0.0001,0.01,0.522,0.6636212624584718,600,604
3,1304,10,100,0.0001,0.01,0.532,0.6633435582822086,650,654
3,1404,10,100,0.0001,0.01,0.506,0.7022792022792023,698,706
3,1504,10,100,0.0001,0.01,0.524,0.6988031914893617,750,754
3,1604,10,100,0.0001,0.01,0.496,0.7144638403990025,806,798
3,1704,10,100,0.0001,0.01,0.546,0.7130281690140845,858,846
3,1804,10,100,0.0001,0.01,0.562,0.7477827050997783,904,900
3,1904,10,100,0.0001,0.01,0.56,0.7389705882352942,955,949
3,2004,10,100,0.0001,0.01,0.572,0.7514970059880239,1007,997
3,2104,10,100,0.0001,0.01,0.532,0.7561787072243346,1062,1042
3,2204,10,100,0.0001,0.01,0.57,0.7867513611615246,1110,1094
3,2304,10,100,0.0001,0.01,0.602,0.7764756944444444,1167,1137
3,2404,10,100,0.0001,0.01,0.586,0.7945091514143094,1219,1185
3,2504,10,100,0.0001,0.01,0.584,0.7943290734824281,1268,1236
3,2604,10,100,0.0001,0.01,0.618,0.815668202764977,1326,1278
3,2704,10,100,0.0001,0.01,0.624,0.8372781065088757,1376,1328
3,2804,10,100,0.0001,0.01,0.636,0.833808844507846,1428,1376
3,2904,10,100,0.0001,0.01,0.648,0.8519283746556474,1474,1430
3,3004,10,100,0.0001,0.01,0.65,0.87017310252996,1522,1482
3,3104,10,100,0.0001,0.01,0.66,0.9091494845360825,1563,1541
3,3204,10,100,0.0001,0.01,0.66,0.9051186017478152,1608,1596
3,3304,10,100,0.0001,0.01,0.678,0.9016343825665859,1656,1648
3,3404,10,100,0.0001,0.01,0.69,0.9215628672150411,1703,1701
3,3504,10,100,0.0001,0.01,0.704,0.9146689497716894,1751,1753
3,3604,10,100,0.0001,0.01,0.72,0.9234184239733629,1793,1811
3,3704,10,100,0.0001,0.01,0.784,0.9487041036717062,1851,1853
3,3804,10,100,0.0001,0.01,0.776,0.9621451104100947,1904,1900
3,3904,10,100,0.0001,0.01,0.78,0.9538934426229508,1949,1955
3,4004,10,100,0.0001,0.01,0.8,0.9557942057942058,2009,1995
3,4104,10,100,0.0001,0.01,0.788,0.929093567251462,2054,2050
3,4204,10,100,0.0001,0.01,0.788,0.9410085632730733,2103,2101
3,4304,10,100,0.0001,0.01,0.848,0.9721189591078067,2155,2149
3,4404,10,100,0.0001,0.01,0.822,0.9770663033605813,2207,2197
3,4504,10,100,0.0001,0.01,0.834,0.9678063943161634,2258,2246
3,4604,10,100,0.0001,0.01,0.86,0.9800173761946134,2309,2295
3,4704,10,100,0.0001,0.01,0.87,0.9893707482993197,2358,2346
3,4804,10,100,0.0001,0.01,0.874,0.9895920066611157,2414,2390
3,4904,10,100,0.0001,0.01,0.876,0.9914355628058727,2462,2442
3,5004,10,100,0.0001,0.01,0.884,0.9946043165467626,2507,2497
3,5104,10,100,0.0001,0.01,0.908,0.9960815047021944,2562,2542
3,5204,10,100,0.0001,0.01,0.846,0.9559953881629516,2613,2591
3,5304,10,100,0.0001,0.01,0.822,0.9349547511312217,2661,2643
3,5404,10,100,0.0001,0.01,0.868,0.9709474463360473,2707,2697
3,5504,10,100,0.0001,0.01,0.854,0.970203488372093,2754,2750
3,5604,10,100,0.0001,0.01,0.888,0.9880442541042113,2813,2791
3,5704,10,100,0.0001,0.01,0.896,0.9952664796633941,2863,2841
3,5804,10,100,0.0001,0.01,0.886,0.985354927636113,2915,2889
3,5904,10,100,0.0001,0.01,0.912,0.9979674796747967,2963,2941
3,6004,10,100,0.0001,0.01,0.904,0.9998334443704198,3009,2995
3,6104,10,100,0.0001,0.01,0.906,0.9983617300131061,3062,3042
3,6204,10,100,0.0001,0.01,0.916,0.99822695035461,3118,3086
3,6304,10,100,0.0001,0.01,0.914,0.9995241116751269,3169,3135
3,6404,10,100,0.0001,0.01,0.924,0.9993753903810119,3218,3186
3,6504,10,100,0.0001,0.01,0.898,0.985239852398524,3257,3247
3,6604,10,100,0.0001,0.01,0.91,0.9772864930345245,3295,3309
3,6704,10,100,0.0001,0.01,0.922,0.9940334128878282,3339,3365
3,6804,10,100,0.0001,0.01,0.918,0.9963256907701352,3388,3416
3,6904,10,100,0.0001,0.01,0.92,0.9966685979142526,3443,3461
3,7004,10,100,0.0001,0.01,0.92,0.9965733866362079,3484,3520
3,7104,10,100,0.0001,0.01,0.932,0.9987331081081081,3532,3572
3,7204,10,100,0.0001,0.01,0.938,0.9970849528039978,3575,3629
3,7304,10,100,0.0001,0.01,0.93,0.9997261774370209,3625,3679
3,7404,10,100,0.0001,0.01,0.936,0.9995948136142626,3675,3729
3,7504,10,100,0.0001,0.01,0.936,0.9990671641791045,3729,3775
3,7604,10,100,0.0001,0.01,0.938,0.9921094160967912,3779,3825
3,7704,10,100,0.0001,0.01,0.922,0.9910436137071651,3823,3881
3,7804,10,100,0.0001,0.01,0.922,0.9885955920041004,3873,3931
3,7904,10,100,0.0001,0.01,0.93,0.990005060728745,3928,3976
3,8004,10,100,0.0001,0.01,0.932,0.9912543728135932,3978,4026
3,8104,10,100,0.0001,0.01,0.942,0.995187561697927,4015,4089
3,8204,10,100,0.0001,0.01,0.94,0.9960994636762555,4081,4123
3,8304,10,100,0.0001,0.01,0.942,0.9985549132947977,4128,4176
3,8404,10,100,0.0001,0.01,0.942,0.9994050452165636,4176,4228
3,8504,10,100,0.0001,0.01,0.938,0.9983537158984007,4225,4279
3,8604,10,100,0.0001,0.01,0.952,0.9996513249651325,4281,4323
3,8704,10,100,0.0001,0.01,0.938,0.9986213235294118,4325,4379
3,8804,10,100,0.0001,0.01,0.938,0.995115856428896,4368,4436
3,8904,10,100,0.0001,0.01,0.944,0.9932614555256065,4419,4485
3,9004,10,100,0.0001,0.01,0.944,0.9888938249666814,4478,4526
3,9104,10,100,0.0001,0.01,0.926,0.9879173989455184,4538,4566
3,9204,10,100,0.0001,0.01,0.946,0.9953281182094741,4586,4618
3,9304,10,100,0.0001,0.01,0.954,0.999140154772141,4635,4669
3,9404,10,100,0.0001,0.01,0.946,0.998192258613356,4686,4718
3,9504,10,100,0.0001,0.01,0.946,0.997895622895623,4731,4773
3,9604,10,100,0.0001,0.01,0.95,0.9967721782590587,4779,4825
3,9704,10,100,0.0001,0.01,0.948,0.9982481450948063,4831,4873
3,9804,10,100,0.0001,0.01,0.956,0.9990820073439413,4886,4918
3,9904,10,100,0.0001,0.01,0.962,0.9995961227786753,4931,4973
3,10004,10,100,0.0001,0.01,0.922,0.9644142343062775,4991,5013
3,10104,10,100,0.0001,0.01,0.928,0.959916864608076,5035,5069
3,10204,10,100,0.0001,0.01,0.966,0.9880439043512348,5089,5115
3,10304,10,100,0.0001,0.01,0.972,0.9936917701863354,5137,5167
3,10404,10,100,0.0001,0.01,0.98,0.9984621299500193,5179,5225
3,10504,10,100,0.0001,0.01,0.98,0.9988575780654989,5230,5274
3,10604,10,100,0.0001,0.01,0.984,0.9995284798189362,5284,5320
3,10704,10,100,0.0001,0.01,0.98,0.999439461883408,5333,5371
3,10804,10,100,0.0001,0.01,0.978,0.9997223250647909,5378,5426
3,10904,10,100,0.0001,0.01,0.982,0.9999082905355833,5426,5478
3,11004,10,100,0.0001,0.01,0.986,1.0,5474,5530
3,11104,10,100,0.0001,0.01,0.986,0.9998198847262247,5530,5574
3,11204,10,100,0.0001,0.01,0.988,1.0,5582,5622
3,11304,10,100,0.0001,0.01,0.986,1.0,5635,5669
3,11404,10,100,0.0001,0.01,0.986,1.0,5690,5714
3,11504,10,100,0.0001,0.01,0.986,1.0,5739,5765
3,11604,10,100,0.0001,0.01,0.988,1.0,5791,5813
3,11704,10,100,0.0001,0.01,0.986,1.0,5840,5864
3,11804,10,100,0.0001,0.01,0.988,0.9993222636394442,5885,5919
3,11904,10,100,0.0001,0.01,0.97,0.9894153225806451,5937,5967
3,12004,10,100,0.0001,0.01,0.964,0.987670776407864,5991,6013
3,12104,10,100,0.0001,0.01,0.972,0.9909947124917383,6037,6067
3,12204,10,100,0.0001,0.01,0.98,0.9961488036709276,6083,6121
3,12304,10,100,0.0001,0.01,0.986,0.9993498049414824,6131,6173
3,12404,10,100,0.0001,0.01,0.986,1.0,6191,6213
3,12504,10,100,0.0001,0.01,0.98,1.0,6246,6258
3,12604,10,100,0.0001,0.01,0.984,1.0,6299,6305
3,12704,10,100,0.0001,0.01,0.986,1.0,6344,6360
3,12804,10,100,0.0001,0.01,0.984,1.0,6391,6413
3,12904,10,100,0.0001,0.01,0.982,0.9994575325480471,6446,6458
3,13004,10,100,0.0001,0.01,0.984,0.9996155029221778,6506,6498
3,13104,10,100,0.0001,0.01,0.988,0.9978632478632479,6556,6548
3,13204,10,100,0.0001,0.01,0.968,0.9930324144198728,6606,6598
3,13304,10,100,0.0001,0.01,0.976,0.9923331328923632,6654,6650
3,13404,10,100,0.0001,0.01,0.986,0.9969412115786332,6708,6696
3,13504,10,100,0.0001,0.01,0.99,0.997556279620853,6758,6746
3,13604,10,100,0.0001,0.01,0.986,0.9972802117024404,6802,6802
3,13704,10,100,0.0001,0.01,0.984,0.9983216579100992,6854,6850
3,13804,10,100,0.0001,0.01,0.98,0.9890611416980586,6901,6903
3,13904,10,100,0.0001,0.01,0.978,0.9979142692750288,6950,6954
3,14004,10,100,0.0001,0.01,0.98,0.9978577549271637,7001,7003
3,14104,10,100,0.0001,0.01,0.988,0.9990782756664776,7049,7055
3,14204,10,100,0.0001,0.01,0.974,0.9883835539284709,7100,7104
3,14304,10,100,0.0001,0.01,0.962,0.9837807606263982,7150,7154
3,14404,10,100,0.0001,0.01,0.986,0.9974312690919189,7202,7202
3,14504,10,100,0.0001,0.01,0.982,0.9984142305570877,7255,7249
3,14604,10,100,0.0001,0.01,0.988,0.9989728841413311,7306,7298
3,14704,10,100,0.0001,0.01,0.992,0.9987758433079434,7347,7357
3,14804,10,100,0.0001,0.01,0.992,0.9995947041340179,7394,7410
3,14904,10,100,0.0001,0.01,0.992,0.9998658078368223,7441,7463
3,15004,10,100,0.0001,0.01,0.988,0.9966009064249534,7490,7514
4,104,10,100,0.0001,0.01,0.528,0.5480769230769231,51,53
4,204,10,100,0.0001,0.01,0.492,0.5784313725490197,99,105
4,304,10,100,0.0001,0.01,0.51,0.6644736842105263,152,152
4,404,10,100,0.0001,0.01,0.528,0.6287128712871287,206,198
4,504,10,100,0.0001,0.01,0.544,0.6349206349206349,260,244
4,604,10,100,0.0001,0.01,0.524,0.6556291390728477,305,299
4,704,10,100,0.0001,0.01,0.49,0.6349431818181818,355,349
4,804,10,100,0.0001,0.01,0.498,0.6368159203980099,404,400
4,904,10,100,0.0001,0.01,0.476,0.6537610619469026,457,447
4,1004,10,100,0.0001,0.01,0.466,0.7051792828685259,496,508
4,1104,10,100,0.0001,0.01,0.484,0.6920289855072463,548,556
4,1204,10,100,0.0001,0.01,0.452,0.717607973421927,600,604
4,1304,10,100,0.0001,0.01,0.524,0.6955521472392638,656,648
4,1404,10,100,0.0001,0.01,0.458,0.7150997150997151,701,703
4,1504,10,100,0.0001,0.01,0.476,0.7147606382978723,749,755
4,1604,10,100,0.0001,0.01,0.52,0.7475062344139651,797,807
4,1704,10,100,0.0001,0.01,0.492,0.7593896713615024,848,856
4,1804,10,100,0.0001,0.01,0.504,0.7943458980044346,897,907
4,1904,10,100,0.0001,0.01,0.53,0.8014705882352942,948,956
4,2004,10,100,0.0001,0.01,0.552,0.8073852295409182,1006,998
4,2104,10,100,0.0001,0.01,0.594,0.7599809885931559,1054,1050
4,2204,10,100,0.0001,0.01,0.568,0.8067150635208712,1100,1104
4,2304,10,100,0.0001,0.01,0.596,0.8259548611111112,1150,1154
4,2404,10,100,0.0001,0.01,0.634,0.8652246256239601,1198,1206
4,2504,10,100,0.0001,0.01,0.648,0.8885782747603834,1248,1256
4,2604,10,100,0.0001,0.01,0.662,0.901689708141321,1297,1307
4,2704,10,100,0.0001,0.01,0.67,0.8960798816568047,1346,1358
4,2804,10,100,0.0001,0.01,0.694,0.9069186875891584,1394,1410
4,2904,10,100,0.0001,0.01,0.73,0.928374655647383,1445,1459
4,3004,10,100,0.0001,0.01,0.734,0.9340878828229028,1500,1504
4,3104,10,100,0.0001,0.01,0.762,0.9729381443298969,1551,1553
4,3204,10,100,0.0001,0.01,0.782,0.967852684144819,1605,1599
4,3304,10,100,0.0001,0.01,0.778,0.9497578692493946,1657,1647
4,3404,10,100,0.0001,0.01,0.792,0.964159811985899,1705,1699
4,3504,10,100,0.0001,0.01,0.806,0.9611872146118722,1752,1752
4,3604,10,100,0.0001,0.01,0.784,0.9619866814650389,1802,1802
4,3704,10,100,0.0001,0.01,0.804,0.9622030237580994,1856,1848
4,3804,10,100,0.0001,0.01,0.822,0.9721345951629863,1899,1905
4,3904,10,100,0.0001,0.01,0.832,0.9585040983606558,1950,1954
4,4004,10,100,0.0001,0.01,0.85,0.9827672327672328,2008,1996
4,4104,10,100,0.0001,0.01,0.856,0.9917153996101364,2057,2047
4,4204,10,100,0.0001,0.01,0.85,0.9940532825880114,2107,2097
4,4304,10,100,0.0001,0.01,0.87,0.995817843866171,2165,2139
4,4404,10,100,0.0001,0.01,0.864,0.9909173478655767,2213,2191
4,4504,10,100,0.0001,0.01,0.866,0.9789076376554174,2265,2239
4,4604,10,100,0.0001,0.01,0.858,0.9678540399652477,2302,2302
4,4704,10,100,0.0001,0.01,0.91,0.9910714285714286,2346,2358
4,4804,10,100,0.0001,0.01,0.876,0.9914654454621149,2400,2404
4,4904,10,100,0.0001,0.01,0.896,0.9938825448613376,2453,2451
4,5004,10,100,0.0001,0.01,0.902,0.9974020783373302,2508,2496
4,5104,10,100,0.0001,0.01,0.914,0.9986285266457681,2552,2552
4,5204,10,100,0.0001,0.01,0.9,0.994619523443505,2603,2601
4,5304,10,100,0.0001,0.01,0.9,0.9884992458521871,2653,2651
4,5404,10,100,0.0001,0.01,0.9,0.993338267949667,2702,2702
4,5504,10,100,0.0001,0.01,0.902,0.9952761627906976,2753,2751
4,5604,10,100,0.0001,0.01,0.92,0.9962526766595289,2797,2807
4,5704,10,100,0.0001,0.01,0.928,0.9921107994389902,2846,2858
4,5804,10,100,0.0001,0.01,0.93,0.9967263955892488,2902,2902
4,5904,10,100,0.0001,0.01,0.926,0.9979674796747967,2955,2949
4,6004,10,100,0.0001,0.01,0.934,0.998834110592938,2996,3008
4,6104,10,100,0.0001,0.01,0.93,0.9952490170380078,3039,3065
4,6204,10,100,0.0001,0.01,0.922,0.9977433913604127,3088,3116
4,6304,10,100,0.0001,0.01,0.926,0.9914340101522843,3137,3167
4,6404,10,100,0.0001,0.01,0.942,0.9968769519050593,3181,3223
4,6504,10,100,0.0001,0.01,0.934,0.9970787207872078,3233,3271
4,6604,10,100,0.0001,0.01,0.924,0.9892489400363416,3287,3317
4,6704,10,100,0.0001,0.01,0.938,0.9943317422434368,3341,3363
4,6804,10,100,0.0001,0.01,0.946,0.9930922986478542,3390,3414
4,6904,10,100,0.0001,0.01,0.95,0.9959443800695249,3438,3466
4,7004,10,100,0.0001,0.01,0.958,0.9984294688749286,3487,3517
4,7104,10,100,0.0001,0.01,0.95,0.9974662162162162,3530,3574
4,7204,10,100,0.0001,0.01,0.95,0.9938922820655192,3587,3617
4,7304,10,100,0.0001,0.01,0.952,0.9978094194961665,3640,3664
4,7404,10,100,0.0001,0.01,0.966,0.997163695299838,3687,3717
4,7504,10,100,0.0001,0.01,0.956,0.9964019189765458,3738,3766
4,7604,10,100,0.0001,0.01,0.96,0.997369805365597,3783,3821
4,7704,10,100,0.0001,0.01,0.954,0.9951973001038421,3831,3873
4,7804,10,100,0.0001,0.01,0.958,0.9952588416196823,3877,3927
4,7904,10,100,0.0001,0.01,0.954,0.993168016194332,3923,3981
4,8004,10,100,0.0001,0.01,0.958,0.9942528735632183,3976,4028
4,8104,10,100,0.0001,0.01,0.95,0.9949407699901284,4022,4082
4,8204,10,100,0.0001,0.01,0.948,0.9941491955143832,4078,4126
4,8304,10,100,0.0001,0.01,0.968,0.9944605009633911,4125,4179
4,8404,10,100,0.0001,0.01,0.968,0.9975011899095668,4175,4229
4,8504,10,100,0.0001,0.01,0.966,0.9978833490122295,4228,4276
4,8604,10,100,0.0001,0.01,0.966,0.9998837749883775,4283,4321
4,8704,10,100,0.0001,0.01,0.954,0.998046875,4327,4377
4,8804,10,100,0.0001,0.01,0.966,0.997955474784189,4379,4425
4,8904,10,100,0.0001,0.01,0.97,0.9993261455525606,4431,4473
4,9004,10,100,0.0001,0.01,0.966,0.9955575299866726,4472,4532
4,9104,10,100,0.0001,0.01,0.928,0.9624340949033392,4525,4579
4,9204,10,100,0.0001,0.01,0.966,0.990438939591482,4575,4629
4,9304,10,100,0.0001,0.01,0.978,0.9946259673258814,4626,4678
4,9404,10,100,0.0001,0.01,0.99,0.9985112717992344,4671,4733
4,9504,10,100,0.0001,0.01,0.986,0.9995791245791246,4724,4780
4,9604,10,100,0.0001,0.01,0.984,0.9988546438983756,4777,4827
4,9704,10,100,0.0001,0.01,0.982,0.999484748557296,4821,4883
4,9804,10,100,0.0001,0.01,0.99,1.0,4871,4933
4,9904,10,100,0.0001,0.01,0.99,0.9997980613893377,4925,4979
4,10004,10,100,0.0001,0.01,0.99,1.0,4968,5036
4,10104,10,100,0.0001,0.01,0.99,1.0,5013,5091
4,10204,10,100,0.0001,0.01,0.992,1.0,5063,5141
4,10304,10,100,0.0001,0.01,0.992,1.0,5114,5190
4,10404,10,100,0.0001,0.01,0.986,0.9999038831218762,5168,5236
4,10504,10,100,0.0001,0.01,0.994,0.9999047981721249,5217,5287
4,10604,10,100,0.0001,0.01,0.99,0.9987740475292343,5267,5337
4,10704,10,100,0.0001,0.01,0.976,0.9957959641255605,5325,5379
4,10804,10,100,0.0001,0.01,0.972,0.9941688263606072,5383,5421
4,10904,10,100,0.0001,0.01,0.97,0.9933969185619956,5430,5474
4,11004,10,100,0.0001,0.01,0.974,0.9935478007997092,5477,5527
4,11104,10,100,0.0001,0.01,0.982,0.9960374639769453,5528,5576
4,11204,10,100,0.0001,0.01,0.984,0.9984826847554444,5578,5626
4,11304,10,100,0.0001,0.01,0.988,0.9984961075725407,5628,5676
4,11404,10,100,0.0001,0.01,0.988,0.9985969835145563,5672,5732
4,11504,10,100,0.0001,0.01,0.984,0.9989568845618915,5724,5780
4,11604,10,100,0.0001,0.01,0.99,0.999741468459152,5781,5823
4,11704,10,100,0.0001,0.01,0.992,1.0,5843,5861
4,11804,10,100,0.0001,0.01,0.992,1.0,5902,5902
4,11904,10,100,0.0001,0.01,0.984,0.9992439516129032,5948,5956
4,12004,10,100,0.0001,0.01,0.974,0.9955014995001666,6001,6003
4,12104,10,100,0.0001,0.01,0.982,0.994960343688037,6047,6057
4,12204,10,100,0.0001,0.01,0.984,0.9958210422812193,6098,6106
4,12304,10,100,0.0001,0.01,0.99,0.9987808842652796,6147,6157
4,12404,10,100,0.0001,0.01,0.988,0.9991131892937762,6192,6212
4,12504,10,100,0.0001,0.01,0.986,0.9967210492642354,6241,6263
4,12604,10,100,0.0001,0.01,0.99,0.9968264043160902,6297,6307
4,12704,10,100,0.0001,0.01,0.988,0.9969301007556675,6339,6365
4,12804,10,100,0.0001,0.01,0.99,0.9974226804123711,6387,6417
4,12904,10,100,0.0001,0.01,0.99,0.9946528208307501,6436,6468
4,13004,10,100,0.0001,0.01,0.99,0.9978468163641956,6488,6516
4,13104,10,100,0.0001,0.01,0.994,0.9999236874236874,6531,6573
4,13204,10,100,0.0001,0.01,0.992,0.9998485307482581,6586,6618
4,13304,10,100,0.0001,0.01,0.994,1.0,6632,6672
4,13404,10,100,0.0001,0.01,0.994,1.0,6682,6722
4,13504,10,100,0.0001,0.01,0.99,1.0,6730,6774
4,13604,10,100,0.0001,0.01,0.994,1.0,6779,6825
4,13704,10,100,0.0001,0.01,0.994,0.9997810858143608,6837,6867
4,13804,10,100,0.0001,0.01,0.992,1.0,6890,6914
4,13904,10,100,0.0001,0.01,0.992,1.0,6936,6968
4,14004,10,100,0.0001,0.01,0.992,1.0,6987,7017
4,14104,10,100,0.0001,0.01,0.992,1.0,7036,7068
4,14204,10,100,0.0001,0.01,0.992,1.0,7094,7110
4,14304,10,100,0.0001,0.01,0.992,1.0,7149,7155
4,14404,10,100,0.0001,0.01,0.992,1.0,7190,7214
4,14504,10,100,0.0001,0.01,0.99,0.9984831770546057,7237,7267
4,14604,10,100,0.0001,0.01,0.972,0.9782251437962202,7285,7319
4,14704,10,100,0.0001,0.01,0.982,0.9961235038084875,7335,7369
4,14804,10,100,0.0001,0.01,0.994,0.9982437179140773,7379,7425
4,14904,10,100,0.0001,0.01,0.992,0.9991277509393451,7426,7478
4,15004,10,100,0.0001,0.01,0.994,0.9999333511063716,7488,7516
5,104,10,100,0.0001,0.01,0.534,0.6346153846153846,54,50
5,204,10,100,0.0001,0.01,0.51,0.7058823529411765,100,104
5,304,10,100,0.0001,0.01,0.518,0.6513157894736842,155,149
5,404,10,100,0.0001,0.01,0.464,0.6163366336633663,204,200
5,504,10,100,0.0001,0.01,0.492,0.626984126984127,248,256
5,604,10,100,0.0001,0.01,0.518,0.6076158940397351,297,307
5,704,10,100,0.0001,0.01,0.486,0.6349431818181818,353,351
5,804,10,100,0.0001,0.01,0.51,0.6268656716417911,397,407
5,904,10,100,0.0001,0.01,0.532,0.6692477876106194,441,463
5,1004,10,100,0.0001,0.01,0.534,0.647410358565737,498,506
5,1104,10,100,0.0001,0.01,0.494,0.6467391304347826,544,560
5,1204,10,100,0.0001,0.01,0.504,0.6735880398671097,596,608
5,1304,10,100,0.0001,0.01,0.514,0.6840490797546013,651,653
5,1404,10,100,0.0001,0.01,0.512,0.717948717948718,692,712
5,1504,10,100,0.0001,0.01,0.492,0.7087765957446809,744,760
5,1604,10,100,0.0001,0.01,0.504,0.7125935162094763,799,805
5,1704,10,100,0.0001,0.01,0.516,0.7012910798122066,857,847
5,1804,10,100,0.0001,0.01,0.522,0.729490022172949,906,898
5,1904,10,100,0.0001,0.01,0.53,0.7542016806722689,951,953
5,2004,10,100,0.0001,0.01,0.532,0.7574850299401198,998,1006
5,2104,10,100,0.0001,0.01,0.53,0.7538022813688213,1053,1051
5,2204,10,100,0.0001,0.01,0.522,0.7917422867513612,1096,1108
5,2304,10,100,0.0001,0.01,0.518,0.7855902777777778,1142,1162
5,2404,10,100,0.0001,0.01,0.51,0.8024126455906821,1187,1217
5,2504,10,100,0.0001,0.01,0.542,0.8246805111821086,1234,1270
5,2604,10,100,0.0001,0.01,0.542,0.8486943164362519,1287,1317
5,2704,10,100,0.0001,0.01,0.538,0.853180473372781,1343,1361
5,2804,10,100,0.0001,0.01,0.568,0.880527817403709,1402,1402
5,2904,10,100,0.0001,0.01,0.566,0.8636363636363636,1454,1450
5,3004,10,100,0.0001,0.01,0.564,0.8788282290279628,1497,1507
5,3104,10,100,0.0001,0.01,0.574,0.8865979381443299,1534,1570
5,3204,10,100,0.0001,0.01,0.608,0.9079275905118602,1589,1615
5,3304,10,100,0.0001,0.01,0.578,0.9019370460048426,1637,1667
5,3404,10,100,0.0001,0.01,0.634,0.9430082256169212,1689,1715
5,3504,10,100,0.0001,0.01,0.68,0.9392123287671232,1745,1759
5,3604,10,100,0.0001,0.01,0.636,0.9270255271920089,1795,1809
5,3704,10,100,0.0001,0.01,0.626,0.8941684665226782,1849,1855
5,3804,10,100,0.0001,0.01,0.628,0.9032597266035752,1904,1900
5,3904,10,100,0.0001,0.01,0.636,0.8913934426229508,1950,1954
5,4004,10,100,0.0001,0.01,0.66,0.9213286713286714,2001,2003
5,4104,10,100,0.0001,0.01,0.652,0.9210526315789473,2040,2064
5,4204,10,100,0.0001,0.01,0.704,0.9602759276879163,2078,2126
5,4304,10,100,0.0001,0.01,0.7,0.9588754646840149,2128,2176
5,4404,10,100,0.0001,0.01,0.696,0.9518619436875567,2186,2218
5,4504,10,100,0.0001,0.01,0.752,0.9553730017761989,2240,2264
5,4604,10,100,0.0001,0.01,0.746,0.9728496959165943,2296,2308
5,4704,10,100,0.0001,0.01,0.782,0.9842687074829932,2350,2354
5,4804,10,100,0.0001,0.01,0.79,0.9879267277268943,2396,2408
5,4904,10,100,0.0001,0.01,0.806,0.9908238172920065,2446,2458
5,5004,10,100,0.0001,0.01,0.81,0.9858113509192646,2494,2510
5,5104,10,100,0.0001,0.01,0.782,0.9245689655172413,2554,2550
5,5204,10,100,0.0001,0.01,0.812,0.9667563412759416,2604,2600
5,5304,10,100,0.0001,0.01,0.826,0.9894419306184012,2654,2650
5,5404,10,100,0.0001,0.01,0.836,0.9896373056994818,2702,2702
5,5504,10,100,0.0001,0.01,0.852,0.9952761627906976,2758,2746
5,5604,10,100,0.0001,0.01,0.856,0.9958957887223412,2809,2795
5,5704,10,100,0.0001,0.01,0.852,0.9975455820476858,2854,2850
5,5804,10,100,0.0001,0.01,0.856,0.9936250861474845,2908,2896
5,5904,10,100,0.0001,0.01,0.85,0.9813685636856369,2966,2938
5,6004,10,100,0.0001,0.01,0.866,0.9923384410393071,3020,2984
5,6104,10,100,0.0001,0.01,0.852,0.9927916120576671,3065,3039
5,6204,10,100,0.0001,0.01,0.89,0.993391360412637,3121,3083
5,6304,10,100,0.0001,0.01,0.88,0.9976205583756346,3162,3142
5,6404,10,100,0.0001,0.01,0.902,0.9976577139287945,3207,3197
5,6504,10,100,0.0001,0.01,0.892,0.9972324723247232,3260,3244
5,6604,10,100,0.0001,0.01,0.882,0.9921259842519685,3303,3301
5,6704,10,100,0.0001,0.01,0.89,0.9926909307875895,3355,3349
5,6804,10,100,0.0001,0.01,0.882,0.9925044091710759,3402,3402
5,6904,10,100,0.0001,0.01,0.896,0.9894264194669756,3450,3454
5,7004,10,100,0.0001,0.01,0.918,0.9915762421473444,3499,3505
5,7104,10,100,0.0001,0.01,0.91,0.9956362612612613,3547,3557
5,7204,10,100,0.0001,0.01,0.904,0.9901443642420877,3590,3614
5,7304,10,100,0.0001,0.01,0.906,0.9864457831325302,3643,3661
5,7404,10,100,0.0001,0.01,0.908,0.9890599675850892,3692,3712
5,7504,10,100,0.0001,0.01,0.92,0.9918710021321961,3745,3759
5,7604,10,100,0.0001,0.01,0.922,0.996449237243556,3791,3813
5,7704,10,100,0.0001,0.01,0.932,0.9968847352024922,3840,3864
5,7804,10,100,0.0001,0.01,0.934,0.9974372116863147,3888,3916
5,7904,10,100,0.0001,0.01,0.942,0.9978491902834008,3929,3975
5,8004,10,100,0.0001,0.01,0.94,0.9966266866566716,3982,4022
5,8104,10,100,0.0001,0.01,0.954,0.9986426456071076,4031,4073
5,8204,10,100,0.0001,0.01,0.94,0.9921989273525109,4084,4120
5,8304,10,100,0.0001,0.01,0.936,0.9990366088631984,4131,4173
5,8404,10,100,0.0001,0.01,0.94,0.9984531175630652,4184,4220
5,8504,10,100,0.0001,0.01,0.936,0.9950611476952023,4231,4273
5,8604,10,100,0.0001,0.01,0.94,0.9931427243142724,4276,4328
5,8704,10,100,0.0001,0.01,0.944,0.9951746323529411,4336,4368
5,8804,10,100,0.0001,0.01,0.922,0.975465697410268,4392,4412
5,8904,10,100,0.0001,0.01,0.948,0.9750673854447439,4445,4459
5,9004,10,100,0.0001,0.01,0.934,0.9854509107063527,4502,4502
5,9104,10,100,0.0001,0.01,0.956,0.9949472759226714,4553,4551
5,9204,10,100,0.0001,0.01,0.956,0.9975010864841374,4598,4606
5,9304,10,100,0.0001,0.01,0.958,0.9978503869303526,4647,4657
5,9404,10,100,0.0001,0.01,0.96,0.9994683113568694,4693,4711
5,9504,10,100,0.0001,0.01,0.972,0.9993686868686869,4738,4766
5,9604,10,100,0.0001,0.01,0.972,0.9997917534360683,4790,4814
5,9704,10,100,0.0001,0.01,0.968,0.9998969497114591,4844,4860
5,9804,10,100,0.0001,0.01,0.968,1.0,4902,4902
5,9904,10,100,0.0001,0.01,0.97,1.0,4954,4950
5,10004,10,100,0.0001,0.01,0.962,0.998500599760096,4998,5006
5,10104,10,100,0.0001,0.01,0.964,0.9984164687252574,5050,5054
5,10204,10,100,0.0001,0.01,0.958,0.9928459427675421,5111,5093
5,10304,10,100,0.0001,0.01,0.956,0.9944681677018633,5162,5142
5,10404,10,100,0.0001,0.01,0.958,0.9951941560938101,5211,5193
5,10504,10,100,0.0001,0.01,0.956,0.9967631378522468,5254,5250
5,10604,10,100,0.0001,0.01,0.962,0.9956620143342135,5308,5296
5,10704,10,100,0.0001,0.01,0.962,0.9981315396113603,5363,5341
5,10804,10,100,0.0001,0.01,0.964,0.998333950388745,5410,5394
5,10904,10,100,0.0001,0.01,0.966,0.9942223037417461,5458,5446
5,11004,10,100,0.0001,0.01,0.97,0.9977280988731371,5509,5495
5,11104,10,100,0.0001,0.01,0.974,0.9992795389048992,5552,5552
5,11204,10,100,0.0001,0.01,0.964,0.9977686540521242,5601,5603
5,11304,10,100,0.0001,0.01,0.972,0.9978768577494692,5646,5658
5,11404,10,100,0.0001,0.01,0.956,0.9972816555594528,5698,5706
5,11504,10,100,0.0001,0.01,0.964,0.9964360222531293,5755,5749
5,11604,10,100,0.0001,0.01,0.952,0.989572561185798,5807,5797
5,11704,10,100,0.0001,0.01,0.968,0.9968386876281613,5863,5841
5,11804,10,100,0.0001,0.01,0.976,0.9977126397831244,5921,5883
5,11904,10,100,0.0001,0.01,0.98,0.9971438172043011,5970,5934
5,12004,10,100,0.0001,0.01,0.984,0.9977507497500833,6026,5978
5,12104,10,100,0.0001,0.01,0.976,0.998512888301388,6073,6031
5,12204,10,100,0.0001,0.01,0.982,0.9978695509668961,6125,6079
5,12304,10,100,0.0001,0.01,0.976,0.9972366710013004,6175,6129
5,12404,10,100,0.0001,0.01,0.974,0.9972589487262173,6227,6177
5,12504,10,100,0.0001,0.01,0.976,0.9967210492642354,6279,6225
5,12604,10,100,0.0001,0.01,0.986,0.9989685814027293,6330,6274
5,12704,10,100,0.0001,0.01,0.986,0.999448992443325,6376,6328
5,12804,10,100,0.0001,0.01,0.986,0.9992970946579194,6432,6372
5,12904,10,100,0.0001,0.01,0.982,0.999845009299442,6483,6421
5,13004,10,100,0.0001,0.01,0.986,0.9999231005844356,6523,6481
5,13104,10,100,0.0001,0.01,0.984,0.9991605616605617,6575,6529
5,13204,10,100,0.0001,0.01,0.98,0.9942441684338079,6630,6574
5,13304,10,100,0.0001,0.01,0.966,0.9914311485267588,6679,6625
5,13404,10,100,0.0001,0.01,0.984,0.9950760966875559,6720,6684
5,13504,10,100,0.0001,0.01,0.986,0.9958530805687204,6771,6733
5,13604,10,100,0.0001,0.01,0.99,0.9969126727433107,6816,6788
5,13704,10,100,0.0001,0.01,0.984,0.9975919439579685,6867,6837
5,13804,10,100,0.0001,0.01,0.992,0.9975369458128078,6912,6892
5,13904,10,100,0.0001,0.01,0.988,0.9982019562715765,6955,6949
5,14004,10,100,0.0001,0.01,0.994,0.9994287346472437,7008,6996
5,14104,10,100,0.0001,0.01,0.98,0.991988088485536,7067,7037
5,14204,10,100,0.0001,0.01,0.984,0.9969726837510561,7114,7090
5,14304,10,100,0.0001,0.01,0.99,0.9985318791946308,7161,7143
5,14404,10,100,0.0001,0.01,0.996,0.9994445987225771,7217,7187
5,14504,10,100,0.0001,0.01,0.996,0.9997931605074463,7271,7233
5,14604,10,100,0.0001,0.01,0.996,0.9999315256094221,7318,7286
5,14704,10,100,0.0001,0.01,0.994,0.999727965179543,7362,7342
5,14804,10,100,0.0001,0.01,0.996,0.9997973520670089,7417,7387
5,14904,10,100,0.0001,0.01,0.992,0.9993961352657005,7464,7440
5,15004,10,100,0.0001,0.01,0.996,0.9999333511063716,7508,7496
6,104,10,100,0.0001,0.01,0.526,0.6057692307692307,63,41
6,204,10,100,0.0001,0.01,0.522,0.6176470588235294,110,94
6,304,10,100,0.0001,0.01,0.52,0.6513157894736842,162,142
6,404,10,100,0.0001,0.01,0.504,0.6782178217821783,216,188
6,504,10,100,0.0001,0.01,0.532,0.6746031746031746,270,234
6,604,10,100,0.0001,0.01,0.516,0.6589403973509934,322,282
6,704,10,100,0.0001,0.01,0.532,0.6732954545454546,367,337
6,804,10,100,0.0001,0.01,0.496,0.6616915422885572,412,392
6,904,10,100,0.0001,0.01,0.516,0.672566371681416,462,442
6,1004,10,100,0.0001,0.01,0.546,0.6942231075697212,516,488
6,1104,10,100,0.0001,0.01,0.504,0.6865942028985508,570,534
6,1204,10,100,0.0001,0.01,0.54,0.7043189368770764,624,580
6,1304,10,100,0.0001,0.01,0.562,0.6986196319018405,666,638
6,1404,10,100,0.0001,0.01,0.518,0.7044159544159544,726,678
6,1504,10,100,0.0001,0.01,0.546,0.7007978723404256,777,727
6,1604,10,100,0.0001,0.01,0.556,0.7531172069825436,828,776
6,1704,10,100,0.0001,0.01,0.558,0.7341549295774648,884,820
6,1804,10,100,0.0001,0.01,0.536,0.7788248337028825,934,870
6,1904,10,100,0.0001,0.01,0.53,0.7542016806722689,991,913
6,2004,10,100,0.0001,0.01,0.556,0.8088822355289421,1041,963
6,2104,10,100,0.0001,0.01,0.58,0.7946768060836502,1096,1008
6,2204,10,100,0.0001,0.01,0.618,0.8348457350272233,1151,1053
6,2304,10,100,0.0001,0.01,0.586,0.7868923611111112,1202,1102
6,2404,10,100,0.0001,0.01,0.642,0.8361064891846922,1251,1153
6,2504,10,100,0.0001,0.01,0.646,0.853035143769968,1298,1206
6,2604,10,100,0.0001,0.01,0.668,0.892089093701997,1349,1255
6,2704,10,100,0.0001,0.01,0.698,0.9215976331360947,1404,1300
6,2804,10,100,0.0001,0.01,0.694,0.8994293865905849,1454,1350
6,2904,10,100,0.0001,0.01,0.704,0.8929063360881543,1509,1395
6,3004,10,100,0.0001,0.01,0.736,0.920439414114514,1559,1445
6,3104,10,100,0.0001,0.01,0.75,0.9085051546391752,1603,1501
6,3204,10,100,0.0001,0.01,0.788,0.9382022471910112,1653,1551
6,3304,10,100,0.0001,0.01,0.822,0.9633777239709443,1697,1607
6,3404,10,100,0.0001,0.01,0.8,0.9723854289071681,1747,1657
6,3504,10,100,0.0001,0.01,0.824,0.9803082191780822,1799,1705
6,3604,10,100,0.0001,0.01,0.84,0.9875138734739178,1850,1754
6,3704,10,100,0.0001,0.01,0.85,0.9894708423326134,1899,1805
6,3804,10,100,0.0001,0.01,0.848,0.9758149316508938,1940,1864
6,3904,10,100,0.0001,0.01,0.848,0.9664446721311475,1993,1911
6,4004,10,100,0.0001,0.01,0.838,0.9775224775224776,2044,1960
6,4104,10,100,0.0001,0.01,0.872,0.9912280701754386,2091,2013
6,4204,10,100,0.0001,0.01,0.874,0.9959562321598477,2140,2064
6,4304,10,100,0.0001,0.01,0.884,0.9967472118959108,2194,2110
6,4404,10,100,0.0001,0.01,0.902,0.9963669391462306,2242,2162
6,4504,10,100,0.0001,0.01,0.902,0.9957815275310835,2291,2213
6,4604,10,100,0.0001,0.01,0.91,0.9973935708079931,2343,2261
6,4704,10,100,0.0001,0.01,0.926,0.9968112244897959,2397,2307
6,4804,10,100,0.0001,0.01,0.922,0.9922980849292257,2451,2353
6,4904,10,100,0.0001,0.01,0.926,0.9973491027732463,2497,2407
6,5004,10,100,0.0001,0.01,0.934,0.9970023980815348,2544,2460
6,5104,10,100,0.0001,0.01,0.918,0.9962774294670846,2595,2509
6,5204,10,100,0.0001,0.01,0.936,0.9955803228285934,2643,2561
6,5304,10,100,0.0001,0.01,0.936,0.9979260935143288,2689,2615
6,5404,10,100,0.0001,0.01,0.936,0.9789045151739453,2736,2668
6,5504,10,100,0.0001,0.01,0.932,0.9896438953488372,2779,2725
6,5604,10,100,0.0001,0.01,0.93,0.98197715917202,2838,2766
6,5704,10,100,0.0001,0.01,0.948,0.9949158485273493,2879,2825
6,5804,10,100,0.0001,0.01,0.95,0.9948311509303929,2929,2875
6,5904,10,100,0.0001,0.01,0.928,0.989329268292683,2977,2927
6,6004,10,100,0.0001,0.01,0.95,0.9888407728181212,3030,2974
6,6104,10,100,0.0001,0.01,0.958,0.9947575360419397,3083,3021
6,6204,10,100,0.0001,0.01,0.954,0.9959703417150225,3126,3078
6,6304,10,100,0.0001,0.01,0.952,0.9979378172588832,3168,3136
6,6404,10,100,0.0001,0.01,0.96,0.9982823235477827,3212,3192
6,6504,10,100,0.0001,0.01,0.96,0.998769987699877,3257,3247
6,6604,10,100,0.0001,0.01,0.966,0.9983343428225318,3310,3294
6,6704,10,100,0.0001,0.01,0.964,0.9979116945107399,3351,3353
6,6804,10,100,0.0001,0.01,0.96,0.9926513815402704,3401,3403
6,6904,10,100,0.0001,0.01,0.962,0.9939165701042874,3448,3456
6,7004,10,100,0.0001,0.01,0.952,0.9908623643632211,3496,3508
6,7104,10,100,0.0001,0.01,0.972,0.9949324324324325,3553,3551
6,7204,10,100,0.0001,0.01,0.972,0.9987506940588562,3603,3601
6,7304,10,100,0.0001,0.01,0.972,0.9991785323110625,3656,3648
6,7404,10,100,0.0001,0.01,0.982,0.9993246893571043,3701,3703
6,7504,10,100,0.0001,0.01,0.976,0.9994669509594882,3759,3745
6,7604,10,100,0.0001,0.01,0.98,0.9998684902682798,3803,3801
6,7704,10,100,0.0001,0.01,0.982,0.9985721703011423,3851,3853
6,7804,10,100,0.0001,0.01,0.976,0.9978216299333675,3899,3905
6,7904,10,100,0.0001,0.01,0.972,0.99709008097166,3955,3949
6,8004,10,100,0.0001,0.01,0.972,0.9965017491254373,4003,4001
6,8104,10,100,0.0001,0.01,0.984,0.9998766041461007,4057,4047
6,8204,10,100,0.0001,0.01,0.974,0.9980497318381277,4106,4098
6,8304,10,100,0.0001,0.01,0.97,0.9977119460500964,4162,4142
6,8404,10,100,0.0001,0.01,0.972,0.9941694431223227,4215,4189
6,8504,10,100,0.0001,0.01,0.97,0.9932972718720602,4269,4235
6,8604,10,100,0.0001,0.01,0.98,0.9953509995351,4320,4284
6,8704,10,100,0.0001,0.01,0.98,0.9974724264705882,4378,4326
6,8804,10,100,0.0001,0.01,0.962,0.9883007723761926,4425,4379
6,8904,10,100,0.0001,0.01,0.982,0.996967654986523,4475,4429
6,9004,10,100,0.0001,0.01,0.984,0.9986672589960017,4522,4482
6,9104,10,100,0.0001,0.01,0.978,0.999670474516696,4566,4538
6,9204,10,100,0.0001,0.01,0.984,0.9997827031725337,4614,4590
6,9304,10,100,0.0001,0.01,0.984,0.9995700773860705,4659,4645
6,9404,10,100,0.0001,0.01,0.986,0.9997873245427478,4707,4697
6,9504,10,100,0.0001,0.01,0.986,0.9998947811447811,4761,4743
6,9604,10,100,0.0001,0.01,0.986,0.9998958767180341,4817,4787
6,9704,10,100,0.0001,0.01,0.988,1.0,4871,4833
6,9804,10,100,0.0001,0.01,0.986,1.0,4920,4884
6,9904,10,100,0.0001,0.01,0.986,1.0,4968,4936
6,10004,10,100,0.0001,0.01,0.99,0.9991003598560576,5021,4983
6,10104,10,100,0.0001,0.01,0.976,0.9953483768804434,5076,5028
6,10204,10,100,0.0001,0.01,0.982,0.9903959231673853,5127,5077
6,10304,10,100,0.0001,0.01,0.988,0.9942740683229814,5179,5125
6,10404,10,100,0.0001,0.01,0.956,0.9772202998846597,5225,5179
6,10504,10,100,0.0001,0.01,0.988,0.9982863670982483,5272,5232
6,10604,10,100,0.0001,0.01,0.982,0.9961335345152773,5315,5289
6,10704,10,100,0.0001,0.01,0.986,0.9989723467862481,5368,5336
6,10804,10,100,0.0001,0.01,0.984,0.999537208441318,5421,5383
6,10904,10,100,0.0001,0.01,0.992,0.9999082905355833,5474,5430
6,11004,10,100,0.0001,0.01,0.988,1.0,5528,5476
6,11104,10,100,0.0001,0.01,0.988,1.0,5578,5526
6,11204,10,100,0.0001,0.01,0.99,0.9997322384862549,5629,5575
6,11304,10,100,0.0001,0.01,0.99,0.9999115357395613,5675,5629
6,11404,10,100,0.0001,0.01,0.99,1.0,5728,5676
6,11504,10,100,0.0001,0.01,0.99,1.0,5773,5731
6,11604,10,100,0.0001,0.01,0.99,0.9995691140985867,5822,5782
6,11704,10,100,0.0001,0.01,0.982,0.9993164730006835,5875,5829
6,11804,10,100,0.0001,0.01,0.99,0.9989833954591664,5925,5879
6,11904,10,100,0.0001,0.01,0.986,0.9939516129032258,5970,5934
6,12004,10,100,0.0001,0.01,0.976,0.9967510829723426,6023,5981
6,12104,10,100,0.0001,0.01,0.986,0.9971083939193655,6083,6021
6,12204,10,100,0.0001,0.01,0.986,0.9972140281874795,6127,6077
6,12304,10,100,0.0001,0.01,0.988,0.9961801040312094,6176,6128
6,12404,10,100,0.0001,0.01,0.992,1.0,6220,6184
6,12504,10,100,0.0001,0.01,0.994,0.9998400511836213,6261,6243
6,12604,10,100,0.0001,0.01,0.994,0.9999206601079023,6314,6290
6,12704,10,100,0.0001,0.01,0.986,0.9988979848866498,6367,6337
6,12804,10,100,0.0001,0.01,0.99,0.9989065916900969,6415,6389
6,12904,10,100,0.0001,0.01,0.988,0.9986825790452573,6467,6437
6,13004,10,100,0.0001,0.01,0.994,0.9983082128575823,6511,6493
6,13104,10,100,0.0001,0.01,0.98,0.9952686202686203,6568,6536
6,13204,10,100,0.0001,0.01,0.99,0.989775825507422,6620,6584
6,13304,10,100,0.0001,0.01,0.99,0.9993986770895971,6663,6641
6,13404,10,100,0.0001,0.01,0.99,0.9944792599224113,6705,6699
6,13504,10,100,0.0001,0.01,0.988,0.9997037914691943,6755,6749
6,13604,10,100,0.0001,0.01,0.99,0.9997794766245222,6805,6799
6,13704,10,100,0.0001,0.01,0.988,1.0,6855,6849
6,13804,10,100,0.0001,0.01,0.986,0.9993480150680962,6895,6909
6,13904,10,100,0.0001,0.01,0.988,0.9989211737629459,6949,6955
6,14004,10,100,0.0001,0.01,0.988,0.9986432447872037,6997,7007
6,14104,10,100,0.0001,0.01,0.99,0.9970221213840046,7044,7060
6,14204,10,100,0.0001,0.01,0.984,0.9987327513376514,7090,7114
6,14304,10,100,0.0001,0.01,0.988,0.9992309843400448,7141,7163
6,14404,10,100,0.0001,0.01,0.986,0.9999305748403221,7185,7219
6,14504,10,100,0.0001,0.01,0.988,0.9999310535024821,7234,7270
6,14604,10,100,0.0001,0.01,0.988,1.0,7286,7318
6,14704,10,100,0.0001,0.01,0.988,1.0,7336,7368
6,14804,10,100,0.0001,0.01,0.988,1.0,7393,7411
6,14904,10,100,0.0001,0.01,0.992,0.9991277509393451,7445,7459
6,15004,10,100,0.0001,0.01,0.99,0.9982671287656625,7489,7515
7,104,10,100,0.0001,0.01,0.5,0.5769230769230769,44,60
7,204,10,100,0.0001,0.01,0.498,0.5882352941176471,86,118
7,304,10,100,0.0001,0.01,0.486,0.6776315789473685,128,176
7,404,10,100,0.0001,0.01,0.472,0.6460396039603961,173,231
7,504,10,100,0.0001,0.01,0.504,0.6666666666666666,229,275
7,604,10,100,0.0001,0.01,0.504,0.6274834437086093,285,319
7,704,10,100,0.0001,0.01,0.504,0.6434659090909091,341,363
7,804,10,100,0.0001,0.01,0.494,0.6803482587064676,390,414
7,904,10,100,0.0001,0.01,0.502,0.665929203539823,437,467
7,1004,10,100,0.0001,0.01,0.498,0.6792828685258964,488,516
7,1104,10,100,0.0001,0.01,0.494,0.6992753623188406,535,569
7,1204,10,100,0.0001,0.01,0.476,0.7026578073089701,582,622
7,1304,10,100,0.0001,0.01,0.494,0.723159509202454,625,679
7,1404,10,100,0.0001,0.01,0.484,0.7492877492877493,679,725
7,1504,10,100,0.0001,0.01,0.514,0.7586436170212766,732,772
7,1604,10,100,0.0001,0.01,0.526,0.770573566084788,775,829
7,1704,10,100,0.0001,0.01,0.532,0.7529342723004695,825,879
7,1804,10,100,0.0001,0.01,0.55,0.8004434589800443,869,935
7,1904,10,100,0.0001,0.01,0.552,0.7752100840336135,924,980
7,2004,10,100,0.0001,0.01,0.55,0.7969061876247505,979,1025
7,2104,10,100,0.0001,0.01,0.576,0.811787072243346,1029,1075
7,2204,10,100,0.0001,0.01,0.604,0.8371143375680581,1073,1131
7,2304,10,100,0.0001,0.01,0.642,0.8324652777777778,1125,1179
7,2404,10,100,0.0001,0.01,0.648,0.8718801996672213,1174,1230
7,2504,10,100,0.0001,0.01,0.66,0.9001597444089456,1226,1278
7,2604,10,100,0.0001,0.01,0.71,0.9166666666666666,1285,1319
7,2704,10,100,0.0001,0.01,0.714,0.9101331360946746,1326,1378
7,2804,10,100,0.0001,0.01,0.718,0.9247503566333809,1384,1420
7,2904,10,100,0.0001,0.01,0.722,0.9321625344352618,1445,1459
7,3004,10,100,0.0001,0.01,0.756,0.9513981358189081,1497,1507
7,3104,10,100,0.0001,0.01,0.732,0.9133376288659794,1549,1555
7,3204,10,100,0.0001,0.01,0.784,0.9509987515605494,1591,1613
7,3304,10,100,0.0001,0.01,0.802,0.9424939467312349,1653,1651
7,3404,10,100,0.0001,0.01,0.818,0.972972972972973,1710,1694
7,3504,10,100,0.0001,0.01,0.832,0.9868721461187214,1764,1740
7,3604,10,100,0.0001,0.01,0.856,0.9908435072142064,1817,1787
7,3704,10,100,0.0001,0.01,0.868,0.9929805615550756,1867,1837
7,3804,10,100,0.0001,0.01,0.848,0.9745005257623555,1913,1891
7,3904,10,100,0.0001,0.01,0.81,0.9439036885245902,1957,1947
7,4004,10,100,0.0001,0.01,0.868,0.9755244755244755,2012,1992
7,4104,10,100,0.0001,0.01,0.888,0.9868421052631579,2068,2036
7,4204,10,100,0.0001,0.01,0.894,0.9945290199809705,2116,2088
7,4304,10,100,0.0001,0.01,0.898,0.9930297397769516,2172,2132
7,4404,10,100,0.0001,0.01,0.92,0.9968210717529519,2225,2179
7,4504,10,100,0.0001,0.01,0.926,0.9986678507992895,2270,2234
7,4604,10,100,0.0001,0.01,0.914,0.9973935708079931,2320,2284
7,4704,10,100,0.0001,0.01,0.912,0.985969387755102,2373,2331
7,4804,10,100,0.0001,0.01,0.922,0.9931307243963364,2421,2383
7,4904,10,100,0.0001,0.01,0.904,0.9942903752039152,2460,2444
7,5004,10,100,0.0001,0.01,0.912,0.9752198241406874,2511,2493
7,5104,10,100,0.0001,0.01,0.906,0.9800156739811913,2559,2545
7,5204,10,100,0.0001,0.01,0.932,0.9930822444273636,2607,2597
7,5304,10,100,0.0001,0.01,0.938,0.9983031674208145,2651,2653
7,5404,10,100,0.0001,0.01,0.95,0.999259807549963,2708,2696
7,5504,10,100,0.0001,0.01,0.946,0.9996366279069767,2753,2751
7,5604,10,100,0.0001,0.01,0.946,0.9982155603140613,2809,2795
7,5704,10,100,0.0001,0.01,0.952,0.9991234221598878,2849,2855
7,5804,10,100,0.0001,0.01,0.944,0.9989662301860786,2890,2914
7,5904,10,100,0.0001,0.01,0.96,0.9998306233062331,2941,2963
7,6004,10,100,0.0001,0.01,0.956,0.9976682211858761,2996,3008
7,6104,10,100,0.0001,0.01,0.954,0.9955766710353866,3047,3057
7,6204,10,100,0.0001,0.01,0.952,0.9959703417150225,3102,3102
7,6304,10,100,0.0001,0.01,0.94,0.9946065989847716,3149,3155
7,6404,10,100,0.0001,0.01,0.954,0.9964084946908183,3197,3207
7,6504,10,100,0.0001,0.01,0.954,0.997539975399754,3244,3260
7,6604,10,100,0.0001,0.01,0.944,0.9939430648092066,3292,3312
7,6704,10,100,0.0001,0.01,0.95,0.997016706443914,3350,3354
7,6804,10,100,0.0001,0.01,0.93,0.9844209288653734,3402,3402
7,6904,10,100,0.0001,0.01,0.946,0.9927578215527231,3450,3454
7,7004,10,100,0.0001,0.01,0.948,0.9955739577384352,3496,3508
7,7104,10,100,0.0001,0.01,0.952,0.9976069819819819,3555,3549
7,7204,10,100,0.0001,0.01,0.956,0.998611882287618,3602,3602
7,7304,10,100,0.0001,0.01,0.954,0.9983570646221248,3648,3656
7,7404,10,100,0.0001,0.01,0.962,0.9979740680713128,3707,3697
7,7504,10,100,0.0001,0.01,0.964,0.997867803837953,3753,3751
7,7604,10,100,0.0001,0.01,0.968,0.9993424513413993,3803,3801
7,7704,10,100,0.0001,0.01,0.966,0.9997403946002077,3847,3857
7,7804,10,100,0.0001,0.01,0.966,0.9996155817529472,3897,3907
7,7904,10,100,0.0001,0.01,0.964,0.9996204453441295,3945,3959
7,8004,10,100,0.0001,0.01,0.964,0.9968765617191404,3993,4011
7,8104,10,100,0.0001,0.01,0.956,0.995187561697927,4038,4066
7,8204,10,100,0.0001,0.01,0.962,0.9940273037542662,4097,4107
7,8304,10,100,0.0001,0.01,0.958,0.9948217726396917,4155,4149
7,8404,10,100,0.0001,0.01,0.948,0.9917896239885768,4204,4200
7,8504,10,100,0.0001,0.01,0.946,0.9869473189087489,4252,4252
7,8604,10,100,0.0001,0.01,0.954,0.9938400743840075,4303,4301
7,8704,10,100,0.0001,0.01,0.97,0.9978170955882353,4360,4344
7,8804,10,100,0.0001,0.01,0.968,0.9969332121762835,4417,4387
7,8904,10,100,0.0001,0.01,0.966,0.9979784366576819,4464,4440
7,9004,10,100,0.0001,0.01,0.966,0.9961128387383386,4516,4488
7,9104,10,100,0.0001,0.01,0.968,0.9956063268892794,4558,4546
7,9204,10,100,0.0001,0.01,0.974,0.9930465015210778,4612,4592
7,9304,10,100,0.0001,0.01,0.982,0.9984952708512468,4671,4633
7,9404,10,100,0.0001,0.01,0.974,1.0,4720,4684
7,9504,10,100,0.0001,0.01,0.976,0.9997895622895623,4776,4728
7,9604,10,100,0.0001,0.01,0.976,1.0,4824,4780
7,9704,10,100,0.0001,0.01,0.976,0.9998969497114591,4876,4828
7,9804,10,100,0.0001,0.01,0.974,1.0,4919,4885
7,9904,10,100,0.0001,0.01,0.978,1.0,4973,4931
7,10004,10,100,0.0001,0.01,0.974,0.9983006797281088,5018,4986
7,10104,10,100,0.0001,0.01,0.966,0.9859461599366588,5070,5034
7,10204,10,100,0.0001,0.01,0.962,0.9893179145433163,5117,5087
7,10304,10,100,0.0001,0.01,0.976,0.9958268633540373,5165,5139
7,10404,10,100,0.0001,0.01,0.976,0.995674740484429,5211,5193
7,10504,10,100,0.0001,0.01,0.976,0.9971439451637472,5250,5254
7,10604,10,100,0.0001,0.01,0.976,0.999622783855149,5300,5304
7,10704,10,100,0.0001,0.01,0.984,0.9995328849028401,5348,5356
7,10804,10,100,0.0001,0.01,0.976,1.0,5394,5410
7,10904,10,100,0.0001,0.01,0.978,1.0,5446,5458
7,11004,10,100,0.0001,0.01,0.98,0.9997273718647764,5509,5495
7,11104,10,100,0.0001,0.01,0.982,0.9996397694524496,5548,5556
7,11204,10,100,0.0001,0.01,0.984,0.9982149232416994,5587,5617
7,11304,10,100,0.0001,0.01,0.982,0.9953998584571833,5643,5661
7,11404,10,100,0.0001,0.01,0.978,0.9956155734829885,5698,5706
7,11504,10,100,0.0001,0.01,0.976,0.9956536856745479,5741,5763
7,11604,10,100,0.0001,0.01,0.972,0.9956049638055843,5784,5820
7,11704,10,100,0.0001,0.01,0.982,0.9979494190020506,5840,5864
7,11804,10,100,0.0001,0.01,0.98,0.9977973568281938,5888,5916
7,11904,10,100,0.0001,0.01,0.982,0.9959677419354839,5938,5966
7,12004,10,100,0.0001,0.01,0.98,0.9955014995001666,5998,6006
7,12104,10,100,0.0001,0.01,0.974,0.9956212822207535,6054,6050
7,12204,10,100,0.0001,0.01,0.99,0.9977876106194691,6100,6104
7,12304,10,100,0.0001,0.01,0.982,0.9990247074122237,6150,6154
7,12404,10,100,0.0001,0.01,0.982,0.9973395678813286,6207,6197
7,12504,10,100,0.0001,0.01,0.988,0.9997600767754319,6255,6249
7,12604,10,100,0.0001,0.01,0.99,0.9988892415106315,6299,6305
7,12704,10,100,0.0001,0.01,0.988,1.0,6355,6349
7,12804,10,100,0.0001,0.01,0.988,0.9995313964386129,6400,6404
7,12904,10,100,0.0001,0.01,0.984,0.9990700557966522,6458,6446
7,13004,10,100,0.0001,0.01,0.986,0.99792371577976,6504,6500
7,13104,10,100,0.0001,0.01,0.986,0.9957264957264957,6550,6554
7,13204,10,100,0.0001,0.01,0.98,0.9962132687064525,6600,6604
7,13304,10,100,0.0001,0.01,0.982,0.9981208659049909,6643,6661
7,13404,10,100,0.0001,0.01,0.992,0.9981348851089227,6697,6707
7,13504,10,100,0.0001,0.01,0.988,0.9989632701421801,6750,6754
7,13604,10,100,0.0001,0.01,0.988,0.9994854454572185,6800,6804
7,13704,10,100,0.0001,0.01,0.99,0.9999270286047869,6850,6854
7,13804,10,100,0.0001,0.01,0.988,0.9994204578383077,6904,6900
7,13904,10,100,0.0001,0.01,0.986,0.9997842347525892,6949,6955
7,14004,10,100,0.0001,0.01,0.982,0.9999285918309054,7007,6997
7,14104,10,100,0.0001,0.01,0.984,0.9998581962563812,7056,7048
7,14204,10,100,0.0001,0.01,0.994,1.0,7106,7098
7,14304,10,100,0.0001,0.01,0.994,0.9999300894854586,7154,7150
7,14404,10,100,0.0001,0.01,0.998,1.0,7207,7197
7,14504,10,100,0.0001,0.01,0.986,0.9968974076116933,7260,7244
7,14604,10,100,0.0001,0.01,0.972,0.9928101889893179,7313,7291
7,14704,10,100,0.0001,0.01,0.984,0.9906828073993471,7359,7345
7,14804,10,100,0.0001,0.01,0.978,0.9938530126992705,7402,7402
7,14904,10,100,0.0001,0.01,0.986,0.995907139023081,7446,7458
7,15004,10,100,0.0001,0.01,0.992,0.9995334577446015,7502,7502
8,104,10,100,0.0001,0.01,0.498,0.5961538461538461,50,54
8,204,10,100,0.0001,0.01,0.512,0.6372549019607843,94,110
8,304,10,100,0.0001,0.01,0.524,0.6578947368421053,153,151
8,404,10,100,0.0001,0.01,0.478,0.6658415841584159,204,200
8,504,10,100,0.0001,0.01,0.498,0.6547619047619048,254,250
8,604,10,100,0.0001,0.01,0.502,0.652317880794702,309,295
8,704,10,100,0.0001,0.01,0.502,0.6448863636363636,353,351
8,804,10,100,0.0001,0.01,0.528,0.6467661691542289,398,406
8,904,10,100,0.0001,0.01,0.486,0.6559734513274337,444,460
8,1004,10,100,0.0001,0.01,0.524,0.6872509960159362,497,507
8,1104,10,100,0.0001,0.01,0.516,0.6784420289855072,550,554
8,1204,10,100,0.0001,0.01,0.52,0.7068106312292359,598,606
8,1304,10,100,0.0001,0.01,0.534,0.7101226993865031,648,656
8,1404,10,100,0.0001,0.01,0.522,0.7172364672364673,700,704
8,1504,10,100,0.0001,0.01,0.526,0.714095744680851,749,755
8,1604,10,100,0.0001,0.01,0.514,0.7400249376558603,791,813
8,1704,10,100,0.0001,0.01,0.518,0.7376760563380281,837,867
8,1804,10,100,0.0001,0.01,0.536,0.7239467849223947,890,914
8,1904,10,100,0.0001,0.01,0.552,0.7484243697478992,946,958
8,2004,10,100,0.0001,0.01,0.584,0.7629740518962076,992,1012
8,2104,10,100,0.0001,0.01,0.624,0.7604562737642585,1040,1064
8,2204,10,100,0.0001,0.01,0.636,0.8148820326678766,1085,1119
8,2304,10,100,0.0001,0.01,0.662,0.8324652777777778,1133,1171
8,2404,10,100,0.0001,0.01,0.69,0.8452579034941764,1184,1220
8,2504,10,100,0.0001,0.01,0.726,0.8678115015974441,1231,1273
8,2604,10,100,0.0001,0.01,0.754,0.8613671274961597,1280,1324
8,2704,10,100,0.0001,0.01,0.786,0.9164201183431953,1327,1377
8,2804,10,100,0.0001,0.01,0.778,0.912981455064194,1372,1432
8,2904,10,100,0.0001,0.01,0.778,0.9201101928374655,1425,1479
8,3004,10,100,0.0001,0.01,0.788,0.9024633821571239,1479,1525
8,3104,10,100,0.0001,0.01,0.81,0.9049613402061856,1535,1569
8,3204,10,100,0.0001,0.01,0.842,0.9341448189762797,1579,1625
8,3304,10,100,0.0001,0.01,0.874,0.9325060532687651,1633,1671
8,3404,10,100,0.0001,0.01,0.858,0.9482961222091657,1682,1722
8,3504,10,100,0.0001,0.01,0.862,0.946917808219178,1737,1767
8,3604,10,100,0.0001,0.01,0.906,0.9683684794672586,1786,1818
8,3704,10,100,0.0001,0.01,0.91,0.9816414686825053,1841,1863
8,3804,10,100,0.0001,0.01,0.916,0.9847528916929548,1890,1914
8,3904,10,100,0.0001,0.01,0.92,0.9900102459016393,1940,1964
8,4004,10,100,0.0001,0.01,0.922,0.9927572427572428,1994,2010
8,4104,10,100,0.0001,0.01,0.938,0.9922027290448343,2044,2060
8,4204,10,100,0.0001,0.01,0.928,0.9814462416745956,2097,2107
8,4304,10,100,0.0001,0.01,0.93,0.9881505576208178,2150,2154
8,4404,10,100,0.0001,0.01,0.932,0.9920526793823796,2197,2207
8,4504,10,100,0.0001,0.01,0.936,0.9940053285968028,2244,2260
8,4604,10,100,0.0001,0.01,0.944,0.9889226759339704,2296,2308
8,4704,10,100,0.0001,0.01,0.944,0.9925595238095238,2351,2353
8,4804,10,100,0.0001,0.01,0.936,0.9939633638634471,2406,2398
8,4904,10,100,0.0001,0.01,0.96,0.9942903752039152,2455,2449
8,5004,10,100,0.0001,0.01,0.95,0.9932054356514788,2505,2499
8,5104,10,100,0.0001,0.01,0.954,0.9900078369905956,2554,2550
8,5204,10,100,0.0001,0.01,0.912,0.97847809377402,2604,2600
8,5304,10,100,0.0001,0.01,0.92,0.9764328808446455,2666,2638
8,5404,10,100,0.0001,0.01,0.948,0.9872316802368616,2712,2692
8,5504,10,100,0.0001,0.01,0.962,0.9863735465116279,2759,2745
8,5604,10,100,0.0001,0.01,0.958,0.9973233404710921,2807,2797
8,5704,10,100,0.0001,0.01,0.958,0.9963183730715287,2856,2848
8,5804,10,100,0.0001,0.01,0.968,0.9951757408683667,2896,2908
8,5904,10,100,0.0001,0.01,0.96,0.9986449864498645,2944,2960
8,6004,10,100,0.0001,0.01,0.97,0.9990006662225184,2995,3009
8,6104,10,100,0.0001,0.01,0.966,0.9990170380078637,3049,3055
8,6204,10,100,0.0001,0.01,0.962,0.9979045776918117,3100,3104
8,6304,10,100,0.0001,0.01,0.958,0.9931789340101523,3156,3148
8,6404,10,100,0.0001,0.01,0.958,0.9890693316677077,3203,3201
8,6504,10,100,0.0001,0.01,0.962,0.9935424354243543,3252,3252
8,6604,10,100,0.0001,0.01,0.964,0.9830405814657783,3300,3304
8,6704,10,100,0.0001,0.01,0.968,0.9958233890214797,3345,3359
8,6804,10,100,0.0001,0.01,0.95,0.986331569664903,3402,3402
8,6904,10,100,0.0001,0.01,0.966,0.9960892236384704,3460,3444
8,7004,10,100,0.0001,0.01,0.976,0.9985722444317533,3514,3490
8,7104,10,100,0.0001,0.01,0.968,0.9978885135135135,3569,3535
8,7204,10,100,0.0001,0.01,0.974,0.9997223764575236,3623,3581
8,7304,10,100,0.0001,0.01,0.972,0.9994523548740416,3665,3639
8,7404,10,100,0.0001,0.01,0.972,0.9997298757428417,3722,3682
8,7504,10,100,0.0001,0.01,0.98,0.9992004264392325,3776,3728
8,7604,10,100,0.0001,0.01,0.982,1.0,3828,3776
8,7704,10,100,0.0001,0.01,0.978,0.9997403946002077,3875,3829
8,7804,10,100,0.0001,0.01,0.98,0.998077908764736,3922,3882
8,7904,10,100,0.0001,0.01,0.982,0.9987348178137652,3970,3934
8,8004,10,100,0.0001,0.01,0.984,0.9997501249375312,4019,3985
8,8104,10,100,0.0001,0.01,0.984,0.998395853899309,4068,4036
8,8204,10,100,0.0001,0.01,0.954,0.9804973183812774,4117,4087
8,8304,10,100,0.0001,0.01,0.964,0.9814547206165704,4172,4132
8,8404,10,100,0.0001,0.01,0.954,0.9737029985721085,4219,4185
8,8504,10,100,0.0001,0.01,0.97,0.9816556914393226,4274,4230
8,8604,10,100,0.0001,0.01,0.97,0.9861692236169224,4324,4280
8,8704,10,100,0.0001,0.01,0.982,0.9975873161764706,4369,4335
8,8804,10,100,0.0001,0.01,0.992,0.9989777373920945,4428,4376
8,8904,10,100,0.0001,0.01,0.984,0.9986522911051213,4478,4426
8,9004,10,100,0.0001,0.01,0.988,0.9998889382496668,4531,4473
8,9104,10,100,0.0001,0.01,0.988,1.0,4579,4525
8,9204,10,100,0.0001,0.01,0.99,0.9998913515862669,4626,4578
8,9304,10,100,0.0001,0.01,0.99,1.0,4681,4623
8,9404,10,100,0.0001,0.01,0.99,0.9998936622713739,4730,4674
8,9504,10,100,0.0001,0.01,0.986,0.998526936026936,4785,4719
8,9604,10,100,0.0001,0.01,0.978,0.9950020824656394,4834,4770
8,9704,10,100,0.0001,0.01,0.984,0.9949505358615004,4881,4823
8,9804,10,100,0.0001,0.01,0.992,0.9991840065279478,4939,4865
8,9904,10,100,0.0001,0.01,0.99,0.9992932148626817,4985,4919
8,10004,10,100,0.0001,0.01,0.992,0.9993002798880448,5034,4970
8,10104,10,100,0.0001,0.01,0.988,0.9969319081551861,5073,5031
8,10204,10,100,0.0001,0.01,0.994,0.9991179929439435,5115,5089
8,10304,10,100,0.0001,0.01,0.992,0.999902950310559,5178,5126
8,10404,10,100,0.0001,0.01,0.99,0.9978854286812764,5225,5179
8,10504,10,100,0.0001,0.01,0.992,0.9996191926884996,5268,5236
8,10604,10,100,0.0001,0.01,0.992,0.9990569596378726,5316,5288
8,10704,10,100,0.0001,0.01,0.986,0.9999065769805681,5367,5337
8,10804,10,100,0.0001,0.01,0.986,0.998333950388745,5407,5397
8,10904,10,100,0.0001,0.01,0.992,0.9996331621423331,5454,5450
8,11004,10,100,0.0001,0.01,0.988,0.9993638676844784,5498,5506
8,11104,10,100,0.0001,0.01,0.984,0.99585734870317,5550,5554
8,11204,10,100,0.0001,0.01,0.966,0.9809889325240986,5595,5609
8,11304,10,100,0.0001,0.01,0.982,0.9875265392781316,5660,5644
8,11404,10,100,0.0001,0.01,0.988,0.9907050157839354,5711,5693
8,11504,10,100,0.0001,0.01,0.982,0.9940890125173852,5760,5744
8,11604,10,100,0.0001,0.01,0.996,0.9975870389520854,5797,5807
8,11704,10,100,0.0001,0.01,0.99,0.9988892686261107,5845,5859
8,11804,10,100,0.0001,0.01,0.988,0.9994916977295832,5889,5915
8,11904,10,100,0.0001,0.01,0.99,0.9998319892473119,5939,5965
8,12004,10,100,0.0001,0.01,0.99,1.0,5990,6014
8,12104,10,100,0.0001,0.01,0.992,1.0,6041,6063
8,12204,10,100,0.0001,0.01,0.992,1.0,6093,6111
8,12304,10,100,0.0001,0.01,0.986,0.9998374512353706,6144,6160
8,12404,10,100,0.0001,0.01,0.992,1.0,6189,6215
8,12504,10,100,0.0001,0.01,0.992,1.0,6243,6261
8,12604,10,100,0.0001,0.01,0.992,1.0,6289,6315
8,12704,10,100,0.0001,0.01,0.992,1.0,6342,6362
8,12804,10,100,0.0001,0.01,0.992,0.9997656982193065,6391,6413
8,12904,10,100,0.0001,0.01,0.99,0.9993800371977681,6446,6458
8,13004,10,100,0.0001,0.01,0.988,0.999461704091049,6494,6510
8,13104,10,100,0.0001,0.01,0.994,0.9981684981684982,6547,6557
8,13204,10,100,0.0001,0.01,0.982,0.9887155407452287,6596,6608
8,13304,10,100,0.0001,0.01,0.978,0.9916566446181599,6637,6667
8,13404,10,100,0.0001,0.01,0.992,0.9976872575350642,6685,6719
8,13504,10,100,0.0001,0.01,0.986,0.9953347156398105,6741,6763
8,13604,10,100,0.0001,0.01,0.986,0.9992649220817407,6793,6811
8,13704,10,100,0.0001,0.01,0.99,0.9994162288382954,6836,6868
8,13804,10,100,0.0001,0.01,0.992,0.9992031295276731,6885,6919
8,13904,10,100,0.0001,0.01,0.992,0.9984896432681243,6937,6967
8,14004,10,100,0.0001,0.01,0.992,0.9995715509854327,6981,7023
8,14104,10,100,0.0001,0.01,0.996,1.0,7036,7068
8,14204,10,100,0.0001,0.01,0.992,0.9983103351168685,7092,7112
8,14304,10,100,0.0001,0.01,0.99,0.9995805369127517,7143,7161
8,14404,10,100,0.0001,0.01,0.992,0.9999305748403221,7191,7213
8,14504,10,100,0.0001,0.01,0.992,0.9998621070049641,7239,7265
8,14604,10,100,0.0001,0.01,0.992,0.9997945768282662,7293,7311
8,14704,10,100,0.0001,0.01,0.984,0.9938112078346029,7355,7349
8,14804,10,100,0.0001,0.01,0.992,0.9943934071872467,7401,7403
8,14904,10,100,0.0001,0.01,0.99,0.9956387546967257,7447,7457
8,15004,10,100,0.0001,0.01,0.994,0.9990669154892029,7495,7509
9,104,10,100,0.0001,0.01,0.492,0.5576923076923077,46,58
9,204,10,100,0.0001,0.01,0.502,0.6078431372549019,105,99
9,304,10,100,0.0001,0.01,0.504,0.5526315789473685,153,151
9,404,10,100,0.0001,0.01,0.53,0.5965346534653465,201,203
9,504,10,100,0.0001,0.01,0.512,0.5753968253968254,248,256
9,604,10,100,0.0001,0.01,0.51,0.597682119205298,291,313
9,704,10,100,0.0001,0.01,0.53,0.5980113636363636,346,358
9,804,10,100,0.0001,0.01,0.54,0.6082089552238806,392,412
9,904,10,100,0.0001,0.01,0.53,0.6404867256637168,446,458
9,1004,10,100,0.0001,0.01,0.552,0.6613545816733067,494,510
9,1104,10,100,0.0001,0.01,0.538,0.6721014492753623,539,565
9,1204,10,100,0.0001,0.01,0.51,0.6951827242524917,590,614
9,1304,10,100,0.0001,0.01,0.53,0.7055214723926381,638,666
9,1404,10,100,0.0001,0.01,0.53,0.7314814814814815,691,713
9,1504,10,100,0.0001,0.01,0.548,0.7220744680851063,736,768
9,1604,10,100,0.0001,0.01,0.552,0.692643391521197,790,814
9,1704,10,100,0.0001,0.01,0.532,0.7488262910798122,835,869
9,1804,10,100,0.0001,0.01,0.574,0.7932372505543237,880,924
9,1904,10,100,0.0001,0.01,0.562,0.7331932773109243,931,973
9,2004,10,100,0.0001,0.01,0.582,0.7984031936127745,979,1025
9,2104,10,100,0.0001,0.01,0.6,0.7846958174904943,1034,1070
9,2204,10,100,0.0001,0.01,0.61,0.8262250453720508,1082,1122
9,2304,10,100,0.0001,0.01,0.666,0.8572048611111112,1126,1178
9,2404,10,100,0.0001,0.01,0.688,0.9022462562396006,1180,1224
9,2504,10,100,0.0001,0.01,0.674,0.8917731629392971,1229,1275
9,2604,10,100,0.0001,0.01,0.696,0.9224270353302612,1276,1328
9,2704,10,100,0.0001,0.01,0.73,0.9049556213017751,1323,1381
9,2804,10,100,0.0001,0.01,0.728,0.9340228245363766,1363,1441
9,2904,10,100,0.0001,0.01,0.796,0.9555785123966942,1410,1494
9,3004,10,100,0.0001,0.01,0.806,0.9680426098535286,1459,1545
9,3104,10,100,0.0001,0.01,0.816,0.9677835051546392,1505,1599
9,3204,10,100,0.0001,0.01,0.824,0.9185393258426966,1551,1653
9,3304,10,100,0.0001,0.01,0.77,0.8931598062953995,1597,1707
9,3404,10,100,0.0001,0.01,0.844,0.9565217391304348,1656,1748
9,3504,10,100,0.0001,0.01,0.866,0.9723173515981736,1706,1798
9,3604,10,100,0.0001,0.01,0.868,0.9808546059933407,1761,1843
9,3704,10,100,0.0001,0.01,0.84,0.9676025917926566,1809,1895
9,3804,10,100,0.0001,0.01,0.868,0.9802839116719243,1862,1942
9,3904,10,100,0.0001,0.01,0.886,0.9912909836065574,1919,1985
9,4004,10,100,0.0001,0.01,0.906,0.9882617382617382,1973,2031
9,4104,10,100,0.0001,0.01,0.902,0.99317738791423,2033,2071
9,4204,10,100,0.0001,0.01,0.916,0.9907231208372979,2086,2118
9,4304,10,100,0.0001,0.01,0.902,0.9825743494423792,2134,2170
9,4404,10,100,0.0001,0.01,0.92,0.9931880108991825,2184,2220
9,4504,10,100,0.0001,0.01,0.908,0.9869005328596803,2232,2272
9,4604,10,100,0.0001,0.01,0.876,0.9498262380538662,2280,2324
9,4704,10,100,0.0001,0.01,0.844,0.9309098639455783,2335,2369
9,4804,10,100,0.0001,0.01,0.882,0.9644046627810158,2375,2429
9,4904,10,100,0.0001,0.01,0.914,0.982463295269168,2430,2474
9,5004,10,100,0.0001,0.01,0.894,0.9708233413269385,2495,2509
9,5104,10,100,0.0001,0.01,0.896,0.977076802507837,2535,2569
9,5204,10,100,0.0001,0.01,0.932,0.9884704073789393,2590,2614
9,5304,10,100,0.0001,0.01,0.934,0.9922699849170438,2640,2664
9,5404,10,100,0.0001,0.01,0.936,0.9940784603997039,2695,2709
9,5504,10,100,0.0001,0.01,0.954,0.998546511627907,2746,2758
9,5604,10,100,0.0001,0.01,0.944,0.9983940042826552,2795,2809
9,5704,10,100,0.0001,0.01,0.944,0.9978962131837307,2842,2862
9,5804,10,100,0.0001,0.01,0.956,0.9993108201240524,2893,2911
9,5904,10,100,0.0001,0.01,0.96,0.9988143631436315,2937,2967
9,6004,10,100,0.0001,0.01,0.958,0.9993337774816788,2980,3024
9,6104,10,100,0.0001,0.01,0.95,0.9993446920052425,3022,3082
9,6204,10,100,0.0001,0.01,0.954,0.999838813668601,3074,3130
9,6304,10,100,0.0001,0.01,0.956,0.9992068527918782,3127,3177
9,6404,10,100,0.0001,0.01,0.956,0.9981261711430356,3180,3224
9,6504,10,100,0.0001,0.01,0.948,0.996309963099631,3231,3273
9,6604,10,100,0.0001,0.01,0.95,0.9954572986069049,3276,3328
9,6704,10,100,0.0001,0.01,0.94,0.9886634844868735,3323,3381
9,6804,10,100,0.0001,0.01,0.944,0.9897119341563786,3372,3432
9,6904,10,100,0.0001,0.01,0.938,0.9853707995365005,3425,3479
9,7004,10,100,0.0001,0.01,0.948,0.9902912621359223,3479,3525
9,7104,10,100,0.0001,0.01,0.944,0.9954954954954955,3522,3582
9,7204,10,100,0.0001,0.01,0.954,0.9952803997779012,3574,3630
9,7304,10,100,0.0001,0.01,0.968,0.9967141292442497,3619,3685
9,7404,10,100,0.0001,0.01,0.968,0.9975688816855753,3669,3735
9,7504,10,100,0.0001,0.01,0.966,0.9965351812366737,3716,3788
9,7604,10,100,0.0001,0.01,0.972,0.9953971593897949,3762,3842
9,7704,10,100,0.0001,0.01,0.97,0.9967549325025961,3812,3892
9,7804,10,100,0.0001,0.01,0.97,0.9979497693490518,3857,3947
9,7904,10,100,0.0001,0.01,0.978,0.9989878542510121,3911,3993
9,8004,10,100,0.0001,0.01,0.968,0.9930034982508745,3962,4042
9,8104,10,100,0.0001,0.01,0.97,0.9901283316880553,4010,4094
9,8204,10,100,0.0001,0.01,0.964,0.9902486591906388,4056,4148
9,8304,10,100,0.0001,0.01,0.976,0.992533718689788,4109,4195
9,8404,10,100,0.0001,0.01,0.966,0.9945264159923846,4156,4248
9,8504,10,100,0.0001,0.01,0.976,0.9940028222013171,4206,4298
9,8604,10,100,0.0001,0.01,0.968,0.9938400743840075,4253,4351
9,8704,10,100,0.0001,0.01,0.958,0.9793198529411765,4307,4397
9,8804,10,100,0.0001,0.01,0.954,0.9929577464788732,4358,4446
9,8904,10,100,0.0001,0.01,0.976,0.9977538185085355,4404,4500
9,9004,10,100,0.0001,0.01,0.98,0.9992225677476677,4448,4556
9,9104,10,100,0.0001,0.01,0.98,0.999670474516696,4498,4606
9,9204,10,100,0.0001,0.01,0.988,0.9990221642764016,4546,4658
9,9304,10,100,0.0001,0.01,0.986,0.9996775580395528,4586,4718
9,9404,10,100,0.0001,0.01,0.984,1.0,4642,4762
9,9504,10,100,0.0001,0.01,0.982,0.9990530303030303,4697,4807
9,9604,10,100,0.0001,0.01,0.972,0.9940649729279467,4757,4847
9,9704,10,100,0.0001,0.01,0.99,0.9990725474031328,4810,4894
9,9804,10,100,0.0001,0.01,0.988,0.9997960016319869,4862,4942
9,9904,10,100,0.0001,0.01,0.99,0.9998990306946688,4914,4990
9,10004,10,100,0.0001,0.01,0.988,0.9996001599360256,4963,5041
9,10104,10,100,0.0001,0.01,0.99,0.9991092636579573,5015,5089
9,10204,10,100,0.0001,0.01,0.99,1.0,5071,5133
9,10304,10,100,0.0001,0.01,0.992,0.9988354037267081,5130,5174
9,10404,10,100,0.0001,0.01,0.984,0.9944252210688197,5183,5221
9,10504,10,100,0.0001,0.01,0.988,0.9942878903274943,5226,5278
9,10604,10,100,0.0001,0.01,0.99,0.9966993587325538,5272,5332
9,10704,10,100,0.0001,0.01,0.988,0.9978512705530643,5326,5378
9,10804,10,100,0.0001,0.01,0.992,0.9975934838948538,5376,5428
9,10904,10,100,0.0001,0.01,0.998,0.9998165810711666,5426,5478
9,11004,10,100,0.0001,0.01,0.996,0.9996364958197019,5472,5532
9,11104,10,100,0.0001,0.01,0.992,0.9965778097982709,5519,5585
9,11204,10,100,0.0001,0.01,0.984,0.9870581935023206,5574,5630
9,11304,10,100,0.0001,0.01,0.988,0.997965322009908,5623,5681
9,11404,10,100,0.0001,0.01,0.992,0.9960540161346896,5672,5732
9,11504,10,100,0.0001,0.01,0.99,0.9953929068150209,5720,5784
9,11604,10,100,0.0001,0.01,0.992,0.9990520510168908,5768,5836
9,11704,10,100,0.0001,0.01,0.988,0.9984620642515379,5827,5877
9,11804,10,100,0.0001,0.01,0.994,0.9989833954591664,5879,5925
9,11904,10,100,0.0001,0.01,0.994,0.9997479838709677,5928,5976
9,12004,10,100,0.0001,0.01,0.994,0.9999166944351883,5976,6028
9,12104,10,100,0.0001,0.01,0.996,0.9995042961004627,6026,6078
9,12204,10,100,0.0001,0.01,0.994,0.9990167158308751,6076,6128
9,12304,10,100,0.0001,0.01,0.994,0.9996749024707412,6129,6175
9,12404,10,100,0.0001,0.01,0.992,0.9929055143502096,6173,6231
9,12504,10,100,0.0001,0.01,0.99,0.9956813819577736,6225,6279
9,12604,10,100,0.0001,0.01,0.988,0.9957156458267217,6280,6324
9,12704,10,100,0.0001,0.01,0.986,0.9950409319899244,6330,6374
9,12804,10,100,0.0001,0.01,0.984,0.9965635738831615,6387,6417
9,12904,10,100,0.0001,0.01,0.994,0.9980626162430254,6436,6468
9,13004,10,100,0.0001,0.01,0.994,0.9981544140264534,6484,6520
9,13104,10,100,0.0001,0.01,0.996,0.9993131868131868,6544,6560
9,13204,10,100,0.0001,0.01,0.998,0.9986367767343229,6591,6613
9,13304,10,100,0.0001,0.01,0.992,0.9990980156343957,6645,6659
9,13404,10,100,0.0001,0.01,0.996,0.9982840943002089,6692,6712
9,13504,10,100,0.0001,0.01,0.996,0.9997778436018957,6749,6755
9,13604,10,100,0.0001,0.01,0.998,0.9998529844163482,6801,6803
9,13704,10,100,0.0001,0.01,1.0,1.0,6850,6854
9,13804,10,100,0.0001,0.01,0.996,0.9997826716893654,6903,6901
9,13904,10,100,0.0001,0.01,0.996,1.0,6950,6954
9,14004,10,100,0.0001,0.01,0.998,0.9997143673236218,7001,7003
9,14104,10,100,0.0001,0.01,0.998,0.9995745887691435,7047,7057
9,14204,10,100,0.0001,0.01,0.984,0.992466910729372,7101,7103
9,14304,10,100,0.0001,0.01,0.994,0.9957354586129754,7158,7146
9,14404,10,100,0.0001,0.01,0.994,0.9955567897806165,7213,7191
9,14504,10,100,0.0001,0.01,1.0,0.9995863210148924,7262,7242
9,14604,10,100,0.0001,0.01,0.998,0.9984935634072857,7304,7300
9,14704,10,100,0.0001,0.01,0.996,0.9995919477693145,7352,7352
9,14804,10,100,0.0001,0.01,0.998,0.9987165630910565,7404,7400
9,14904,10,100,0.0001,0.01,1.0,0.9993961352657005,7450,7454
9,15004,10,100,0.0001,0.01,1.0,0.9989336177019461,7498,7506
10,104,10,100,0.0001,0.01,0.492,0.7692307692307693,55,49
10,204,10,100,0.0001,0.01,0.518,0.7156862745098039,103,101
10,304,10,100,0.0001,0.01,0.498,0.6447368421052632,154,150
10,404,10,100,0.0001,0.01,0.49,0.6707920792079208,204,200
10,504,10,100,0.0001,0.01,0.488,0.6448412698412699,256,248
10,604,10,100,0.0001,0.01,0.492,0.6605960264900662,304,300
10,704,10,100,0.0001,0.01,0.522,0.625,356,348
10,804,10,100,0.0001,0.01,0.472,0.5932835820895522,398,406
10,904,10,100,0.0001,0.01,0.51,0.6493362831858407,447,457
10,1004,10,100,0.0001,0.01,0.502,0.6713147410358565,501,503
10,1104,10,100,0.0001,0.01,0.478,0.6639492753623188,554,550
10,1204,10,100,0.0001,0.01,0.518,0.6669435215946844,602,602
10,1304,10,100,0.0001,0.01,0.52,0.6924846625766872,645,659
10,1404,10,100,0.0001,0.01,0.54,0.7136752136752137,693,711
10,1504,10,100,0.0001,0.01,0.518,0.6835106382978723,738,766
10,1604,10,100,0.0001,0.01,0.518,0.7175810473815462,784,820
10,1704,10,100,0.0001,0.01,0.526,0.7323943661971831,836,868
10,1804,10,100,0.0001,0.01,0.54,0.746119733924612,879,925
10,1904,10,100,0.0001,0.01,0.56,0.7678571428571429,931,973
10,2004,10,100,0.0001,0.01,0.568,0.7594810379241517,987,1017
10,2104,10,100,0.0001,0.01,0.59,0.7728136882129277,1034,1070
10,2204,10,100,0.0001,0.01,0.62,0.8103448275862069,1084,1120
10,2304,10,100,0.0001,0.01,0.648,0.859375,1137,1167
10,2404,10,100,0.0001,0.01,0.652,0.8373544093178037,1172,1232
10,2504,10,100,0.0001,0.01,0.666,0.860223642172524,1224,1280
10,2604,10,100,0.0001,0.01,0.688,0.8725038402457758,1265,1339
10,2704,10,100,0.0001,0.01,0.72,0.9034763313609467,1320,1384
10,2804,10,100,0.0001,0.01,0.722,0.9012125534950072,1374,1430
10,2904,10,100,0.0001,0.01,0.732,0.9004820936639119,1430,1474
10,3004,10,100,0.0001,0.01,0.804,0.9207723035952063,1473,1531
10,3104,10,100,0.0001,0.01,0.818,0.9474871134020618,1527,1577
10,3204,10,100,0.0001,0.01,0.816,0.9528714107365793,1584,1620
10,3304,10,100,0.0001,0.01,0.828,0.9539951573849879,1633,1671
10,3404,10,100,0.0001,0.01,0.838,0.9553466509988249,1678,1726
10,3504,10,100,0.0001,0.01,0.842,0.97574200913242,1729,1775
10,3604,10,100,0.0001,0.01,0.848,0.9736403995560489,1773,1831
10,3704,10,100,0.0001,0.01,0.842,0.9465442764578834,1824,1880
10,3804,10,100,0.0001,0.01,0.866,0.9676656151419558,1878,1926
10,3904,10,100,0.0001,0.01,0.87,0.9802766393442623,1926,1978
10,4004,10,100,0.0001,0.01,0.888,0.9715284715284715,1975,2029
10,4104,10,100,0.0001,0.01,0.88,0.9646686159844055,2022,2082
10,4204,10,100,0.0001,0.01,0.884,0.9828734538534729,2077,2127
10,4304,10,100,0.0001,0.01,0.902,0.9900092936802974,2129,2175
10,4404,10,100,0.0001,0.01,0.916,0.9915985467756585,2178,2226
10,4504,10,100,0.0001,0.01,0.906,0.9944493783303731,2222,2282
10,4604,10,100,0.0001,0.01,0.922,0.9958731537793223,2278,2326
10,4704,10,100,0.0001,0.01,0.926,0.9974489795918368,2331,2373
10,4804,10,100,0.0001,0.01,0.908,0.996044962531224,2380,2424
10,4904,10,100,0.0001,0.01,0.924,0.9967373572593801,2430,2474
10,5004,10,100,0.0001,0.01,0.932,0.9960031974420464,2476,2528
10,5104,10,100,0.0001,0.01,0.93,0.9958855799373041,2528,2576
10,5204,10,100,0.0001,0.01,0.94,0.9976940814757879,2590,2614
10,5304,10,100,0.0001,0.01,0.926,0.9926470588235294,2641,2663
10,5404,10,100,0.0001,0.01,0.936,0.9959289415247965,2690,2714
10,5504,10,100,0.0001,0.01,0.93,0.9934593023255814,2737,2767
10,5604,10,100,0.0001,0.01,0.936,0.992326909350464,2789,2815
10,5704,10,100,0.0001,0.01,0.944,0.9982468443197756,2839,2865
10,5804,10,100,0.0001,0.01,0.94,0.9977601654031703,2891,2913
10,5904,10,100,0.0001,0.01,0.942,0.9922086720867209,2939,2965
10,6004,10,100,0.0001,0.01,0.954,0.9955029980013325,2989,3015
10,6104,10,100,0.0001,0.01,0.952,0.9972149410222805,3041,3063
10,6204,10,100,0.0001,0.01,0.956,0.9980657640232108,3089,3115
10,6304,10,100,0.0001,0.01,0.962,0.9998413705583756,3136,3168
10,6404,10,100,0.0001,0.01,0.956,0.9992192379762649,3187,3217
10,6504,10,100,0.0001,0.01,0.964,0.9995387453874539,3233,3271
10,6604,10,100,0.0001,0.01,0.964,1.0,3282,3322
10,6704,10,100,0.0001,0.01,0.958,0.9956742243436754,3328,3376
10,6804,10,100,0.0001,0.01,0.882,0.9412110523221634,3377,3427
10,6904,10,100,0.0001,0.01,0.932,0.9584298957126304,3420,3484
10,7004,10,100,0.0001,0.01,0.972,0.9890062821245003,3466,3538
10,7104,10,100,0.0001,0.01,0.966,0.9936655405405406,3518,3586
10,7204,10,100,0.0001,0.01,0.972,0.9969461410327596,3565,3639
10,7304,10,100,0.0001,0.01,0.964,0.989184008762322,3616,3688
10,7404,10,100,0.0001,0.01,0.972,0.9956780118854673,3667,3737
10,7504,10,100,0.0001,0.01,0.984,0.9994669509594882,3721,3783
10,7604,10,100,0.0001,0.01,0.98,0.9996054708048395,3782,3822
10,7704,10,100,0.0001,0.01,0.978,0.9996105919003115,3839,3865
10,7804,10,100,0.0001,0.01,0.98,0.9996155817529472,3890,3914
10,7904,10,100,0.0001,0.01,0.984,0.9994939271255061,3944,3960
10,8004,10,100,0.0001,0.01,0.984,0.9998750624687656,3994,4010
10,8104,10,100,0.0001,0.01,0.98,0.9990128331688055,4051,4053
10,8204,10,100,0.0001,0.01,0.98,0.9980497318381277,4105,4099
10,8304,10,100,0.0001,0.01,0.976,0.9978323699421965,4157,4147
10,8404,10,100,0.0001,0.01,0.984,0.9994050452165636,4208,4196
10,8504,10,100,0.0001,0.01,0.984,0.9995296331138288,4268,4236
10,8604,10,100,0.0001,0.01,0.982,0.996048349604835,4320,4284
10,8704,10,100,0.0001,0.01,0.978,0.9965533088235294,4373,4331
10,8804,10,100,0.0001,0.01,0.982,0.9934120854157201,4418,4386
10,8904,10,100,0.0001,0.01,0.978,0.996967654986523,4467,4437
10,9004,10,100,0.0001,0.01,0.982,0.9962239004886717,4509,4495
10,9104,10,100,0.0001,0.01,0.978,0.9971441124780316,4570,4534
10,9204,10,100,0.0001,0.01,0.972,0.9938070404172099,4632,4572
10,9304,10,100,0.0001,0.01,0.986,0.9973129836629406,4691,4613
10,9404,10,100,0.0001,0.01,0.98,0.9991492981709911,4747,4657
10,9504,10,100,0.0001,0.01,0.988,1.0,4798,4706
10,9604,10,100,0.0001,0.01,0.988,0.999271137026239,4852,4752
10,9704,10,100,0.0001,0.01,0.984,0.9976298433635614,4901,4803
10,9804,10,100,0.0001,0.01,0.986,0.9986740106079152,4956,4848
10,9904,10,100,0.0001,0.01,0.984,0.9965670436187399,4997,4907
10,10004,10,100,0.0001,0.01,0.98,0.9911035585765694,5045,4959
10,10104,10,100,0.0001,0.01,0.98,0.9962391132224862,5095,5009
10,10204,10,100,0.0001,0.01,0.98,0.993531948255586,5149,5055
10,10304,10,100,0.0001,0.01,0.976,0.9949534161490683,5198,5106
10,10404,10,100,0.0001,0.01,0.99,0.9996155324875048,5257,5147
10,10504,10,100,0.0001,0.01,0.988,0.9986671744097486,5306,5198
10,10604,10,100,0.0001,0.01,0.988,0.9971708789136176,5354,5250
10,10704,10,100,0.0001,0.01,0.98,0.9988789237668162,5416,5288
10,10804,10,100,0.0001,0.01,0.988,0.9994446501295816,5465,5339
10,10904,10,100,0.0001,0.01,0.984,0.9994497432134997,5505,5399
10,11004,10,100,0.0001,0.01,0.984,0.9991821155943293,5559,5445
10,11104,10,100,0.0001,0.01,0.988,0.9981087896253602,5600,5504
10,11204,10,100,0.0001,0.01,0.984,0.9946447697250982,5651,5553
10,11304,10,100,0.0001,0.01,0.972,0.994692144373673,5699,5605
10,11404,10,100,0.0001,0.01,0.99,0.998860049105577,5752,5652
10,11504,10,100,0.0001,0.01,0.99,0.997826842837274,5804,5700
10,11604,10,100,0.0001,0.01,0.988,0.9974146845915202,5852,5752
10,11704,10,100,0.0001,0.01,0.988,0.995557074504443,5901,5803
10,11804,10,100,0.0001,0.01,0.98,0.9903422568620807,5941,5863
10,11904,10,100,0.0001,0.01,0.99,0.9984038978494624,5995,5909
10,12004,10,100,0.0001,0.01,0.992,0.9980006664445185,6042,5962
10,12104,10,100,0.0001,0.01,0.986,0.9984302709847984,6092,6012
10,12204,10,100,0.0001,0.01,0.996,0.9987708947885939,6139,6065
10,12304,10,100,0.0001,0.01,0.994,0.9984557867360208,6188,6116
10,12404,10,100,0.0001,0.01,0.986,0.9975008061915511,6234,6170
10,12504,10,100,0.0001,0.01,0.992,0.9984804862444018,6276,6228
10,12604,10,100,0.0001,0.01,0.994,0.9988892415106315,6326,6278
10,12704,10,100,0.0001,0.01,0.988,0.9984256926952141,6368,6336
10,12804,10,100,0.0001,0.01,0.996,0.9982036863480163,6419,6385
10,12904,10,100,0.0001,0.01,0.99,0.9994575325480471,6469,6435
10,13004,10,100,0.0001,0.01,0.99,0.9991541064287911,6515,6489
10,13104,10,100,0.0001,0.01,0.986,0.9953449328449329,6555,6549
10,13204,10,100,0.0001,0.01,0.994,0.9975764919721296,6606,6598
10,13304,10,100,0.0001,0.01,0.996,0.9993986770895971,6651,6653
10,13404,10,100,0.0001,0.01,0.994,0.9996269770217845,6704,6700
10,13504,10,100,0.0001,0.01,0.99,0.9999259478672986,6752,6752
10,13604,10,100,0.0001,0.01,0.99,0.9993384298735666,6800,6804
10,13704,10,100,0.0001,0.01,0.992,0.9999270286047869,6844,6860
10,13804,10,100,0.0001,0.01,0.992,0.9994929006085193,6892,6912
10,13904,10,100,0.0001,0.01,0.992,0.9998561565017261,6944,6960
10,14004,10,100,0.0001,0.01,0.996,0.9998571836618109,6994,7010
10,14104,10,100,0.0001,0.01,0.994,0.9999290981281905,7047,7057
10,14204,10,100,0.0001,0.01,0.994,1.0,7100,7104
10,14304,10,100,0.0001,0.01,0.994,1.0,7152,7152
10,14404,10,100,0.0001,0.01,0.988,0.9961816162177173,7208,7196
10,14504,10,100,0.0001,0.01,0.964,0.9688361831218975,7264,7240
10,14604,10,100,0.0001,0.01,0.996,0.9943166255820323,7315,7289
10,14704,10,100,0.0001,0.01,0.996,0.9986398258977149,7362,7342
10,14804,10,100,0.0001,0.01,0.996,0.9996622534450149,7412,7392
10,14904,10,100,0.0001,0.01,0.998,0.9997987117552335,7463,7441
10,15004,10,100,0.0001,0.01,0.996,0.9999333511063716,7509,7495
11,104,10,100,0.0001,0.01,0.478,0.5961538461538461,53,51
11,204,10,100,0.0001,0.01,0.522,0.5343137254901961,106,98
11,304,10,100,0.0001,0.01,0.472,0.6513157894736842,153,151
11,404,10,100,0.0001,0.01,0.482,0.5915841584158416,208,196
11,504,10,100,0.0001,0.01,0.502,0.6091269841269841,251,253
11,604,10,100,0.0001,0.01,0.476,0.6291390728476821,309,295
11,704,10,100,0.0001,0.01,0.492,0.5994318181818182,358,346
11,804,10,100,0.0001,0.01,0.468,0.5883084577114428,408,396
11,904,10,100,0.0001,0.01,0.494,0.5984513274336283,456,448
11,1004,10,100,0.0001,0.01,0.48,0.6284860557768924,508,496
11,1104,10,100,0.0001,0.01,0.52,0.6684782608695652,550,554
11,1204,10,100,0.0001,0.01,0.526,0.670265780730897,598,606
11,1304,10,100,0.0001,0.01,0.536,0.6717791411042945,647,657
11,1404,10,100,0.0001,0.01,0.546,0.6766381766381766,693,711
11,1504,10,100,0.0001,0.01,0.512,0.699468085106383,752,752
11,1604,10,100,0.0001,0.01,0.53,0.7275561097256857,802,802
11,1704,10,100,0.0001,0.01,0.558,0.7306338028169014,847,857
11,1804,10,100,0.0001,0.01,0.534,0.7777161862527716,901,903
11,1904,10,100,0.0001,0.01,0.55,0.7557773109243697,949,955
11,2004,10,100,0.0001,0.01,0.586,0.8078842315369261,995,1009
11,2104,10,100,0.0001,0.01,0.632,0.8141634980988594,1048,1056
11,2204,10,100,0.0001,0.01,0.618,0.8239564428312159,1096,1108
11,2304,10,100,0.0001,0.01,0.612,0.8181423611111112,1144,1160
11,2404,10,100,0.0001,0.01,0.654,0.8481697171381032,1200,1204
11,2504,10,100,0.0001,0.01,0.638,0.8302715654952076,1246,1258
11,2604,10,100,0.0001,0.01,0.702,0.8905529953917051,1299,1305
11,2704,10,100,0.0001,0.01,0.716,0.8912721893491125,1350,1354
11,2804,10,100,0.0001,0.01,0.742,0.9158345221112696,1400,1404
11,2904,10,100,0.0001,0.01,0.7,0.8918732782369146,1456,1448
11,3004,10,100,0.0001,0.01,0.794,0.9380825565912118,1499,1505
11,3104,10,100,0.0001,0.01,0.786,0.939110824742268,1543,1561
11,3204,10,100,0.0001,0.01,0.832,0.9603620474406991,1589,1615
11,3304,10,100,0.0001,0.01,0.852,0.9555084745762712,1647,1657
11,3404,10,100,0.0001,0.01,0.864,0.9703290246768508,1699,1705
11,3504,10,100,0.0001,0.01,0.85,0.9740296803652968,1748,1756
11,3604,10,100,0.0001,0.01,0.862,0.9819644839067703,1792,1812
11,3704,10,100,0.0001,0.01,0.882,0.9935205183585313,1840,1864
11,3804,10,100,0.0001,0.01,0.882,0.9629337539432177,1883,1921
11,3904,10,100,0.0001,0.01,0.892,0.9554303278688525,1934,1970
11,4004,10,100,0.0001,0.01,0.876,0.9592907092907093,1990,2014
11,4104,10,100,0.0001,0.01,0.866,0.952729044834308,2041,2063
11,4204,10,100,0.0001,0.01,0.886,0.9783539486203615,2095,2109
11,4304,10,100,0.0001,0.01,0.91,0.9723513011152416,2148,2156
11,4404,10,100,0.0001,0.01,0.916,0.9915985467756585,2198,2206
11,4504,10,100,0.0001,0.01,0.928,0.9935612788632326,2254,2250
11,4604,10,100,0.0001,0.01,0.93,0.9826238053866203,2304,2300
11,4704,10,100,0.0001,0.01,0.904,0.9642857142857143,2346,2358
11,4804,10,100,0.0001,0.01,0.918,0.9883430474604497,2404,2400
11,4904,10,100,0.0001,0.01,0.93,0.9967373572593801,2455,2449
11,5004,10,100,0.0001,0.01,0.948,0.9990007993605116,2514,2490
11,5104,10,100,0.0001,0.01,0.952,0.9988244514106583,2562,2542
11,5204,10,100,0.0001,0.01,0.952,0.9998078401229823,2617,2587
11,5304,10,100,0.0001,0.01,0.958,0.9996229260935143,2662,2642
11,5404,10,100,0.0001,0.01,0.952,0.9996299037749815,2712,2692
11,5504,10,100,0.0001,0.01,0.952,0.9976380813953488,2758,2746
11,5604,10,100,0.0001,0.01,0.966,0.9987508922198429,2803,2801
11,5704,10,100,0.0001,0.01,0.972,0.9991234221598878,2858,2846
11,5804,10,100,0.0001,0.01,0.952,0.9982770503101309,2903,2901
11,5904,10,100,0.0001,0.01,0.968,0.9988143631436315,2947,2957
11,6004,10,100,0.0001,0.01,0.968,0.9998334443704198,3007,2997
11,6104,10,100,0.0001,0.01,0.974,0.9998361730013107,3058,3046
11,6204,10,100,0.0001,0.01,0.972,0.9991940683430045,3101,3103
11,6304,10,100,0.0001,0.01,0.972,0.9998413705583756,3156,3148
11,6404,10,100,0.0001,0.01,0.976,0.999843847595253,3201,3203
11,6504,10,100,0.0001,0.01,0.972,0.9996924969249692,3244,3260
11,6604,10,100,0.0001,0.01,0.96,0.9978800726832223,3294,3310
11,6704,10,100,0.0001,0.01,0.968,0.994928400954654,3346,3358
11,6804,10,100,0.0001,0.01,0.978,0.9954438565549677,3403,3401
11,6904,10,100,0.0001,0.01,0.974,0.9950753186558516,3456,3448
11,7004,10,100,0.0001,0.01,0.982,0.9981439177612793,3515,3489
11,7104,10,100,0.0001,0.01,0.97,0.9969031531531531,3567,3537
11,7204,10,100,0.0001,0.01,0.972,0.994447529150472,3618,3586
11,7304,10,100,0.0001,0.01,0.974,0.9978094194961665,3674,3630
11,7404,10,100,0.0001,0.01,0.984,0.9995948136142626,3721,3683
11,7504,10,100,0.0001,0.01,0.984,0.9984008528784648,3768,3736
11,7604,10,100,0.0001,0.01,0.988,0.9988164124145187,3816,3788
11,7704,10,100,0.0001,0.01,0.988,0.9994807892004154,3866,3838
11,7804,10,100,0.0001,0.01,0.978,0.9966683751922091,3916,3888
11,7904,10,100,0.0001,0.01,0.984,0.9992408906882592,3961,3943
11,8004,10,100,0.0001,0.01,0.986,0.9965017491254373,4013,3991
11,8104,10,100,0.0001,0.01,0.974,0.9943237907206318,4059,4045
11,8204,10,100,0.0001,0.01,0.942,0.9673330082886397,4111,4093
11,8304,10,100,0.0001,0.01,0.952,0.9827793834296724,4155,4149
11,8404,10,100,0.0001,0.01,0.98,0.9972632079961923,4206,4198
11,8504,10,100,0.0001,0.01,0.984,0.9981185324553151,4255,4249
11,8604,10,100,0.0001,0.01,0.98,0.99860529986053,4309,4295
11,8704,10,100,0.0001,0.01,0.986,1.0,4363,4341
11,8804,10,100,0.0001,0.01,0.986,0.9996592457973649,4407,4397
11,8904,10,100,0.0001,0.01,0.988,0.9997753818508536,4444,4460
11,9004,10,100,0.0001,0.01,0.988,1.0,4495,4509
11,9104,10,100,0.0001,0.01,0.988,1.0,4537,4567
11,9204,10,100,0.0001,0.01,0.988,1.0,4586,4618
11,9304,10,100,0.0001,0.01,0.988,1.0,4633,4671
11,9404,10,100,0.0001,0.01,0.988,1.0,4679,4725
11,9504,10,100,0.0001,0.01,0.988,1.0,4728,4776
11,9604,10,100,0.0001,0.01,0.988,0.9985422740524781,4780,4824
11,9704,10,100,0.0001,0.01,0.982,0.9991755976916735,4829,4875
11,9804,10,100,0.0001,0.01,0.984,0.9988780089759282,4872,4932
11,9904,10,100,0.0001,0.01,0.982,0.9918214862681745,4925,4979
11,10004,10,100,0.0001,0.01,0.982,0.9910035985605757,4978,5026
11,10104,10,100,0.0001,0.01,0.976,0.993368962787015,5018,5086
11,10204,10,100,0.0001,0.01,0.98,0.9957859662877303,5061,5143
11,10304,10,100,0.0001,0.01,0.978,0.9923330745341615,5116,5188
11,10404,10,100,0.0001,0.01,0.976,0.9960592079969243,5174,5230
11,10504,10,100,0.0001,0.01,0.974,0.9966679360243716,5226,5278
11,10604,10,100,0.0001,0.01,0.986,0.9985854394568088,5277,5327
11,10704,10,100,0.0001,0.01,0.99,0.9993460388639761,5331,5373
11,10804,10,100,0.0001,0.01,0.99,0.9998148833765272,5384,5420
11,10904,10,100,0.0001,0.01,0.992,1.0,5430,5474
11,11004,10,100,0.0001,0.01,0.996,1.0,5468,5536
11,11104,10,100,0.0001,0.01,0.998,1.0,5526,5578
11,11204,10,100,0.0001,0.01,0.998,1.0,5578,5626
11,11304,10,100,0.0001,0.01,0.992,0.9972576079263977,5630,5674
11,11404,10,100,0.0001,0.01,0.986,0.998509294984216,5669,5735
11,11504,10,100,0.0001,0.01,0.98,0.9922635605006954,5718,5786
11,11604,10,100,0.0001,0.01,0.994,0.9980179248534988,5761,5843
11,11704,10,100,0.0001,0.01,0.992,0.9988892686261107,5812,5892
11,11804,10,100,0.0001,0.01,0.98,0.9924601829888173,5866,5938
11,11904,10,100,0.0001,0.01,0.992,0.9967237903225806,5917,5987
11,12004,10,100,0.0001,0.01,0.998,0.9988337220926358,5965,6039
11,12104,10,100,0.0001,0.01,0.994,0.9998347653668209,6022,6082
11,12204,10,100,0.0001,0.01,0.998,0.9958210422812193,6071,6133
11,12304,10,100,0.0001,0.01,0.992,0.9983745123537061,6131,6173
11,12404,10,100,0.0001,0.01,0.998,0.9993550467591099,6180,6224
11,12504,10,100,0.0001,0.01,0.984,0.9926423544465771,6229,6275
11,12604,10,100,0.0001,0.01,0.988,0.997778483021263,6283,6321
11,12704,10,100,0.0001,0.01,0.994,0.9989767002518891,6335,6369
11,12804,10,100,0.0001,0.01,0.994,0.9955482661668229,6387,6417
11,12904,10,100,0.0001,0.01,0.998,0.9964352138871667,6444,6460
11,13004,10,100,0.0001,0.01,0.994,0.9991541064287911,6492,6512
11,13104,10,100,0.0001,0.01,0.998,0.9997710622710623,6538,6566
11,13204,10,100,0.0001,0.01,0.998,0.999924265374129,6590,6614
11,13304,10,100,0.0001,0.01,0.998,1.0,6645,6659
11,13404,10,100,0.0001,0.01,0.998,0.9999253954043569,6701,6703
11,13504,10,100,0.0001,0.01,0.994,0.9986670616113744,6744,6760
11,13604,10,100,0.0001,0.01,0.996,0.9972802117024404,6804,6800
11,13704,10,100,0.0001,0.01,0.98,0.9926298890834793,6859,6845
11,13804,10,100,0.0001,0.01,0.99,0.9965227470298464,6913,6891
11,13904,10,100,0.0001,0.01,0.994,0.997626582278481,6960,6944
11,14004,10,100,0.0001,0.01,0.996,0.9952156526706655,7012,6992
11,14104,10,100,0.0001,0.01,1.0,0.9989364719228587,7055,7049
11,14204,10,100,0.0001,0.01,0.99,0.997395099971839,7100,7104
11,14304,10,100,0.0001,0.01,0.994,0.999650447427293,7148,7156
11,14404,10,100,0.0001,0.01,0.996,0.9990974729241877,7195,7209
11,14504,10,100,0.0001,0.01,0.996,0.9999310535024821,7244,7260
11,14604,10,100,0.0001,0.01,0.996,1.0,7299,7305
11,14704,10,100,0.0001,0.01,0.996,1.0,7350,7354
11,14804,10,100,0.0001,0.01,0.998,0.9980410699810862,7401,7403
11,14904,10,100,0.0001,0.01,0.99,0.9949677938808373,7453,7451
11,15004,10,100,0.0001,0.01,0.996,0.9977339376166355,7513,7491
12,104,10,100,0.0001,0.01,0.446,0.5961538461538461,47,57
12,204,10,100,0.0001,0.01,0.54,0.6715686274509803,96,108
12,304,10,100,0.0001,0.01,0.512,0.631578947368421,140,164
12,404,10,100,0.0001,0.01,0.526,0.6336633663366337,188,216
12,504,10,100,0.0001,0.01,0.506,0.6607142857142857,236,268
12,604,10,100,0.0001,0.01,0.514,0.6539735099337748,286,318
12,704,10,100,0.0001,0.01,0.52,0.65625,331,373
12,804,10,100,0.0001,0.01,0.512,0.6890547263681592,377,427
12,904,10,100,0.0001,0.01,0.504,0.6570796460176991,428,476
12,1004,10,100,0.0001,0.01,0.514,0.7101593625498008,484,520
12,1104,10,100,0.0001,0.01,0.512,0.6875,541,563
12,1204,10,100,0.0001,0.01,0.492,0.6985049833887044,595,609
12,1304,10,100,0.0001,0.01,0.532,0.6871165644171779,648,656
12,1404,10,100,0.0001,0.01,0.512,0.7051282051282052,697,707
12,1504,10,100,0.0001,0.01,0.5,0.6675531914893617,725,779
12,1604,10,100,0.0001,0.01,0.542,0.7250623441396509,775,829
12,1704,10,100,0.0001,0.01,0.558,0.7429577464788732,820,884
12,1804,10,100,0.0001,0.01,0.628,0.7921286031042128,868,936
12,1904,10,100,0.0001,0.01,0.576,0.779936974789916,922,982
12,2004,10,100,0.0001,0.01,0.576,0.7914171656686627,971,1033
12,2104,10,100,0.0001,0.01,0.598,0.7818441064638784,1023,1081
12,2204,10,100,0.0001,0.01,0.628,0.7944646098003629,1078,1126
12,2304,10,100,0.0001,0.01,0.668,0.8658854166666666,1119,1185
12,2404,10,100,0.0001,0.01,0.668,0.8689683860232945,1168,1236
12,2504,10,100,0.0001,0.01,0.614,0.7847444089456869,1231,1273
12,2604,10,100,0.0001,0.01,0.678,0.8728878648233487,1283,1321
12,2704,10,100,0.0001,0.01,0.736,0.8849852071005917,1331,1373
12,2804,10,100,0.0001,0.01,0.714,0.8776747503566333,1380,1424
12,2904,10,100,0.0001,0.01,0.694,0.8980716253443526,1438,1466
12,3004,10,100,0.0001,0.01,0.736,0.8874833555259654,1487,1517
12,3104,10,100,0.0001,0.01,0.76,0.9278350515463918,1536,1568
12,3204,10,100,0.0001,0.01,0.806,0.9550561797752809,1586,1618
12,3304,10,100,0.0001,0.01,0.774,0.9567191283292978,1635,1669
12,3404,10,100,0.0001,0.01,0.8,0.9459459459459459,1681,1723
12,3504,10,100,0.0001,0.01,0.778,0.9209474885844748,1722,1782
12,3604,10,100,0.0001,0.01,0.78,0.9159267480577137,1780,1824
12,3704,10,100,0.0001,0.01,0.848,0.9697624190064795,1840,1864
12,3804,10,100,0.0001,0.01,0.834,0.9789695057833859,1894,1910
12,3904,10,100,0.0001,0.01,0.84,0.985655737704918,1949,1955
12,4004,10,100,0.0001,0.01,0.862,0.9842657342657343,2000,2004
12,4104,10,100,0.0001,0.01,0.9,0.9865984405458089,2050,2054
12,4204,10,100,0.0001,0.01,0.874,0.9885823025689819,2103,2101
12,4304,10,100,0.0001,0.01,0.892,0.9955855018587361,2151,2153
12,4404,10,100,0.0001,0.01,0.896,0.9945504087193461,2202,2202
12,4504,10,100,0.0001,0.01,0.92,0.9980017761989343,2254,2250
12,4604,10,100,0.0001,0.01,0.92,0.9932667245873154,2306,2298
12,4704,10,100,0.0001,0.01,0.912,0.9885204081632653,2357,2347
12,4804,10,100,0.0001,0.01,0.92,0.992089925062448,2399,2405
12,4904,10,100,0.0001,0.01,0.918,0.9975530179445351,2444,2460
12,5004,10,100,0.0001,0.01,0.93,0.9986011191047163,2494,2510
12,5104,10,100,0.0001,0.01,0.914,0.9903996865203761,2557,2547
12,5204,10,100,0.0001,0.01,0.916,0.995772482705611,2607,2597
12,5304,10,100,0.0001,0.01,0.94,0.9935897435897436,2660,2644
12,5404,10,100,0.0001,0.01,0.956,0.9972242783123613,2705,2699
12,5504,10,100,0.0001,0.01,0.956,0.995094476744186,2760,2744
12,5604,10,100,0.0001,0.01,0.956,0.9987508922198429,2803,2801
12,5704,10,100,0.0001,0.01,0.966,0.9973702664796634,2862,2842
12,5804,10,100,0.0001,0.01,0.958,0.9975878704341833,2913,2891
12,5904,10,100,0.0001,0.01,0.952,0.9950880758807588,2967,2937
12,6004,10,100,0.0001,0.01,0.962,0.9966688874083944,3017,2987
12,6104,10,100,0.0001,0.01,0.964,0.9960681520314548,3062,3042
12,6204,10,100,0.0001,0.01,0.954,0.9882333978078659,3114,3090
12,6304,10,100,0.0001,0.01,0.95,0.9907994923857868,3160,3144
12,6404,10,100,0.0001,0.01,0.964,0.990318550905684,3214,3190
12,6504,10,100,0.0001,0.01,0.972,0.9973862238622386,3261,3243
12,6604,10,100,0.0001,0.01,0.964,0.9937916414294367,3313,3291
12,6704,10,100,0.0001,0.01,0.976,0.9998508353221957,3358,3346
12,6804,10,100,0.0001,0.01,0.972,0.9991181657848325,3402,3402
12,6904,10,100,0.0001,0.01,0.972,0.9994206257242179,3451,3453
12,7004,10,100,0.0001,0.01,0.978,0.9994288977727013,3501,3503
12,7104,10,100,0.0001,0.01,0.974,0.9997184684684685,3551,3553
12,7204,10,100,0.0001,0.01,0.974,0.9997223764575236,3605,3599
12,7304,10,100,0.0001,0.01,0.986,0.9987677984665937,3652,3652
12,7404,10,100,0.0001,0.01,0.982,0.9982441923284711,3695,3709
12,7504,10,100,0.0001,0.01,0.97,0.9956023454157783,3741,3763
12,7604,10,100,0.0001,0.01,0.98,0.9967122567069964,3793,3811
12,7704,10,100,0.0001,0.01,0.972,0.9931204569055037,3841,3863
12,7804,10,100,0.0001,0.01,0.964,0.9868016401845208,3891,3913
12,7904,10,100,0.0001,0.01,0.97,0.986082995951417,3935,3969
12,8004,10,100,0.0001,0.01,0.974,0.9965017491254373,3986,4018
12,8104,10,100,0.0001,0.01,0.98,0.9977788746298124,4037,4067
12,8204,10,100,0.0001,0.01,0.968,0.9946367625548513,4088,4116
12,8304,10,100,0.0001,0.01,0.984,0.9977119460500964,4137,4167
12,8404,10,100,0.0001,0.01,0.97,0.9957163255592575,4188,4216
12,8504,10,100,0.0001,0.01,0.984,0.9989416745061148,4243,4261
12,8604,10,100,0.0001,0.01,0.984,1.0,4292,4312
12,8704,10,100,0.0001,0.01,0.984,0.9994255514705882,4333,4371
12,8804,10,100,0.0001,0.01,0.988,0.9996592457973649,4389,4415
12,8904,10,100,0.0001,0.01,0.982,0.9978661275831087,4446,4458
12,9004,10,100,0.0001,0.01,0.984,0.9964460239893381,4500,4504
12,9104,10,100,0.0001,0.01,0.986,0.9981326889279437,4561,4543
12,9204,10,100,0.0001,0.01,0.986,0.9944589308996089,4612,4592
12,9304,10,100,0.0001,0.01,0.986,0.9978503869303526,4659,4645
12,9404,10,100,0.0001,0.01,0.984,0.9969162058698426,4705,4699
12,9504,10,100,0.0001,0.01,0.99,0.9991582491582491,4757,4747
12,9604,10,100,0.0001,0.01,0.992,0.9969804248229904,4810,4794
12,9704,10,100,0.0001,0.01,0.982,0.9927864798021434,4864,4840
12,9804,10,100,0.0001,0.01,0.986,0.9900040799673603,4912,4892
12,9904,10,100,0.0001,0.01,0.984,0.9930331179321487,4960,4944
12,10004,10,100,0.0001,0.01,0.994,0.9978008796481408,5008,4996
12,10104,10,100,0.0001,0.01,0.992,0.9993072050673001,5060,5044
12,10204,10,100,0.0001,0.01,0.996,0.9997059976479812,5113,5091
12,10304,10,100,0.0001,0.01,0.996,0.999902950310559,5167,5137
12,10404,10,100,0.0001,0.01,0.992,0.998077662437524,5227,5177
12,10504,10,100,0.0001,0.01,0.99,0.996953541507997,5284,5220
12,10604,10,100,0.0001,0.01,0.968,0.9873632591474916,5340,5264
12,10704,10,100,0.0001,0.01,0.99,0.9989723467862481,5388,5316
12,10804,10,100,0.0001,0.01,0.99,0.9999074416882636,5446,5358
12,10904,10,100,0.0001,0.01,0.992,0.9999082905355833,5489,5415
12,11004,10,100,0.0001,0.01,0.996,1.0,5541,5463
12,11104,10,100,0.0001,0.01,0.998,1.0,5595,5509
12,11204,10,100,0.0001,0.01,0.998,1.0,5639,5565
12,11304,10,100,0.0001,0.01,0.998,1.0,5697,5607
12,11404,10,100,0.0001,0.01,0.998,1.0,5749,5655
12,11504,10,100,0.0001,0.01,0.998,1.0,5789,5715
12,11604,10,100,0.0001,0.01,0.992,0.9984488107549121,5840,5764
12,11704,10,100,0.0001,0.01,0.998,0.9997436773752563,5884,5820
12,11804,10,100,0.0001,0.01,0.994,0.9988139613690274,5932,5872
12,11904,10,100,0.0001,0.01,0.992,0.9966397849462365,5990,5914
12,12004,10,100,0.0001,0.01,0.99,0.9880873042319227,6028,5976
12,12104,10,100,0.0001,0.01,0.994,0.9923992068737607,6074,6030
12,12204,10,100,0.0001,0.01,0.984,0.9927892494264176,6128,6076
12,12304,10,100,0.0001,0.01,0.992,0.9986183355006502,6178,6126
12,12404,10,100,0.0001,0.01,0.994,0.9995969042244437,6222,6182
12,12504,10,100,0.0001,0.01,0.992,0.9988003838771593,6269,6235
12,12604,10,100,0.0001,0.01,0.994,0.9997619803237068,6320,6284
12,12704,10,100,0.0001,0.01,0.996,0.9999212846347607,6365,6339
12,12804,10,100,0.0001,0.01,0.994,0.9999218994064355,6414,6390
12,12904,10,100,0.0001,0.01,0.994,0.999845009299442,6469,6435
12,13004,10,100,0.0001,0.01,0.996,0.9999231005844356,6519,6485
12,13104,10,100,0.0001,0.01,0.994,1.0,6574,6530
12,13204,10,100,0.0001,0.01,0.996,0.9996970614965162,6629,6575
12,13304,10,100,0.0001,0.01,0.998,0.9999248346361996,6677,6627
12,13404,10,100,0.0001,0.01,0.996,0.9999253954043569,6723,6681
12,13504,10,100,0.0001,0.01,0.986,0.9969638625592417,6774,6730
12,13604,10,100,0.0001,0.01,0.94,0.9669950014701558,6826,6778
12,13704,10,100,0.0001,0.01,0.988,0.9932136602451839,6876,6828
12,13804,10,100,0.0001,0.01,1.0,0.999855114459577,6927,6877
12,13904,10,100,0.0001,0.01,0.996,0.999928078250863,6980,6924
12,14004,10,100,0.0001,0.01,0.996,0.9999285918309054,7026,6978
12,14104,10,100,0.0001,0.01,0.996,0.9999290981281905,7078,7026
12,14204,10,100,0.0001,0.01,0.998,1.0,7133,7071
12,14304,10,100,0.0001,0.01,1.0,0.9995805369127517,7173,7131
12,14404,10,100,0.0001,0.01,0.996,0.9971535684532075,7220,7184
12,14504,10,100,0.0001,0.01,0.998,0.9995863210148924,7270,7234
12,14604,10,100,0.0001,0.01,0.998,0.9995891536565324,7320,7284
12,14704,10,100,0.0001,0.01,0.998,1.0,7380,7324
12,14804,10,100,0.0001,0.01,0.998,1.0,7429,7375
12,14904,10,100,0.0001,0.01,0.998,1.0,7474,7430
12,15004,10,100,0.0001,0.01,0.998,1.0,7523,7481
13,104,10,100,0.0001,0.01,0.504,0.5576923076923077,58,46
13,204,10,100,0.0001,0.01,0.476,0.5049019607843137,115,89
13,304,10,100,0.0001,0.01,0.492,0.5427631578947368,157,147
13,404,10,100,0.0001,0.01,0.522,0.5891089108910891,210,194
13,504,10,100,0.0001,0.01,0.512,0.5654761904761905,254,250
13,604,10,100,0.0001,0.01,0.548,0.6374172185430463,299,305
13,704,10,100,0.0001,0.01,0.494,0.5838068181818182,352,352
13,804,10,100,0.0001,0.01,0.502,0.6243781094527363,398,406
13,904,10,100,0.0001,0.01,0.516,0.6183628318584071,447,457
13,1004,10,100,0.0001,0.01,0.556,0.6235059760956175,494,510
13,1104,10,100,0.0001,0.01,0.562,0.6512681159420289,537,567
13,1204,10,100,0.0001,0.01,0.552,0.6636212624584718,597,607
13,1304,10,100,0.0001,0.01,0.548,0.6771472392638037,644,660
13,1404,10,100,0.0001,0.01,0.532,0.7094017094017094,689,715
13,1504,10,100,0.0001,0.01,0.53,0.7107712765957447,742,762
13,1604,10,100,0.0001,0.01,0.526,0.7356608478802993,791,813
13,1704,10,100,0.0001,0.01,0.514,0.7065727699530516,843,861
13,1804,10,100,0.0001,0.01,0.522,0.746119733924612,895,909
13,1904,10,100,0.0001,0.01,0.524,0.7836134453781513,946,958
13,2004,10,100,0.0001,0.01,0.536,0.8063872255489022,996,1008
13,2104,10,100,0.0001,0.01,0.552,0.7713878326996197,1053,1051
13,2204,10,100,0.0001,0.01,0.564,0.8062613430127041,1102,1102
13,2304,10,100,0.0001,0.01,0.574,0.7925347222222222,1144,1160
13,2404,10,100,0.0001,0.01,0.588,0.8531613976705491,1196,1208
13,2504,10,100,0.0001,0.01,0.59,0.8554313099041534,1255,1249
13,2604,10,100,0.0001,0.01,0.614,0.8955453149001537,1303,1301
13,2704,10,100,0.0001,0.01,0.622,0.8909023668639053,1354,1350
13,2804,10,100,0.0001,0.01,0.656,0.8922967189728959,1407,1397
13,2904,10,100,0.0001,0.01,0.646,0.8942837465564738,1457,1447
13,3004,10,100,0.0001,0.01,0.704,0.9144474034620506,1500,1504
13,3104,10,100,0.0001,0.01,0.722,0.9239690721649485,1550,1554
13,3204,10,100,0.0001,0.01,0.696,0.9428838951310862,1597,1607
13,3304,10,100,0.0001,0.01,0.746,0.9388619854721549,1642,1662
13,3404,10,100,0.0001,0.01,0.726,0.9412455934195064,1693,1711
13,3504,10,100,0.0001,0.01,0.74,0.9263698630136986,1743,1761
13,3604,10,100,0.0001,0.01,0.762,0.9517203107658158,1795,1809
13,3704,10,100,0.0001,0.01,0.752,0.9322354211663066,1845,1859
13,3804,10,100,0.0001,0.01,0.768,0.9468980021030494,1890,1914
13,3904,10,100,0.0001,0.01,0.806,0.9510758196721312,1937,1967
13,4004,10,100,0.0001,0.01,0.76,0.936063936063936,1992,2012
13,4104,10,100,0.0001,0.01,0.81,0.9707602339181286,2037,2067
13,4204,10,100,0.0001,0.01,0.808,0.9714557564224549,2088,2116
13,4304,10,100,0.0001,0.01,0.816,0.9809479553903345,2136,2168
13,4404,10,100,0.0001,0.01,0.844,0.9859218891916439,2192,2212
13,4504,10,100,0.0001,0.01,0.838,0.9826820603907638,2241,2263
13,4604,10,100,0.0001,0.01,0.844,0.9813205907906168,2289,2315
13,4704,10,100,0.0001,0.01,0.86,0.9938350340136054,2341,2363
13,4804,10,100,0.0001,0.01,0.864,0.9954204829308909,2392,2412
13,4904,10,100,0.0001,0.01,0.86,0.9922512234910277,2450,2454
13,5004,10,100,0.0001,0.01,0.86,0.9902078337330136,2501,2503
13,5104,10,100,0.0001,0.01,0.836,0.9864811912225705,2548,2556
13,5204,10,100,0.0001,0.01,0.84,0.9853958493466565,2594,2610
13,5304,10,100,0.0001,0.01,0.892,0.9858597285067874,2638,2666
13,5404,10,100,0.0001,0.01,0.88,0.9909326424870466,2690,2714
13,5504,10,100,0.0001,0.01,0.898,0.9900072674418605,2740,2764
13,5604,10,100,0.0001,0.01,0.888,0.9925053533190579,2782,2822
13,5704,10,100,0.0001,0.01,0.882,0.9854488078541375,2829,2875
13,5804,10,100,0.0001,0.01,0.886,0.9851826326671261,2875,2929
13,5904,10,100,0.0001,0.01,0.888,0.9706978319783198,2919,2985
13,6004,10,100,0.0001,0.01,0.892,0.9865089940039974,2974,3030
13,6104,10,100,0.0001,0.01,0.896,0.9877129750982963,3012,3092
13,6204,10,100,0.0001,0.01,0.902,0.9909735654416505,3055,3149
13,6304,10,100,0.0001,0.01,0.924,0.9893718274111675,3099,3205
13,6404,10,100,0.0001,0.01,0.926,0.9960961898813242,3150,3254
13,6504,10,100,0.0001,0.01,0.926,0.9887761377613776,3207,3297
13,6604,10,100,0.0001,0.01,0.944,0.9942459115687462,3262,3342
13,6704,10,100,0.0001,0.01,0.946,0.9962708830548926,3311,3393
13,6804,10,100,0.0001,0.01,0.948,0.9975014697236919,3361,3443
13,6904,10,100,0.0001,0.01,0.948,0.9984067207415991,3415,3489
13,7004,10,100,0.0001,0.01,0.952,0.9992861222158766,3469,3535
13,7104,10,100,0.0001,0.01,0.946,0.9995777027027027,3515,3589
13,7204,10,100,0.0001,0.01,0.952,0.9981954469739034,3561,3643
13,7304,10,100,0.0001,0.01,0.956,0.999315443592552,3607,3697
13,7404,10,100,0.0001,0.01,0.948,0.9987844408427877,3651,3753
13,7504,10,100,0.0001,0.01,0.942,0.9958688699360341,3698,3806
13,7604,10,100,0.0001,0.01,0.956,0.9981588637559179,3742,3862
13,7704,10,100,0.0001,0.01,0.958,0.9972741433021807,3792,3912
13,7804,10,100,0.0001,0.01,0.942,0.9902614044079959,3839,3965
13,7904,10,100,0.0001,0.01,0.95,0.986336032388664,3894,4010
13,8004,10,100,0.0001,0.01,0.93,0.9843828085957022,3944,4060
13,8104,10,100,0.0001,0.01,0.958,0.9855626850937809,3997,4107
13,8204,10,100,0.0001,0.01,0.948,0.9884202827888835,4053,4151
13,8304,10,100,0.0001,0.01,0.964,0.996868978805395,4095,4209
13,8404,10,100,0.0001,0.01,0.96,0.9957163255592575,4145,4259
13,8504,10,100,0.0001,0.01,0.966,0.9982361241768579,4202,4302
13,8604,10,100,0.0001,0.01,0.968,0.9967456996745699,4251,4353
13,8704,10,100,0.0001,0.01,0.97,0.9983915441176471,4306,4398
13,8804,10,100,0.0001,0.01,0.968,0.9981826442526125,4351,4453
13,8904,10,100,0.0001,0.01,0.968,0.9984276729559748,4398,4506
13,9004,10,100,0.0001,0.01,0.976,0.9994446912483341,4445,4559
13,9104,10,100,0.0001,0.01,0.968,0.9986818980667839,4492,4612
13,9204,10,100,0.0001,0.01,0.976,0.9988048674489353,4540,4664
13,9304,10,100,0.0001,0.01,0.976,0.9992476354256233,4591,4713
13,9404,10,100,0.0001,0.01,0.976,0.9986176095278605,4636,4768
13,9504,10,100,0.0001,0.01,0.96,0.9849537037037037,4674,4830
13,9604,10,100,0.0001,0.01,0.962,0.9913577675968347,4722,4882
13,9704,10,100,0.0001,0.01,0.974,0.9952596867271228,4762,4942
13,9804,10,100,0.0001,0.01,0.974,0.9972460220318238,4806,4998
13,9904,10,100,0.0001,0.01,0.974,0.997778675282714,4859,5045
13,10004,10,100,0.0001,0.01,0.978,0.9965013994402239,4906,5098
13,10104,10,100,0.0001,0.01,0.974,0.996437054631829,4958,5146
13,10204,10,100,0.0001,0.01,0.962,0.9954919639357115,5002,5202
13,10304,10,100,0.0001,0.01,0.976,0.9979619565217391,5059,5245
13,10404,10,100,0.0001,0.01,0.96,0.9888504421376394,5107,5297
13,10504,10,100,0.0001,0.01,0.968,0.998000761614623,5159,5345
13,10604,10,100,0.0001,0.01,0.974,0.9976423990946812,5212,5392
13,10704,10,100,0.0001,0.01,0.978,0.9983183856502242,5275,5429
13,10804,10,100,0.0001,0.01,0.978,0.9973158089596446,5319,5485
13,10904,10,100,0.0001,0.01,0.968,0.9974321349963317,5374,5530
13,11004,10,100,0.0001,0.01,0.968,0.990003635041803,5431,5573
13,11104,10,100,0.0001,0.01,0.972,0.9907240634005764,5478,5626
13,11204,10,100,0.0001,0.01,0.966,0.9925919314530525,5532,5672
13,11304,10,100,0.0001,0.01,0.98,0.9976999292285916,5584,5720
13,11404,10,100,0.0001,0.01,0.984,0.9995615573482989,5637,5767
13,11504,10,100,0.0001,0.01,0.984,1.0,5694,5810
13,11604,10,100,0.0001,0.01,0.982,0.9977593933126508,5741,5863
13,11704,10,100,0.0001,0.01,0.976,0.9964969241285031,5793,5911
13,11804,10,100,0.0001,0.01,0.966,0.9925449000338868,5838,5966
13,11904,10,100,0.0001,0.01,0.978,0.9976478494623656,5893,6011
13,12004,10,100,0.0001,0.01,0.982,0.9975008330556481,5948,6056
13,12104,10,100,0.0001,0.01,0.982,0.9970257766027759,5999,6105
13,12204,10,100,0.0001,0.01,0.986,0.9984431333988856,6059,6145
13,12304,10,100,0.0001,0.01,0.986,0.9987808842652796,6116,6188
13,12404,10,100,0.0001,0.01,0.97,0.9975008061915511,6174,6230
13,12504,10,100,0.0001,0.01,0.98,0.9979206653870761,6216,6288
13,12604,10,100,0.0001,0.01,0.974,0.9953982862583307,6265,6339
13,12704,10,100,0.0001,0.01,0.976,0.9968513853904282,6318,6386
13,12804,10,100,0.0001,0.01,0.972,0.9939862542955327,6368,6436
13,12904,10,100,0.0001,0.01,0.982,0.9987600743955363,6419,6485
13,13004,10,100,0.0001,0.01,0.99,0.9989234081820978,6467,6537
13,13104,10,100,0.0001,0.01,0.978,0.9967185592185592,6518,6586
13,13204,10,100,0.0001,0.01,0.98,0.9943199030596789,6575,6629
13,13304,10,100,0.0001,0.01,0.984,0.9979705351773902,6620,6684
13,13404,10,100,0.0001,0.01,0.982,0.9965681886004177,6672,6732
13,13504,10,100,0.0001,0.01,0.988,0.9997778436018957,6734,6770
13,13604,10,100,0.0001,0.01,0.988,0.9998529844163482,6777,6827
13,13704,10,100,0.0001,0.01,0.99,0.9996351430239346,6827,6877
13,13804,10,100,0.0001,0.01,0.994,0.9992755722978847,6882,6922
13,13904,10,100,0.0001,0.01,0.988,0.998849252013809,6930,6974
13,14004,10,100,0.0001,0.01,0.988,0.9999285918309054,6986,7018
13,14104,10,100,0.0001,0.01,0.99,1.0,7036,7068
13,14204,10,100,0.0001,0.01,0.99,1.0,7085,7119
13,14304,10,100,0.0001,0.01,0.988,0.9999300894854586,7131,7173
13,14404,10,100,0.0001,0.01,0.988,1.0,7186,7218
13,14504,10,100,0.0001,0.01,0.978,0.9923469387755102,7242,7262
13,14604,10,100,0.0001,0.01,0.974,0.9891810462886881,7290,7314
13,14704,10,100,0.0001,0.01,0.986,0.99680359085963,7344,7360
13,14804,10,100,0.0001,0.01,0.984,0.9984463658470684,7396,7408
13,14904,10,100,0.0001,0.01,0.984,0.998389694041868,7445,7459
13,15004,10,100,0.0001,0.01,0.986,0.9978672354038923,7499,7505
14,104,10,100,0.0001,0.01,0.472,0.5288461538461539,55,49
14,204,10,100,0.0001,0.01,0.518,0.6617647058823529,113,91
14,304,10,100,0.0001,0.01,0.5,0.5888157894736842,154,150
14,404,10,100,0.0001,0.01,0.5,0.6287128712871287,204,200
14,504,10,100,0.0001,0.01,0.464,0.6507936507936508,253,251
14,604,10,100,0.0001,0.01,0.462,0.6307947019867549,296,308
14,704,10,100,0.0001,0.01,0.502,0.6818181818181818,349,355
14,804,10,100,0.0001,0.01,0.528,0.6393034825870647,393,411
14,904,10,100,0.0001,0.01,0.472,0.702433628318584,444,460
14,1004,10,100,0.0001,0.01,0.48,0.7091633466135459,493,511
14,1104,10,100,0.0001,0.01,0.496,0.7038043478260869,542,562
14,1204,10,100,0.0001,0.01,0.516,0.7200996677740864,597,607
14,1304,10,100,0.0001,0.01,0.524,0.7055214723926381,653,651
14,1404,10,100,0.0001,0.01,0.54,0.7663817663817664,698,706
14,1504,10,100,0.0001,0.01,0.516,0.745345744680851,747,757
14,1604,10,100,0.0001,0.01,0.538,0.7562344139650873,802,802
14,1704,10,100,0.0001,0.01,0.52,0.7646713615023474,849,855
14,1804,10,100,0.0001,0.01,0.522,0.7993348115299335,899,905
14,1904,10,100,0.0001,0.01,0.544,0.7830882352941176,947,957
14,2004,10,100,0.0001,0.01,0.558,0.8098802395209581,1002,1002
14,2104,10,100,0.0001,0.01,0.556,0.8122623574144486,1060,1044
14,2204,10,100,0.0001,0.01,0.548,0.8602540834845736,1105,1099
14,2304,10,100,0.0001,0.01,0.586,0.8528645833333334,1150,1154
14,2404,10,100,0.0001,0.01,0.584,0.8589850249584027,1202,1202
14,2504,10,100,0.0001,0.01,0.568,0.8466453674121406,1244,1260
14,2604,10,100,0.0001,0.01,0.596,0.8897849462365591,1290,1314
14,2704,10,100,0.0001,0.01,0.594,0.8923816568047337,1345,1359
14,2804,10,100,0.0001,0.01,0.642,0.9147646219686163,1393,1411
14,2904,10,100,0.0001,0.01,0.622,0.9318181818181818,1442,1462
14,3004,10,100,0.0001,0.01,0.622,0.9131158455392809,1495,1509
14,3104,10,100,0.0001,0.01,0.624,0.9197809278350515,1543,1561
14,3204,10,100,0.0001,0.01,0.64,0.9416354556803995,1591,1613
14,3304,10,100,0.0001,0.01,0.7,0.9434019370460048,1643,1661
14,3404,10,100,0.0001,0.01,0.752,0.9553466509988249,1690,1714
14,3504,10,100,0.0001,0.01,0.694,0.9623287671232876,1739,1765
14,3604,10,100,0.0001,0.01,0.692,0.9167591564927858,1789,1815
14,3704,10,100,0.0001,0.01,0.69,0.9049676025917927,1839,1865
14,3804,10,100,0.0001,0.01,0.76,0.9539957939011566,1896,1908
14,3904,10,100,0.0001,0.01,0.812,0.9628586065573771,1944,1960
14,4004,10,100,0.0001,0.01,0.816,0.9862637362637363,1984,2020
14,4104,10,100,0.0001,0.01,0.846,0.990009746588694,2030,2074
14,4204,10,100,0.0001,0.01,0.838,0.9883444338725024,2078,2126
14,4304,10,100,0.0001,0.01,0.846,0.9923327137546468,2122,2182
14,4404,10,100,0.0001,0.01,0.864,0.990236148955495,2168,2236
14,4504,10,100,0.0001,0.01,0.878,0.9953374777975134,2224,2280
14,4604,10,100,0.0001,0.01,0.876,0.9943527367506516,2277,2327
14,4704,10,100,0.0001,0.01,0.878,0.9944727891156463,2324,2380
14,4804,10,100,0.0001,0.01,0.868,0.9885512073272273,2370,2434
14,4904,10,100,0.0001,0.01,0.892,0.9961256117455138,2428,2476
14,5004,10,100,0.0001,0.01,0.898,0.9946043165467626,2481,2523
14,5104,10,100,0.0001,0.01,0.902,0.9911833855799373,2538,2566
14,5204,10,100,0.0001,0.01,0.902,0.9921214450422752,2599,2605
14,5304,10,100,0.0001,0.01,0.886,0.9877450980392157,2651,2653
14,5404,10,100,0.0001,0.01,0.92,0.9944485566247224,2703,2701
14,5504,10,100,0.0001,0.01,0.914,0.989280523255814,2754,2750
14,5604,10,100,0.0001,0.01,0.908,0.9812633832976445,2801,2803
14,5704,10,100,0.0001,0.01,0.924,0.9865007012622721,2854,2850
14,5804,10,100,0.0001,0.01,0.938,0.9968986905582357,2905,2899
14,5904,10,100,0.0001,0.01,0.942,0.9981368563685636,2962,2942
14,6004,10,100,0.0001,0.01,0.958,0.9980013324450366,3009,2995
14,6104,10,100,0.0001,0.01,0.956,0.9993446920052425,3054,3050
14,6204,10,100,0.0001,0.01,0.95,0.9975822050290135,3106,3098
14,6304,10,100,0.0001,0.01,0.97,1.0,3151,3153
14,6404,10,100,0.0001,0.01,0.948,0.9987507807620237,3208,3196
14,6504,10,100,0.0001,0.01,0.948,0.9929274292742928,3262,3242
14,6604,10,100,0.0001,0.01,0.954,0.9986371895820715,3299,3305
14,6704,10,100,0.0001,0.01,0.954,0.9840393794749404,3354,3350
14,6804,10,100,0.0001,0.01,0.962,0.9961787184009406,3405,3399
14,6904,10,100,0.0001,0.01,0.946,0.9875434530706837,3458,3446
14,7004,10,100,0.0001,0.01,0.944,0.9945745288406624,3518,3486
14,7104,10,100,0.0001,0.01,0.97,0.9987331081081081,3567,3537
14,7204,10,100,0.0001,0.01,0.968,0.998611882287618,3607,3597
14,7304,10,100,0.0001,0.01,0.97,0.9946604600219058,3656,3648
14,7404,10,100,0.0001,0.01,0.972,0.9995948136142626,3704,3700
14,7504,10,100,0.0001,0.01,0.964,0.9997334754797441,3756,3748
14,7604,10,100,0.0001,0.01,0.976,0.9992109416096792,3811,3793
14,7704,10,100,0.0001,0.01,0.972,0.9997403946002077,3868,3836
14,7804,10,100,0.0001,0.01,0.972,0.9982060481804202,3915,3889
14,7904,10,100,0.0001,0.01,0.976,0.9992408906882592,3959,3945
14,8004,10,100,0.0001,0.01,0.972,0.9962518740629686,4013,3991
14,8104,10,100,0.0001,0.01,0.982,0.9995064165844028,4052,4052
14,8204,10,100,0.0001,0.01,0.972,0.9962213554363725,4100,4104
14,8304,10,100,0.0001,0.01,0.966,0.9954238921001927,4153,4151
14,8404,10,100,0.0001,0.01,0.962,0.975963826749167,4206,4198
14,8504,10,100,0.0001,0.01,0.974,0.9883584195672624,4253,4251
14,8604,10,100,0.0001,0.01,0.968,0.9962807996280799,4296,4308
14,8704,10,100,0.0001,0.01,0.972,0.9995404411764706,4345,4359
14,8804,10,100,0.0001,0.01,0.978,0.9968196274420718,4398,4406
14,8904,10,100,0.0001,0.01,0.978,0.9979784366576819,4446,4458
14,9004,10,100,0.0001,0.01,0.974,0.9974455797423367,4489,4515
14,9104,10,100,0.0001,0.01,0.976,0.9986818980667839,4543,4561
14,9204,10,100,0.0001,0.01,0.978,0.9995654063450674,4598,4606
14,9304,10,100,0.0001,0.01,0.982,0.9995700773860705,4643,4661
14,9404,10,100,0.0001,0.01,0.982,0.9995746490854955,4691,4713
14,9504,10,100,0.0001,0.01,0.98,0.9998947811447811,4741,4763
14,9604,10,100,0.0001,0.01,0.968,0.9955226988754685,4782,4822
14,9704,10,100,0.0001,0.01,0.984,0.9989694971145919,4831,4873
14,9804,10,100,0.0001,0.01,0.984,0.9993880048959608,4886,4918
14,9904,10,100,0.0001,0.01,0.98,0.9987883683360258,4935,4969
14,10004,10,100,0.0001,0.01,0.982,0.999000399840064,4980,5024
14,10104,10,100,0.0001,0.01,0.984,0.9993072050673001,5034,5070
14,10204,10,100,0.0001,0.01,0.978,0.9985299882399059,5082,5122
14,10304,10,100,0.0001,0.01,0.976,0.9930124223602484,5136,5168
14,10404,10,100,0.0001,0.01,0.986,0.9979815455594002,5190,5214
14,10504,10,100,0.0001,0.01,0.98,0.9968583396801218,5240,5264
14,10604,10,100,0.0001,0.01,0.986,0.9915126367408525,5283,5321
14,10704,10,100,0.0001,0.01,0.982,0.9977578475336323,5333,5371
14,10804,10,100,0.0001,0.01,0.978,0.9985190670122177,5386,5418
14,10904,10,100,0.0001,0.01,0.98,0.9974321349963317,5440,5464
14,11004,10,100,0.0001,0.01,0.982,0.9970010905125409,5491,5513
14,11104,10,100,0.0001,0.01,0.988,0.9951368876080692,5535,5569
14,11204,10,100,0.0001,0.01,0.978,0.9976794002142092,5590,5614
14,11304,10,100,0.0001,0.01,0.982,0.9992038216560509,5644,5660
14,11404,10,100,0.0001,0.01,0.984,0.9998246229393195,5690,5714
14,11504,10,100,0.0001,0.01,0.984,1.0,5744,5760
14,11604,10,100,0.0001,0.01,0.984,1.0,5790,5814
14,11704,10,100,0.0001,0.01,0.984,1.0,5839,5865
14,11804,10,100,0.0001,0.01,0.986,1.0,5897,5907
14,11904,10,100,0.0001,0.01,0.986,1.0,5947,5957
14,12004,10,100,0.0001,0.01,0.986,0.9999166944351883,6006,5998
14,12104,10,100,0.0001,0.01,0.986,0.9998347653668209,6062,6042
14,12204,10,100,0.0001,0.01,0.98,0.9996722386102918,6120,6084
14,12304,10,100,0.0001,0.01,0.988,0.9995123537061118,6173,6131
14,12404,10,100,0.0001,0.01,0.976,0.9879071267333118,6229,6175
14,12504,10,100,0.0001,0.01,0.984,0.9897632757517595,6285,6219
14,12604,10,100,0.0001,0.01,0.984,0.9982545223738496,6340,6264
14,12704,10,100,0.0001,0.01,0.978,0.9940963476070529,6385,6319
14,12804,10,100,0.0001,0.01,0.986,0.9985160887222743,6432,6372
14,12904,10,100,0.0001,0.01,0.986,0.9979851208927464,6473,6431
14,13004,10,100,0.0001,0.01,0.99,0.9998462011688711,6526,6478
14,13104,10,100,0.0001,0.01,0.984,0.9997710622710623,6584,6520
14,13204,10,100,0.0001,0.01,0.984,0.9998485307482581,6637,6567
14,13304,10,100,0.0001,0.01,0.984,0.9996241731809982,6682,6622
14,13404,10,100,0.0001,0.01,0.99,1.0,6741,6663
14,13504,10,100,0.0001,0.01,0.99,1.0,6794,6710
14,13604,10,100,0.0001,0.01,0.988,0.9999264922081741,6839,6765
14,13704,10,100,0.0001,0.01,0.988,0.9994892002335085,6884,6820
14,13804,10,100,0.0001,0.01,0.984,0.9986235873659809,6932,6872
14,13904,10,100,0.0001,0.01,0.98,0.9968354430379747,6972,6932
14,14004,10,100,0.0001,0.01,0.984,0.9973578977435018,7019,6985
14,14104,10,100,0.0001,0.01,0.982,0.9978020419739081,7057,7047
14,14204,10,100,0.0001,0.01,0.978,0.9945789918332864,7118,7086
14,14304,10,100,0.0001,0.01,0.984,0.9986717002237137,7165,7139
14,14404,10,100,0.0001,0.01,0.986,0.9986114968064427,7218,7186
14,14504,10,100,0.0001,0.01,0.988,0.9996552675124104,7269,7235
14,14604,10,100,0.0001,0.01,0.986,0.9996576280471103,7320,7284
14,14704,10,100,0.0001,0.01,0.988,0.9999319912948857,7370,7334
14,14804,10,100,0.0001,0.01,0.988,0.9999324506890029,7423,7381
14,14904,10,100,0.0001,0.01,0.988,1.0,7468,7436
14,15004,10,100,0.0001,0.01,0.988,1.0,7516,7488
15,104,10,100,0.0001,0.01,0.502,0.5384615384615384,49,55
15,204,10,100,0.0001,0.01,0.492,0.7401960784313726,97,107
15,304,10,100,0.0001,0.01,0.468,0.6644736842105263,153,151
15,404,10,100,0.0001,0.01,0.446,0.6138613861386139,207,197
15,504,10,100,0.0001,0.01,0.47,0.5793650793650794,258,246
15,604,10,100,0.0001,0.01,0.492,0.597682119205298,314,290
15,704,10,100,0.0001,0.01,0.506,0.6051136363636364,370,334
15,804,10,100,0.0001,0.01,0.474,0.6144278606965174,424,380
15,904,10,100,0.0001,0.01,0.508,0.6305309734513275,484,420
15,1004,10,100,0.0001,0.01,0.52,0.6673306772908366,535,469
15,1104,10,100,0.0001,0.01,0.526,0.6594202898550725,580,524
15,1204,10,100,0.0001,0.01,0.51,0.6810631229235881,631,573
15,1304,10,100,0.0001,0.01,0.518,0.6779141104294478,688,616
15,1404,10,100,0.0001,0.01,0.482,0.7286324786324786,743,661
15,1504,10,100,0.0001,0.01,0.512,0.7486702127659575,800,704
15,1604,10,100,0.0001,0.01,0.534,0.7125935162094763,848,756
15,1704,10,100,0.0001,0.01,0.526,0.7541079812206573,907,797
15,1804,10,100,0.0001,0.01,0.534,0.7677383592017738,954,850
15,1904,10,100,0.0001,0.01,0.53,0.7899159663865546,1009,895
15,2004,10,100,0.0001,0.01,0.526,0.7385229540918163,1057,947
15,2104,10,100,0.0001,0.01,0.556,0.7799429657794676,1109,995
15,2204,10,100,0.0001,0.01,0.55,0.8053539019963702,1156,1048
15,2304,10,100,0.0001,0.01,0.564,0.8159722222222222,1197,1107
15,2404,10,100,0.0001,0.01,0.548,0.809900166389351,1250,1154
15,2504,10,100,0.0001,0.01,0.578,0.819888178913738,1298,1206
15,2604,10,100,0.0001,0.01,0.574,0.8548387096774194,1347,1257
15,2704,10,100,0.0001,0.01,0.62,0.8809171597633136,1390,1314
15,2804,10,100,0.0001,0.01,0.614,0.8758915834522111,1444,1360
15,2904,10,100,0.0001,0.01,0.654,0.8991046831955923,1503,1401
15,3004,10,100,0.0001,0.01,0.652,0.8665113182423435,1551,1453
15,3104,10,100,0.0001,0.01,0.626,0.8569587628865979,1597,1507
15,3204,10,100,0.0001,0.01,0.66,0.9094881398252185,1644,1560
15,3304,10,100,0.0001,0.01,0.644,0.9158595641646489,1698,1606
15,3404,10,100,0.0001,0.01,0.688,0.9347826086956522,1750,1654
15,3504,10,100,0.0001,0.01,0.684,0.9386415525114156,1800,1704
15,3604,10,100,0.0001,0.01,0.742,0.9608768035516093,1844,1760
15,3704,10,100,0.0001,0.01,0.728,0.9670626349892009,1901,1803
15,3804,10,100,0.0001,0.01,0.744,0.9784437434279706,1940,1864
15,3904,10,100,0.0001,0.01,0.766,0.9838627049180327,1994,1910
15,4004,10,100,0.0001,0.01,0.76,0.9845154845154845,2040,1964
15,4104,10,100,0.0001,0.01,0.764,0.9590643274853801,2090,2014
15,4204,10,100,0.0001,0.01,0.79,0.9769267364414843,2138,2066
15,4304,10,100,0.0001,0.01,0.798,0.9816449814126395,2190,2114
15,4404,10,100,0.0001,0.01,0.82,0.9766121707538601,2237,2167
15,4504,10,100,0.0001,0.01,0.83,0.9913410301953819,2284,2220
15,4604,10,100,0.0001,0.01,0.828,0.981537793223284,2328,2276
15,4704,10,100,0.0001,0.01,0.844,0.9936224489795918,2379,2325
15,4804,10,100,0.0001,0.01,0.846,0.9895920066611157,2431,2373
15,4904,10,100,0.0001,0.01,0.822,0.9471859706362153,2478,2426
15,5004,10,100,0.0001,0.01,0.852,0.9706235011990407,2523,2481
15,5104,10,100,0.0001,0.01,0.856,0.986873040752351,2569,2535
15,5204,10,100,0.0001,0.01,0.862,0.9919292851652575,2626,2578
15,5304,10,100,0.0001,0.01,0.886,0.996606334841629,2677,2627
15,5404,10,100,0.0001,0.01,0.898,0.9972242783123613,2724,2680
15,5504,10,100,0.0001,0.01,0.892,0.9980014534883721,2772,2732
15,5604,10,100,0.0001,0.01,0.906,0.9962526766595289,2828,2776
15,5704,10,100,0.0001,0.01,0.9,0.998422159887798,2875,2829
15,5804,10,100,0.0001,0.01,0.91,0.9982770503101309,2923,2881
15,5904,10,100,0.0001,0.01,0.91,0.9976287262872628,2979,2925
15,6004,10,100,0.0001,0.01,0.918,0.997001998667555,3019,2985
15,6104,10,100,0.0001,0.01,0.916,0.9981979030144168,3079,3025
15,6204,10,100,0.0001,0.01,0.912,0.9900064474532559,3124,3080
15,6304,10,100,0.0001,0.01,0.918,0.9920685279187818,3170,3134
15,6404,10,100,0.0001,0.01,0.91,0.9915677701436603,3221,3183
15,6504,10,100,0.0001,0.01,0.928,0.9944649446494465,3266,3238
15,6604,10,100,0.0001,0.01,0.924,0.9940944881889764,3317,3287
15,6704,10,100,0.0001,0.01,0.934,0.9980608591885441,3363,3341
15,6804,10,100,0.0001,0.01,0.924,0.9976484420928865,3416,3388
15,6904,10,100,0.0001,0.01,0.936,0.9968134414831982,3454,3450
15,7004,10,100,0.0001,0.01,0.934,0.9951456310679612,3500,3504
15,7104,10,100,0.0001,0.01,0.948,0.9950731981981982,3547,3557
15,7204,10,100,0.0001,0.01,0.942,0.9876457523598001,3587,3617
15,7304,10,100,0.0001,0.01,0.916,0.9711117196056955,3642,3662
15,7404,10,100,0.0001,0.01,0.948,0.9848730415991356,3699,3705
15,7504,10,100,0.0001,0.01,0.95,0.9960021321961621,3750,3754
15,7604,10,100,0.0001,0.01,0.964,0.9969752761704366,3804,3800
15,7704,10,100,0.0001,0.01,0.962,0.9963655244029076,3854,3850
15,7804,10,100,0.0001,0.01,0.964,0.9987186058431573,3901,3903
15,7904,10,100,0.0001,0.01,0.964,0.999746963562753,3953,3951
15,8004,10,100,0.0001,0.01,0.968,0.9997501249375312,4003,4001
15,8104,10,100,0.0001,0.01,0.97,0.9998766041461007,4055,4049
15,8204,10,100,0.0001,0.01,0.974,0.999512432959532,4102,4102
15,8304,10,100,0.0001,0.01,0.968,0.9998795761078998,4149,4155
15,8404,10,100,0.0001,0.01,0.976,1.0,4198,4206
15,8504,10,100,0.0001,0.01,0.974,1.0,4246,4258
15,8604,10,100,0.0001,0.01,0.976,0.99953509995351,4294,4310
15,8704,10,100,0.0001,0.01,0.978,0.9997702205882353,4344,4360
15,8804,10,100,0.0001,0.01,0.968,1.0,4395,4409
15,8904,10,100,0.0001,0.01,0.97,0.9995507637017071,4440,4464
15,9004,10,100,0.0001,0.01,0.972,0.9998889382496668,4481,4523
15,9104,10,100,0.0001,0.01,0.974,1.0,4518,4586
15,9204,10,100,0.0001,0.01,0.976,0.9978270317253368,4573,4631
15,9304,10,100,0.0001,0.01,0.958,0.9973129836629406,4623,4681
15,9404,10,100,0.0001,0.01,0.95,0.9776690769885156,4670,4734
15,9504,10,100,0.0001,0.01,0.96,0.9897937710437711,4719,4785
15,9604,10,100,0.0001,0.01,0.946,0.9714702207413578,4767,4837
15,9704,10,100,0.0001,0.01,0.982,0.9961871393239901,4822,4882
15,9804,10,100,0.0001,0.01,0.972,0.9906160750713995,4874,4930
15,9904,10,100,0.0001,0.01,0.974,0.997172859450727,4929,4975
15,10004,10,100,0.0001,0.01,0.98,0.9993002798880448,4973,5031
15,10104,10,100,0.0001,0.01,0.98,0.9993072050673001,5020,5084
15,10204,10,100,0.0001,0.01,0.986,0.9997059976479812,5072,5132
15,10304,10,100,0.0001,0.01,0.984,0.999805900621118,5113,5191
15,10404,10,100,0.0001,0.01,0.982,1.0,5174,5230
15,10504,10,100,0.0001,0.01,0.986,0.9998095963442498,5220,5284
15,10604,10,100,0.0001,0.01,0.984,1.0,5266,5338
15,10704,10,100,0.0001,0.01,0.98,0.9999065769805681,5327,5377
15,10804,10,100,0.0001,0.01,0.988,1.0,5367,5437
15,10904,10,100,0.0001,0.01,0.986,1.0,5416,5488
15,11004,10,100,0.0001,0.01,0.986,0.9999091239549255,5468,5536
15,11104,10,100,0.0001,0.01,0.984,0.9993695965417867,5519,5585
15,11204,10,100,0.0001,0.01,0.978,0.9985719385933595,5563,5641
15,11304,10,100,0.0001,0.01,0.972,0.9962845010615711,5615,5689
15,11404,10,100,0.0001,0.01,0.976,0.9846545071904594,5663,5741
15,11504,10,100,0.0001,0.01,0.98,0.991307371349096,5716,5788
15,11604,10,100,0.0001,0.01,0.986,0.9968114443295415,5773,5831
15,11704,10,100,0.0001,0.01,0.984,0.9996582365003418,5825,5879
15,11804,10,100,0.0001,0.01,0.986,0.9998305659098611,5863,5941
15,11904,10,100,0.0001,0.01,0.986,1.0,5920,5984
15,12004,10,100,0.0001,0.01,0.988,1.0,5965,6039
15,12104,10,100,0.0001,0.01,0.988,0.9999173826834105,6023,6081
15,12204,10,100,0.0001,0.01,0.988,0.9995083579154376,6081,6123
15,12304,10,100,0.0001,0.01,0.986,0.9986996098829649,6128,6176
15,12404,10,100,0.0001,0.01,0.986,0.9998387616897775,6171,6233
15,12504,10,100,0.0001,0.01,0.984,0.9984804862444018,6223,6281
15,12604,10,100,0.0001,0.01,0.988,0.9982545223738496,6283,6321
15,12704,10,100,0.0001,0.01,0.984,0.9977959697732998,6337,6367
15,12804,10,100,0.0001,0.01,0.984,0.996641674476726,6386,6418
15,12904,10,100,0.0001,0.01,0.988,0.9977526348419095,6430,6474
15,13004,10,100,0.0001,0.01,0.982,0.9966164257151645,6475,6529
15,13104,10,100,0.0001,0.01,0.99,0.9978632478632479,6530,6574
15,13204,10,100,0.0001,0.01,0.99,0.9987125113601939,6590,6614
15,13304,10,100,0.0001,0.01,0.986,0.9977450390859892,6640,6664
15,13404,10,100,0.0001,0.01,0.986,0.9976872575350642,6693,6711
15,13504,10,100,0.0001,0.01,0.99,0.9996297393364929,6742,6762
15,13604,10,100,0.0001,0.01,0.986,0.9994854454572185,6784,6820
15,13704,10,100,0.0001,0.01,0.984,0.9984676007005254,6834,6870
15,13804,10,100,0.0001,0.01,0.978,0.9958707620979427,6880,6924
15,13904,10,100,0.0001,0.01,0.984,0.9979861910241657,6933,6971
15,14004,10,100,0.0001,0.01,0.98,0.9887889174521566,6989,7015
15,14104,10,100,0.0001,0.01,0.98,0.991633579126489,7039,7065
15,14204,10,100,0.0001,0.01,0.99,0.9972542945649113,7087,7117
15,14304,10,100,0.0001,0.01,0.986,0.9997203579418344,7136,7168
15,14404,10,100,0.0001,0.01,0.986,1.0,7185,7219
15,14504,10,100,0.0001,0.01,0.986,0.9999310535024821,7244,7260
15,14604,10,100,0.0001,0.01,0.986,1.0,7302,7302
15,14704,10,100,0.0001,0.01,0.986,1.0,7352,7352
15,14804,10,100,0.0001,0.01,0.99,0.9991218589570386,7405,7399
15,14904,10,100,0.0001,0.01,0.99,0.9997316156736447,7451,7453
15,15004,10,100,0.0001,0.01,0.986,0.9993335110637164,7503,7501
16,104,10,100,0.0001,0.01,0.476,0.5480769230769231,53,51
16,204,10,100,0.0001,0.01,0.52,0.5588235294117647,104,100
16,304,10,100,0.0001,0.01,0.526,0.6085526315789473,147,157
16,404,10,100,0.0001,0.01,0.462,0.5470297029702971,201,203
16,504,10,100,0.0001,0.01,0.462,0.5357142857142857,251,253
16,604,10,100,0.0001,0.01,0.49,0.6341059602649006,295,309
16,704,10,100,0.0001,0.01,0.504,0.6235795454545454,348,356
16,804,10,100,0.0001,0.01,0.5,0.6144278606965174,394,410
16,904,10,100,0.0001,0.01,0.476,0.6482300884955752,451,453
16,1004,10,100,0.0001,0.01,0.476,0.6633466135458167,492,512
16,1104,10,100,0.0001,0.01,0.486,0.6766304347826086,540,564
16,1204,10,100,0.0001,0.01,0.464,0.6943521594684385,588,616
16,1304,10,100,0.0001,0.01,0.476,0.6779141104294478,641,663
16,1404,10,100,0.0001,0.01,0.508,0.7094017094017094,695,709
16,1504,10,100,0.0001,0.01,0.52,0.6861702127659575,751,753
16,1604,10,100,0.0001,0.01,0.502,0.7369077306733167,793,811
16,1704,10,100,0.0001,0.01,0.508,0.6995305164319249,837,867
16,1804,10,100,0.0001,0.01,0.514,0.7289356984478935,888,916
16,1904,10,100,0.0001,0.01,0.524,0.7552521008403361,942,962
16,2004,10,100,0.0001,0.01,0.514,0.7754491017964071,993,1011
16,2104,10,100,0.0001,0.01,0.524,0.7590304182509505,1041,1063
16,2204,10,100,0.0001,0.01,0.508,0.7999092558983666,1084,1120
16,2304,10,100,0.0001,0.01,0.514,0.8111979166666666,1129,1175
16,2404,10,100,0.0001,0.01,0.554,0.8302828618968386,1176,1228
16,2504,10,100,0.0001,0.01,0.542,0.8218849840255591,1224,1280
16,2604,10,100,0.0001,0.01,0.558,0.8433179723502304,1270,1334
16,2704,10,100,0.0001,0.01,0.532,0.834689349112426,1306,1398
16,2804,10,100,0.0001,0.01,0.598,0.8744650499286734,1363,1441
16,2904,10,100,0.0001,0.01,0.584,0.8918732782369146,1410,1494
16,3004,10,100,0.0001,0.01,0.636,0.9097869507323568,1468,1536
16,3104,10,100,0.0001,0.01,0.664,0.8836984536082474,1517,1587
16,3204,10,100,0.0001,0.01,0.67,0.9169787765293383,1567,1637
16,3304,10,100,0.0001,0.01,0.696,0.9319007263922519,1626,1678
16,3404,10,100,0.0001,0.01,0.694,0.9333137485311398,1674,1730
16,3504,10,100,0.0001,0.01,0.704,0.9332191780821918,1727,1777
16,3604,10,100,0.0001,0.01,0.716,0.9544950055493896,1772,1832
16,3704,10,100,0.0001,0.01,0.752,0.9600431965442765,1818,1886
16,3804,10,100,0.0001,0.01,0.72,0.9584647739221872,1868,1936
16,3904,10,100,0.0001,0.01,0.734,0.9213627049180327,1916,1988
16,4004,10,100,0.0001,0.01,0.772,0.9527972027972028,1981,2023
16,4104,10,100,0.0001,0.01,0.786,0.9446881091617934,2028,2076
16,4204,10,100,0.0001,0.01,0.762,0.9524262607040913,2074,2130
16,4304,10,100,0.0001,0.01,0.792,0.9602695167286245,2125,2179
16,4404,10,100,0.0001,0.01,0.768,0.9554950045413261,2176,2228
16,4504,10,100,0.0001,0.01,0.748,0.9289520426287744,2218,2286
16,4604,10,100,0.0001,0.01,0.794,0.9639443961772372,2259,2345
16,4704,10,100,0.0001,0.01,0.826,0.9653486394557823,2315,2389
16,4804,10,100,0.0001,0.01,0.814,0.97751873438801,2365,2439
16,4904,10,100,0.0001,0.01,0.834,0.990415986949429,2406,2498
16,5004,10,100,0.0001,0.01,0.848,0.9920063948840927,2453,2551
16,5104,10,100,0.0001,0.01,0.836,0.9931426332288401,2505,2599
16,5204,10,100,0.0001,0.01,0.844,0.9925057647963106,2556,2648
16,5304,10,100,0.0001,0.01,0.84,0.9903846153846154,2601,2703
16,5404,10,100,0.0001,0.01,0.854,0.9929681717246485,2647,2757
16,5504,10,100,0.0001,0.01,0.852,0.9930959302325582,2698,2806
16,5604,10,100,0.0001,0.01,0.856,0.9953604568165596,2749,2855
16,5704,10,100,0.0001,0.01,0.876,0.9957924263674615,2804,2900
16,5804,10,100,0.0001,0.01,0.87,0.9981047553411441,2856,2948
16,5904,10,100,0.0001,0.01,0.886,0.9976287262872628,2910,2994
16,6004,10,100,0.0001,0.01,0.866,0.9971685542971352,2965,3039
16,6104,10,100,0.0001,0.01,0.86,0.9929554390563565,3019,3085
16,6204,10,100,0.0001,0.01,0.872,0.9858156028368794,3071,3133
16,6304,10,100,0.0001,0.01,0.884,0.993020304568528,3117,3187
16,6404,10,100,0.0001,0.01,0.872,0.98579013116802,3171,3233
16,6504,10,100,0.0001,0.01,0.882,0.9955412054120542,3217,3287
16,6604,10,100,0.0001,0.01,0.882,0.9883403997577226,3275,3329
16,6704,10,100,0.0001,0.01,0.892,0.9973150357995226,3325,3379
16,6804,10,100,0.0001,0.01,0.894,0.9979423868312757,3372,3432
16,6904,10,100,0.0001,0.01,0.904,0.9992757821552724,3429,3475
16,7004,10,100,0.0001,0.01,0.91,0.9980011422044546,3474,3530
16,7104,10,100,0.0001,0.01,0.908,0.9994369369369369,3518,3586
16,7204,10,100,0.0001,0.01,0.918,0.9994447529150472,3561,3643
16,7304,10,100,0.0001,0.01,0.924,0.9938389923329682,3607,3697
16,7404,10,100,0.0001,0.01,0.912,0.9936520799567801,3653,3751
16,7504,10,100,0.0001,0.01,0.906,0.9946695095948828,3703,3801
16,7604,10,100,0.0001,0.01,0.888,0.9898737506575487,3764,3840
16,7704,10,100,0.0001,0.01,0.924,0.9927310488058152,3808,3896
16,7804,10,100,0.0001,0.01,0.914,0.9952588416196823,3856,3948
16,7904,10,100,0.0001,0.01,0.918,0.9978491902834008,3903,4001
16,8004,10,100,0.0001,0.01,0.926,0.9977511244377811,3953,4051
16,8104,10,100,0.0001,0.01,0.932,0.9981490621915103,3991,4113
16,8204,10,100,0.0001,0.01,0.94,0.9985372988785958,4042,4162
16,8304,10,100,0.0001,0.01,0.938,0.9980732177263969,4091,4213
16,8404,10,100,0.0001,0.01,0.93,0.9983341266063779,4137,4267
16,8504,10,100,0.0001,0.01,0.926,0.9995296331138288,4194,4310
16,8604,10,100,0.0001,0.01,0.922,0.9980241748024175,4243,4361
16,8704,10,100,0.0001,0.01,0.93,0.9982766544117647,4289,4415
16,8804,10,100,0.0001,0.01,0.944,1.0,4334,4470
16,8904,10,100,0.0001,0.01,0.944,0.9984276729559748,4391,4513
16,9004,10,100,0.0001,0.01,0.954,0.9978898267436694,4437,4567
16,9104,10,100,0.0001,0.01,0.922,0.9942882249560633,4481,4623
16,9204,10,100,0.0001,0.01,0.922,0.9848978704910908,4531,4673
16,9304,10,100,0.0001,0.01,0.926,0.9837704213241617,4578,4726
16,9404,10,100,0.0001,0.01,0.936,0.9924500212675458,4627,4777
16,9504,10,100,0.0001,0.01,0.956,0.9969486531986532,4675,4829
16,9604,10,100,0.0001,0.01,0.95,0.9991670137442732,4728,4876
16,9704,10,100,0.0001,0.01,0.956,0.9991755976916735,4786,4918
16,9804,10,100,0.0001,0.01,0.946,0.9995920032639739,4841,4963
16,9904,10,100,0.0001,0.01,0.956,0.9984854604200323,4896,5008
16,10004,10,100,0.0001,0.01,0.96,0.9997001199520192,4955,5049
16,10104,10,100,0.0001,0.01,0.958,0.9999010292953285,5008,5096
16,10204,10,100,0.0001,0.01,0.958,0.999607996863975,5053,5151
16,10304,10,100,0.0001,0.01,0.962,0.999902950310559,5111,5193
16,10404,10,100,0.0001,0.01,0.966,0.9998077662437524,5161,5243
16,10504,10,100,0.0001,0.01,0.95,0.9975247524752475,5209,5295
16,10604,10,100,0.0001,0.01,0.966,0.9982082233119578,5260,5344
16,10704,10,100,0.0001,0.01,0.954,0.9965433482810164,5315,5389
16,10804,10,100,0.0001,0.01,0.956,0.9944465012958164,5367,5437
16,10904,10,100,0.0001,0.01,0.956,0.9856933235509905,5416,5488
16,11004,10,100,0.0001,0.01,0.962,0.9895492548164304,5465,5539
16,11104,10,100,0.0001,0.01,0.952,0.9929755043227666,5517,5587
16,11204,10,100,0.0001,0.01,0.958,0.9916101392359872,5555,5649
16,11304,10,100,0.0001,0.01,0.958,0.995930644019816,5616,5688
16,11404,10,100,0.0001,0.01,0.956,0.9983339179235357,5667,5737
16,11504,10,100,0.0001,0.01,0.956,0.9991307371349096,5717,5787
16,11604,10,100,0.0001,0.01,0.958,0.999741468459152,5766,5838
16,11704,10,100,0.0001,0.01,0.968,0.9984620642515379,5812,5892
16,11804,10,100,0.0001,0.01,0.956,0.9999152829549305,5856,5948
16,11904,10,100,0.0001,0.01,0.964,1.0,5899,6005
16,12004,10,100,0.0001,0.01,0.966,1.0,5940,6064
16,12104,10,100,0.0001,0.01,0.964,0.9999173826834105,5989,6115
16,12204,10,100,0.0001,0.01,0.97,0.9995902982628646,6037,6167
16,12304,10,100,0.0001,0.01,0.968,0.9986183355006502,6087,6217
16,12404,10,100,0.0001,0.01,0.97,0.9988713318284425,6142,6262
16,12504,10,100,0.0001,0.01,0.962,0.9992802303262955,6194,6310
16,12604,10,100,0.0001,0.01,0.962,0.9980165026975564,6249,6355
16,12704,10,100,0.0001,0.01,0.96,0.9976385390428212,6298,6406
16,12804,10,100,0.0001,0.01,0.938,0.9801624492346142,6347,6457
16,12904,10,100,0.0001,0.01,0.968,0.9902355858648481,6405,6499
16,13004,10,100,0.0001,0.01,0.97,0.9945401414949246,6454,6550
16,13104,10,100,0.0001,0.01,0.974,0.996031746031746,6501,6603
16,13204,10,100,0.0001,0.01,0.976,0.9957588609512269,6553,6651
16,13304,10,100,0.0001,0.01,0.974,0.9977450390859892,6619,6685
16,13404,10,100,0.0001,0.01,0.976,0.9979856759176365,6670,6734
16,13504,10,100,0.0001,0.01,0.978,0.99948163507109,6721,6783
16,13604,10,100,0.0001,0.01,0.978,1.0,6767,6837
16,13704,10,100,0.0001,0.01,0.978,0.9996351430239346,6824,6880
16,13804,10,100,0.0001,0.01,0.976,0.9999275572297884,6872,6932
16,13904,10,100,0.0001,0.01,0.974,1.0,6923,6981
16,14004,10,100,0.0001,0.01,0.974,1.0,6983,7021
16,14104,10,100,0.0001,0.01,0.978,0.9997872943845717,7029,7075
16,14204,10,100,0.0001,0.01,0.974,0.9997183891861448,7083,7121
16,14304,10,100,0.0001,0.01,0.966,0.9897930648769575,7134,7170
16,14404,10,100,0.0001,0.01,0.96,0.9880588725354068,7188,7216
16,14504,10,100,0.0001,0.01,0.968,0.9985521235521235,7241,7263
16,14604,10,100,0.0001,0.01,0.976,0.9976718707203506,7291,7313
16,14704,10,100,0.0001,0.01,0.982,0.9997959738846572,7341,7363
16,14804,10,100,0.0001,0.01,0.976,0.9956092947851932,7389,7415
16,14904,10,100,0.0001,0.01,0.984,0.9993290391841116,7436,7468
16,15004,10,100,0.0001,0.01,0.98,0.998000533191149,7492,7512
17,104,10,100,0.0001,0.01,0.506,0.6826923076923077,47,57
17,204,10,100,0.0001,0.01,0.488,0.7549019607843137,103,101
17,304,10,100,0.0001,0.01,0.504,0.631578947368421,159,145
17,404,10,100,0.0001,0.01,0.506,0.6831683168316832,208,196
17,504,10,100,0.0001,0.01,0.51,0.626984126984127,261,243
17,604,10,100,0.0001,0.01,0.506,0.6324503311258278,306,298
17,704,10,100,0.0001,0.01,0.514,0.6235795454545454,359,345
17,804,10,100,0.0001,0.01,0.508,0.6455223880597015,406,398
17,904,10,100,0.0001,0.01,0.51,0.6526548672566371,459,445
17,1004,10,100,0.0001,0.01,0.526,0.6593625498007968,506,498
17,1104,10,100,0.0001,0.01,0.514,0.6639492753623188,550,554
17,1204,10,100,0.0001,0.01,0.526,0.6760797342192691,609,595
17,1304,10,100,0.0001,0.01,0.512,0.6633435582822086,651,653
17,1404,10,100,0.0001,0.01,0.524,0.7101139601139601,689,715
17,1504,10,100,0.0001,0.01,0.546,0.71875,740,764
17,1604,10,100,0.0001,0.01,0.546,0.7556109725685786,796,808
17,1704,10,100,0.0001,0.01,0.558,0.7517605633802817,846,858
17,1804,10,100,0.0001,0.01,0.57,0.7688470066518847,901,903
17,1904,10,100,0.0001,0.01,0.594,0.7689075630252101,953,951
17,2004,10,100,0.0001,0.01,0.638,0.8023952095808383,1006,998
17,2104,10,100,0.0001,0.01,0.676,0.8189163498098859,1059,1045
17,2204,10,100,0.0001,0.01,0.642,0.8421052631578947,1100,1104
17,2304,10,100,0.0001,0.01,0.682,0.8611111111111112,1147,1157
17,2404,10,100,0.0001,0.01,0.684,0.8698003327787022,1197,1207
17,2504,10,100,0.0001,0.01,0.712,0.9009584664536742,1247,1257
17,2604,10,100,0.0001,0.01,0.75,0.9112903225806451,1298,1306
17,2704,10,100,0.0001,0.01,0.74,0.904215976331361,1348,1356
17,2804,10,100,0.0001,0.01,0.762,0.9368758915834522,1401,1403
17,2904,10,100,0.0001,0.01,0.774,0.943870523415978,1444,1460
17,3004,10,100,0.0001,0.01,0.786,0.9474034620505992,1503,1501
17,3104,10,100,0.0001,0.01,0.814,0.9532860824742269,1560,1544
17,3204,10,100,0.0001,0.01,0.814,0.9619225967540574,1615,1589
17,3304,10,100,0.0001,0.01,0.83,0.9446125907990315,1664,1640
17,3404,10,100,0.0001,0.01,0.844,0.9576968272620446,1712,1692
17,3504,10,100,0.0001,0.01,0.846,0.9500570776255708,1763,1741
17,3604,10,100,0.0001,0.01,0.814,0.9625416204217536,1810,1794
17,3704,10,100,0.0001,0.01,0.85,0.9438444924406048,1865,1839
17,3804,10,100,0.0001,0.01,0.864,0.9760778128286015,1907,1897
17,3904,10,100,0.0001,0.01,0.86,0.9679815573770492,1954,1950
17,4004,10,100,0.0001,0.01,0.874,0.9812687312687313,2007,1997
17,4104,10,100,0.0001,0.01,0.88,0.9844054580896686,2056,2048
17,4204,10,100,0.0001,0.01,0.878,0.9857278782112274,2114,2090
17,4304,10,100,0.0001,0.01,0.894,0.9890799256505576,2169,2135
17,4404,10,100,0.0001,0.01,0.92,0.9977293369663942,2217,2187
17,4504,10,100,0.0001,0.01,0.92,0.9980017761989343,2258,2246
17,4604,10,100,0.0001,0.01,0.918,0.9993483927019983,2310,2294
17,4704,10,100,0.0001,0.01,0.912,0.9991496598639455,2365,2339
17,4804,10,100,0.0001,0.01,0.906,0.9985428809325562,2409,2395
17,4904,10,100,0.0001,0.01,0.934,0.9981647634584013,2458,2446
17,5004,10,100,0.0001,0.01,0.924,0.9928057553956835,2512,2492
17,5104,10,100,0.0001,0.01,0.92,0.9943181818181818,2550,2554
17,5204,10,100,0.0001,0.01,0.916,0.9615680245964643,2595,2609
17,5304,10,100,0.0001,0.01,0.906,0.9728506787330317,2653,2651
17,5404,10,100,0.0001,0.01,0.936,0.9829755736491488,2704,2700
17,5504,10,100,0.0001,0.01,0.948,0.9921875,2757,2747
17,5604,10,100,0.0001,0.01,0.95,0.9989293361884368,2805,2799
17,5704,10,100,0.0001,0.01,0.956,0.9998246844319776,2856,2848
17,5804,10,100,0.0001,0.01,0.952,1.0,2904,2900
17,5904,10,100,0.0001,0.01,0.954,1.0,2949,2955
17,6004,10,100,0.0001,0.01,0.956,1.0,2999,3005
17,6104,10,100,0.0001,0.01,0.956,1.0,3047,3057
17,6204,10,100,0.0001,0.01,0.948,0.9993552546744036,3100,3104
17,6304,10,100,0.0001,0.01,0.956,0.9995241116751269,3161,3143
17,6404,10,100,0.0001,0.01,0.958,1.0,3207,3197
17,6504,10,100,0.0001,0.01,0.958,0.9993849938499385,3262,3242
17,6604,10,100,0.0001,0.01,0.96,0.9995457298606905,3312,3292
17,6704,10,100,0.0001,0.01,0.958,0.9979116945107399,3354,3350
17,6804,10,100,0.0001,0.01,0.95,0.9939741328630217,3404,3400
17,6904,10,100,0.0001,0.01,0.936,0.9611819235225956,3452,3452
17,7004,10,100,0.0001,0.01,0.916,0.9767275842375785,3498,3506
17,7104,10,100,0.0001,0.01,0.958,0.993384009009009,3551,3553
17,7204,10,100,0.0001,0.01,0.962,0.997223764575236,3604,3600
17,7304,10,100,0.0001,0.01,0.962,0.9995892661555312,3650,3654
17,7404,10,100,0.0001,0.01,0.964,0.9997298757428417,3703,3701
17,7504,10,100,0.0001,0.01,0.968,0.9998667377398721,3754,3750
17,7604,10,100,0.0001,0.01,0.962,0.9989479221462388,3811,3793
17,7704,10,100,0.0001,0.01,0.974,1.0,3853,3851
17,7804,10,100,0.0001,0.01,0.962,1.0,3896,3908
17,7904,10,100,0.0001,0.01,0.974,1.0,3947,3957
17,8004,10,100,0.0001,0.01,0.972,0.9995002498750625,4008,3996
17,8104,10,100,0.0001,0.01,0.976,0.9992596248766041,4054,4050
17,8204,10,100,0.0001,0.01,0.962,0.9964651389566065,4099,4105
17,8304,10,100,0.0001,0.01,0.964,0.9948217726396917,4149,4155
17,8404,10,100,0.0001,0.01,0.958,0.993455497382199,4192,4212
17,8504,10,100,0.0001,0.01,0.94,0.9609595484477893,4248,4256
17,8604,10,100,0.0001,0.01,0.968,0.9911668991166899,4289,4315
17,8704,10,100,0.0001,0.01,0.972,0.9958639705882353,4343,4361
17,8804,10,100,0.0001,0.01,0.97,0.998750567923671,4389,4415
17,8904,10,100,0.0001,0.01,0.972,0.9993261455525606,4438,4466
17,9004,10,100,0.0001,0.01,0.976,0.9994446912483341,4485,4519
17,9104,10,100,0.0001,0.01,0.976,0.999670474516696,4542,4562
17,9204,10,100,0.0001,0.01,0.984,0.9994567579313341,4580,4624
17,9304,10,100,0.0001,0.01,0.986,0.9998925193465176,4626,4678
17,9404,10,100,0.0001,0.01,0.984,1.0,4677,4727
17,9504,10,100,0.0001,0.01,0.984,0.9989478114478114,4724,4780
17,9604,10,100,0.0001,0.01,0.978,0.9986463973344439,4774,4830
17,9704,10,100,0.0001,0.01,0.982,0.9982481450948063,4817,4887
17,9804,10,100,0.0001,0.01,0.992,0.9997960016319869,4873,4931
17,9904,10,100,0.0001,0.01,0.986,0.999394184168013,4927,4977
17,10004,10,100,0.0001,0.01,0.988,1.0,4975,5029
17,10104,10,100,0.0001,0.01,0.986,1.0,5028,5076
17,10204,10,100,0.0001,0.01,0.984,1.0,5070,5134
17,10304,10,100,0.0001,0.01,0.986,1.0,5118,5186
17,10404,10,100,0.0001,0.01,0.984,0.9988465974625144,5172,5232
17,10504,10,100,0.0001,0.01,0.984,0.996953541507997,5227,5277
17,10604,10,100,0.0001,0.01,0.976,0.9914183327046397,5282,5322
17,10704,10,100,0.0001,0.01,0.982,0.9972907324364724,5330,5374
17,10804,10,100,0.0001,0.01,0.988,0.9976860422065902,5389,5415
17,10904,10,100,0.0001,0.01,0.988,0.9961482024944974,5435,5469
17,11004,10,100,0.0001,0.01,0.988,0.9990912395492548,5488,5516
17,11104,10,100,0.0001,0.01,0.986,0.999549711815562,5535,5569
17,11204,10,100,0.0001,0.01,0.99,0.9991967154587648,5583,5621
17,11304,10,100,0.0001,0.01,0.976,0.9899150743099787,5629,5675
17,11404,10,100,0.0001,0.01,0.992,0.998860049105577,5678,5726
17,11504,10,100,0.0001,0.01,0.988,0.9999130737134909,5730,5774
17,11604,10,100,0.0001,0.01,0.99,1.0,5770,5834
17,11704,10,100,0.0001,0.01,0.992,1.0,5817,5887
17,11804,10,100,0.0001,0.01,0.992,1.0,5863,5941
17,11904,10,100,0.0001,0.01,0.992,1.0,5899,6005
17,12004,10,100,0.0001,0.01,0.992,1.0,5949,6055
17,12104,10,100,0.0001,0.01,0.992,1.0,5993,6111
17,12204,10,100,0.0001,0.01,0.984,0.998934775483448,6045,6159
17,12304,10,100,0.0001,0.01,0.988,0.9991872561768531,6089,6215
17,12404,10,100,0.0001,0.01,0.99,0.999032570138665,6145,6259
17,12504,10,100,0.0001,0.01,0.988,0.9984804862444018,6193,6311
17,12604,10,100,0.0001,0.01,0.99,0.997778483021263,6250,6354
17,12704,10,100,0.0001,0.01,0.992,0.9996851385390428,6304,6400
17,12804,10,100,0.0001,0.01,0.996,0.9985160887222743,6354,6450
17,12904,10,100,0.0001,0.01,0.994,1.0,6409,6495
17,13004,10,100,0.0001,0.01,0.992,0.9975392187019378,6455,6549
17,13104,10,100,0.0001,0.01,0.992,0.9987789987789988,6510,6594
17,13204,10,100,0.0001,0.01,0.986,0.9932596182974857,6557,6647
17,13304,10,100,0.0001,0.01,0.984,0.9969182200841852,6611,6693
17,13404,10,100,0.0001,0.01,0.992,0.9973142345568488,6662,6742
17,13504,10,100,0.0001,0.01,0.994,0.998593009478673,6715,6789
17,13604,10,100,0.0001,0.01,0.994,0.9984563363716554,6769,6835
17,13704,10,100,0.0001,0.01,0.994,0.9999270286047869,6820,6884
17,13804,10,100,0.0001,0.01,0.994,0.9999275572297884,6878,6926
17,13904,10,100,0.0001,0.01,0.994,0.9997123130034522,6931,6973
17,14004,10,100,0.0001,0.01,0.992,0.9999285918309054,6983,7021
17,14104,10,100,0.0001,0.01,0.994,1.0,7033,7071
17,14204,10,100,0.0001,0.01,0.992,1.0,7094,7110
17,14304,10,100,0.0001,0.01,0.994,1.0,7140,7164
17,14404,10,100,0.0001,0.01,0.994,0.9997917245209664,7190,7214
17,14504,10,100,0.0001,0.01,0.998,0.9987589630446774,7242,7262
17,14604,10,100,0.0001,0.01,0.992,0.9961654341276363,7293,7311
17,14704,10,100,0.0001,0.01,0.992,0.9966675734494015,7343,7361
17,14804,10,100,0.0001,0.01,0.984,0.9967576330721427,7395,7409
17,14904,10,100,0.0001,0.01,0.996,0.9993961352657005,7442,7462
17,15004,10,100,0.0001,0.01,0.996,0.9997334044254865,7500,7504
18,104,10,100,0.0001,0.01,0.494,0.6057692307692307,52,52
18,204,10,100,0.0001,0.01,0.496,0.7009803921568627,104,100
18,304,10,100,0.0001,0.01,0.504,0.5789473684210527,150,154
18,404,10,100,0.0001,0.01,0.496,0.6608910891089109,205,199
18,504,10,100,0.0001,0.01,0.512,0.5694444444444444,260,244
18,604,10,100,0.0001,0.01,0.53,0.6539735099337748,311,293
18,704,10,100,0.0001,0.01,0.472,0.6477272727272727,352,352
18,804,10,100,0.0001,0.01,0.464,0.650497512437811,390,414
18,904,10,100,0.0001,0.01,0.486,0.620575221238938,437,467
18,1004,10,100,0.0001,0.01,0.528,0.6414342629482072,488,516
18,1104,10,100,0.0001,0.01,0.524,0.6621376811594203,539,565
18,1204,10,100,0.0001,0.01,0.52,0.6910299003322259,592,612
18,1304,10,100,0.0001,0.01,0.548,0.6878834355828221,645,659
18,1404,10,100,0.0001,0.01,0.522,0.7150997150997151,696,708
18,1504,10,100,0.0001,0.01,0.534,0.7094414893617021,746,758
18,1604,10,100,0.0001,0.01,0.538,0.713216957605985,801,803
18,1704,10,100,0.0001,0.01,0.572,0.7341549295774648,843,861
18,1804,10,100,0.0001,0.01,0.576,0.7682926829268293,900,904
18,1904,10,100,0.0001,0.01,0.556,0.7253151260504201,945,959
18,2004,10,100,0.0001,0.01,0.568,0.7524950099800399,988,1016
18,2104,10,100,0.0001,0.01,0.58,0.7789923954372624,1035,1069
18,2204,10,100,0.0001,0.01,0.614,0.8257713248638838,1080,1124
18,2304,10,100,0.0001,0.01,0.596,0.7986111111111112,1126,1178
18,2404,10,100,0.0001,0.01,0.63,0.8211314475873545,1181,1223
18,2504,10,100,0.0001,0.01,0.638,0.8534345047923323,1227,1277
18,2604,10,100,0.0001,0.01,0.614,0.8444700460829493,1277,1327
18,2704,10,100,0.0001,0.01,0.648,0.8598372781065089,1331,1373
18,2804,10,100,0.0001,0.01,0.702,0.8976462196861626,1384,1420
18,2904,10,100,0.0001,0.01,0.684,0.9273415977961432,1437,1467
18,3004,10,100,0.0001,0.01,0.704,0.8608521970705726,1491,1513
18,3104,10,100,0.0001,0.01,0.704,0.9371778350515464,1543,1561
18,3204,10,100,0.0001,0.01,0.716,0.9413233458177278,1598,1606
18,3304,10,100,0.0001,0.01,0.748,0.9549031476997578,1639,1665
18,3404,10,100,0.0001,0.01,0.76,0.945358401880141,1683,1721
18,3504,10,100,0.0001,0.01,0.764,0.9706050228310502,1729,1775
18,3604,10,100,0.0001,0.01,0.774,0.9711431742508324,1782,1822
18,3704,10,100,0.0001,0.01,0.778,0.9743520518358532,1835,1869
18,3804,10,100,0.0001,0.01,0.818,0.9692429022082019,1891,1913
18,3904,10,100,0.0001,0.01,0.804,0.9638831967213115,1940,1964
18,4004,10,100,0.0001,0.01,0.802,0.98001998001998,1989,2015
18,4104,10,100,0.0001,0.01,0.814,0.9839181286549707,2030,2074
18,4204,10,100,0.0001,0.01,0.814,0.9828734538534729,2086,2118
18,4304,10,100,0.0001,0.01,0.834,0.9902416356877324,2137,2167
18,4404,10,100,0.0001,0.01,0.834,0.9845594913714805,2187,2217
18,4504,10,100,0.0001,0.01,0.824,0.9795737122557726,2235,2269
18,4604,10,100,0.0001,0.01,0.858,0.9902258905299739,2282,2322
18,4704,10,100,0.0001,0.01,0.87,0.9900085034013606,2335,2369
18,4804,10,100,0.0001,0.01,0.896,0.9950041631973355,2382,2422
18,4904,10,100,0.0001,0.01,0.876,0.9936786296900489,2431,2473
18,5004,10,100,0.0001,0.01,0.882,0.996802557953637,2484,2520
18,5104,10,100,0.0001,0.01,0.874,0.984717868338558,2526,2578
18,5204,10,100,0.0001,0.01,0.88,0.98923904688701,2583,2621
18,5304,10,100,0.0001,0.01,0.896,0.997737556561086,2639,2665
18,5404,10,100,0.0001,0.01,0.872,0.966321243523316,2688,2716
18,5504,10,100,0.0001,0.01,0.894,0.9854651162790697,2742,2762
18,5604,10,100,0.0001,0.01,0.904,0.9908993576017131,2787,2817
18,5704,10,100,0.0001,0.01,0.918,0.9910589060308556,2834,2870
18,5804,10,100,0.0001,0.01,0.922,0.9884562370778773,2885,2919
18,5904,10,100,0.0001,0.01,0.898,0.9612127371273713,2941,2963
18,6004,10,100,0.0001,0.01,0.936,0.9825116588940707,2995,3009
18,6104,10,100,0.0001,0.01,0.94,0.9939384010484927,3049,3055
18,6204,10,100,0.0001,0.01,0.946,0.9969374597034172,3092,3112
18,6304,10,100,0.0001,0.01,0.952,0.9988895939086294,3154,3150
18,6404,10,100,0.0001,0.01,0.956,0.9992192379762649,3199,3205
18,6504,10,100,0.0001,0.01,0.95,0.9996924969249692,3262,3242
18,6604,10,100,0.0001,0.01,0.954,0.9983343428225318,3315,3289
18,6704,10,100,0.0001,0.01,0.952,0.9979116945107399,3370,3334
18,6804,10,100,0.0001,0.01,0.942,0.9986772486772487,3419,3385
18,6904,10,100,0.0001,0.01,0.958,0.9982618771726536,3466,3438
18,7004,10,100,0.0001,0.01,0.95,0.9981439177612793,3515,3489
18,7104,10,100,0.0001,0.01,0.956,0.9953547297297297,3566,3538
18,7204,10,100,0.0001,0.01,0.95,0.9966685174902832,3617,3587
18,7304,10,100,0.0001,0.01,0.956,0.9952081051478642,3666,3638
18,7404,10,100,0.0001,0.01,0.94,0.9817666126418152,3715,3689
18,7504,10,100,0.0001,0.01,0.94,0.9816098081023454,3769,3735
18,7604,10,100,0.0001,0.01,0.952,0.9930299842188322,3818,3786
18,7704,10,100,0.0001,0.01,0.948,0.9902647975077882,3873,3831
18,7804,10,100,0.0001,0.01,0.962,0.9991030240902101,3921,3883
18,7904,10,100,0.0001,0.01,0.962,0.9994939271255061,3979,3925
18,8004,10,100,0.0001,0.01,0.968,0.999375312343828,4028,3976
18,8104,10,100,0.0001,0.01,0.964,0.9988894373149062,4075,4029
18,8204,10,100,0.0001,0.01,0.974,0.9991467576791809,4121,4083
18,8304,10,100,0.0001,0.01,0.966,0.9992774566473989,4173,4131
18,8404,10,100,0.0001,0.01,0.972,0.9997620180866255,4214,4190
18,8504,10,100,0.0001,0.01,0.972,0.9996472248353716,4258,4246
18,8604,10,100,0.0001,0.01,0.966,0.9998837749883775,4308,4296
18,8704,10,100,0.0001,0.01,0.96,0.9996553308823529,4355,4349
18,8804,10,100,0.0001,0.01,0.964,0.989777373920945,4402,4402
18,8904,10,100,0.0001,0.01,0.962,0.9857367475292004,4449,4455
18,9004,10,100,0.0001,0.01,0.964,0.9928920479786761,4505,4499
18,9104,10,100,0.0001,0.01,0.97,0.9948374340949033,4553,4551
18,9204,10,100,0.0001,0.01,0.976,0.9934810951760105,4602,4602
18,9304,10,100,0.0001,0.01,0.964,0.9972055030094583,4646,4658
18,9404,10,100,0.0001,0.01,0.98,0.9986176095278605,4694,4710
18,9504,10,100,0.0001,0.01,0.976,0.9995791245791246,4746,4758
18,9604,10,100,0.0001,0.01,0.972,0.9977092877967514,4797,4807
18,9704,10,100,0.0001,0.01,0.98,0.9975267930750206,4860,4844
18,9804,10,100,0.0001,0.01,0.966,0.9973480212158303,4911,4893
18,9904,10,100,0.0001,0.01,0.972,0.99828352180937,4971,4933
18,10004,10,100,0.0001,0.01,0.974,0.9974010395841664,5010,4994
18,10104,10,100,0.0001,0.01,0.976,0.9951504354711006,5056,5048
18,10204,10,100,0.0001,0.01,0.974,0.9956879655037241,5109,5095
18,10304,10,100,0.0001,0.01,0.978,0.9954386645962733,5153,5151
18,10404,10,100,0.0001,0.01,0.972,0.9910611303344867,5198,5206
18,10504,10,100,0.0001,0.01,0.97,0.9944782939832445,5252,5252
18,10604,10,100,0.0001,0.01,0.984,0.9952847981893626,5303,5301
18,10704,10,100,0.0001,0.01,0.98,0.9933669656203289,5353,5351
18,10804,10,100,0.0001,0.01,0.986,0.9982413920770085,5404,5400
18,10904,10,100,0.0001,0.01,0.976,0.9955979457079971,5460,5444
18,11004,10,100,0.0001,0.01,0.99,0.9994547437295529,5511,5493
18,11104,10,100,0.0001,0.01,0.984,0.9997298270893372,5556,5548
18,11204,10,100,0.0001,0.01,0.988,0.999910746162085,5608,5596
18,11304,10,100,0.0001,0.01,0.99,0.9998230714791224,5663,5641
18,11404,10,100,0.0001,0.01,0.992,0.9994738688179586,5714,5690
18,11504,10,100,0.0001,0.01,0.992,0.9995653685674548,5760,5744
18,11604,10,100,0.0001,0.01,0.988,0.9991382281971734,5805,5799
18,11704,10,100,0.0001,0.01,0.99,1.0,5853,5851
18,11804,10,100,0.0001,0.01,0.978,0.9888173500508303,5907,5897
18,11904,10,100,0.0001,0.01,0.988,0.9963877688172043,5951,5953
18,12004,10,100,0.0001,0.01,0.988,0.9930856381206264,6004,6000
18,12104,10,100,0.0001,0.01,0.984,0.9970257766027759,6061,6043
18,12204,10,100,0.0001,0.01,0.964,0.9927892494264176,6115,6089
18,12304,10,100,0.0001,0.01,0.978,0.9926853055916776,6166,6138
18,12404,10,100,0.0001,0.01,0.98,0.9951628506933248,6212,6192
18,12504,10,100,0.0001,0.01,0.99,0.9983205374280231,6266,6238
18,12604,10,100,0.0001,0.01,0.996,0.9978578229133609,6322,6282
18,12704,10,100,0.0001,0.01,0.994,0.9998425692695214,6378,6326
18,12804,10,100,0.0001,0.01,0.99,0.9986722899094033,6415,6389
18,12904,10,100,0.0001,0.01,0.99,0.9993800371977681,6462,6442
18,13004,10,100,0.0001,0.01,0.99,0.9993848046754845,6509,6495
18,13104,10,100,0.0001,0.01,0.992,0.9981684981684982,6558,6546
18,13204,10,100,0.0001,0.01,0.988,0.9975764919721296,6609,6595
18,13304,10,100,0.0001,0.01,0.988,0.994588093806374,6660,6644
18,13404,10,100,0.0001,0.01,0.99,0.9988063264697106,6706,6698
18,13504,10,100,0.0001,0.01,0.994,0.9998518957345972,6759,6745
18,13604,10,100,0.0001,0.01,0.996,1.0,6818,6786
18,13704,10,100,0.0001,0.01,0.996,1.0,6867,6837
18,13804,10,100,0.0001,0.01,0.996,0.9996377861489424,6911,6893
18,13904,10,100,0.0001,0.01,0.996,1.0,6962,6942
18,14004,10,100,0.0001,0.01,0.996,1.0,7014,6990
18,14104,10,100,0.0001,0.01,0.998,1.0,7067,7037
18,14204,10,100,0.0001,0.01,0.996,1.0,7106,7098
18,14304,10,100,0.0001,0.01,0.996,1.0,7158,7146
18,14404,10,100,0.0001,0.01,0.984,0.9895862260483199,7215,7189
18,14504,10,100,0.0001,0.01,0.992,0.9967595146166575,7260,7244
18,14604,10,100,0.0001,0.01,0.986,0.9841824157764996,7309,7295
18,14704,10,100,0.0001,0.01,0.992,0.997347660500544,7362,7342
18,14804,10,100,0.0001,0.01,0.996,0.9987165630910565,7413,7391
18,14904,10,100,0.0001,0.01,0.998,0.9990606548577563,7457,7447
18,15004,10,100,0.0001,0.01,0.99,0.9981338309784058,7511,7493
19,104,10,100,0.0001,0.01,0.498,0.7115384615384616,45,59
19,204,10,100,0.0001,0.01,0.53,0.6176470588235294,91,113
19,304,10,100,0.0001,0.01,0.51,0.6151315789473685,145,159
19,404,10,100,0.0001,0.01,0.524,0.6584158415841584,195,209
19,504,10,100,0.0001,0.01,0.494,0.623015873015873,241,263
19,604,10,100,0.0001,0.01,0.472,0.6307947019867549,281,323
19,704,10,100,0.0001,0.01,0.476,0.6420454545454546,334,370
19,804,10,100,0.0001,0.01,0.514,0.6567164179104478,388,416
19,904,10,100,0.0001,0.01,0.49,0.6415929203539823,438,466
19,1004,10,100,0.0001,0.01,0.506,0.6772908366533864,494,510
19,1104,10,100,0.0001,0.01,0.472,0.6567028985507246,542,562
19,1204,10,100,0.0001,0.01,0.482,0.7250830564784053,593,611
19,1304,10,100,0.0001,0.01,0.514,0.6940184049079755,636,668
19,1404,10,100,0.0001,0.01,0.464,0.6930199430199431,686,718
19,1504,10,100,0.0001,0.01,0.514,0.6954787234042553,740,764
19,1604,10,100,0.0001,0.01,0.496,0.75,799,805
19,1704,10,100,0.0001,0.01,0.498,0.7517605633802817,853,851
19,1804,10,100,0.0001,0.01,0.472,0.7549889135254989,907,897
19,1904,10,100,0.0001,0.01,0.5,0.7809873949579832,956,948
19,2004,10,100,0.0001,0.01,0.502,0.7994011976047904,1006,998
19,2104,10,100,0.0001,0.01,0.506,0.814638783269962,1054,1050
19,2204,10,100,0.0001,0.01,0.506,0.8507259528130672,1102,1102
19,2304,10,100,0.0001,0.01,0.522,0.8389756944444444,1150,1154
19,2404,10,100,0.0001,0.01,0.506,0.8789517470881864,1207,1197
19,2504,10,100,0.0001,0.01,0.554,0.8761980830670927,1254,1250
19,2604,10,100,0.0001,0.01,0.518,0.859062980030722,1315,1289
19,2704,10,100,0.0001,0.01,0.56,0.8879437869822485,1363,1341
19,2804,10,100,0.0001,0.01,0.558,0.9101283880171184,1413,1391
19,2904,10,100,0.0001,0.01,0.536,0.8932506887052342,1452,1452
19,3004,10,100,0.0001,0.01,0.608,0.920439414114514,1504,1500
19,3104,10,100,0.0001,0.01,0.584,0.904639175257732,1554,1550
19,3204,10,100,0.0001,0.01,0.604,0.9219725343320849,1601,1603
19,3304,10,100,0.0001,0.01,0.614,0.8913438256658596,1646,1658
19,3404,10,100,0.0001,0.01,0.628,0.9324324324324325,1698,1706
19,3504,10,100,0.0001,0.01,0.66,0.9534817351598174,1749,1755
19,3604,10,100,0.0001,0.01,0.686,0.9497780244173141,1796,1808
19,3704,10,100,0.0001,0.01,0.684,0.9565334773218143,1851,1853
19,3804,10,100,0.0001,0.01,0.748,0.9676656151419558,1907,1897
19,3904,10,100,0.0001,0.01,0.746,0.9823258196721312,1954,1950
19,4004,10,100,0.0001,0.01,0.744,0.9787712287712288,2007,1997
19,4104,10,100,0.0001,0.01,0.754,0.9617446393762183,2052,2052
19,4204,10,100,0.0001,0.01,0.808,0.9752616555661275,2105,2099
19,4304,10,100,0.0001,0.01,0.82,0.9853624535315985,2159,2145
19,4404,10,100,0.0001,0.01,0.816,0.9868301544050863,2209,2195
19,4504,10,100,0.0001,0.01,0.866,0.9964476021314387,2249,2255
19,4604,10,100,0.0001,0.01,0.85,0.9950043440486533,2292,2312
19,4704,10,100,0.0001,0.01,0.854,0.9961734693877551,2340,2364
19,4804,10,100,0.0001,0.01,0.872,0.9968776019983348,2388,2416
19,4904,10,100,0.0001,0.01,0.87,0.9961256117455138,2437,2467
19,5004,10,100,0.0001,0.01,0.898,0.9974020783373302,2499,2505
19,5104,10,100,0.0001,0.01,0.878,0.9939263322884012,2547,2557
19,5204,10,100,0.0001,0.01,0.876,0.9901998462720983,2603,2601
19,5304,10,100,0.0001,0.01,0.892,0.9939668174962293,2657,2647
19,5404,10,100,0.0001,0.01,0.898,0.9894522575869726,2704,2700
19,5504,10,100,0.0001,0.01,0.874,0.9838299418604651,2767,2737
19,5604,10,100,0.0001,0.01,0.9,0.9894718058529621,2817,2787
19,5704,10,100,0.0001,0.01,0.924,0.989656381486676,2868,2836
19,5804,10,100,0.0001,0.01,0.924,0.9958649207443143,2923,2881
19,5904,10,100,0.0001,0.01,0.922,0.9913617886178862,2970,2934
19,6004,10,100,0.0001,0.01,0.934,0.9968354430379747,3029,2975
19,6104,10,100,0.0001,0.01,0.944,0.9981979030144168,3066,3038
19,6204,10,100,0.0001,0.01,0.954,0.9979045776918117,3118,3086
19,6304,10,100,0.0001,0.01,0.95,1.0,3180,3124
19,6404,10,100,0.0001,0.01,0.954,0.9993753903810119,3227,3177
19,6504,10,100,0.0001,0.01,0.952,0.9990774907749077,3282,3222
19,6604,10,100,0.0001,0.01,0.942,0.9980314960629921,3334,3270
19,6704,10,100,0.0001,0.01,0.956,0.9985083532219571,3393,3311
19,6804,10,100,0.0001,0.01,0.95,0.9989711934156379,3444,3360
19,6904,10,100,0.0001,0.01,0.956,0.9956546929316339,3493,3411
19,7004,10,100,0.0001,0.01,0.946,0.9984294688749286,3545,3459
19,7104,10,100,0.0001,0.01,0.95,0.9925394144144144,3587,3517
19,7204,10,100,0.0001,0.01,0.946,0.9909772348695169,3639,3565
19,7304,10,100,0.0001,0.01,0.952,0.9887732749178533,3696,3608
19,7404,10,100,0.0001,0.01,0.952,0.995407887628309,3750,3654
19,7504,10,100,0.0001,0.01,0.956,0.99613539445629,3806,3698
19,7604,10,100,0.0001,0.01,0.95,0.9988164124145187,3842,3762
19,7704,10,100,0.0001,0.01,0.96,0.9996105919003115,3891,3813
19,7804,10,100,0.0001,0.01,0.958,0.9992311635058944,3939,3865
19,7904,10,100,0.0001,0.01,0.966,0.9989878542510121,3985,3919
19,8004,10,100,0.0001,0.01,0.956,0.9940029985007496,4034,3970
19,8104,10,100,0.0001,0.01,0.966,0.9987660414610069,4086,4018
19,8204,10,100,0.0001,0.01,0.97,0.9986591906387128,4129,4075
19,8304,10,100,0.0001,0.01,0.97,0.9984344894026975,4181,4123
19,8404,10,100,0.0001,0.01,0.974,0.9992860542598763,4223,4181
19,8504,10,100,0.0001,0.01,0.966,0.9985888993414863,4281,4223
19,8604,10,100,0.0001,0.01,0.976,0.99814039981404,4342,4262
19,8704,10,100,0.0001,0.01,0.98,0.9991957720588235,4400,4304
19,8804,10,100,0.0001,0.01,0.976,0.9976147205815539,4449,4355
19,8904,10,100,0.0001,0.01,0.976,0.9987646001796945,4496,4408
19,9004,10,100,0.0001,0.01,0.982,0.9965570857396713,4543,4461
19,9104,10,100,0.0001,0.01,0.968,0.9943980667838312,4594,4510
19,9204,10,100,0.0001,0.01,0.968,0.9930465015210778,4643,4561
19,9304,10,100,0.0001,0.01,0.976,0.9934436801375752,4694,4610
19,9404,10,100,0.0001,0.01,0.974,0.9907486176095278,4736,4668
19,9504,10,100,0.0001,0.01,0.964,0.98989898989899,4788,4716
19,9604,10,100,0.0001,0.01,0.982,0.9970845481049563,4831,4773
19,9704,10,100,0.0001,0.01,0.978,0.9988664468260511,4876,4828
19,9804,10,100,0.0001,0.01,0.98,0.9990820073439413,4923,4881
19,9904,10,100,0.0001,0.01,0.984,0.9969709208400647,4979,4925
19,10004,10,100,0.0001,0.01,0.978,0.9988004798080767,5033,4971
19,10104,10,100,0.0001,0.01,0.984,0.9999010292953285,5073,5031
19,10204,10,100,0.0001,0.01,0.98,0.9993139945119561,5128,5076
19,10304,10,100,0.0001,0.01,0.986,1.0,5183,5121
19,10404,10,100,0.0001,0.01,0.986,0.9999038831218762,5230,5174
19,10504,10,100,0.0001,0.01,0.986,0.9999047981721249,5282,5222
19,10604,10,100,0.0001,0.01,0.982,0.9980196152395322,5336,5268
19,10704,10,100,0.0001,0.01,0.982,0.9988789237668162,5381,5323
19,10804,10,100,0.0001,0.01,0.984,0.9992595335061089,5434,5370
19,10904,10,100,0.0001,0.01,0.982,0.9990829053558328,5489,5415
19,11004,10,100,0.0001,0.01,0.984,0.9984551072337332,5538,5466
19,11104,10,100,0.0001,0.01,0.98,0.9980187319884726,5593,5511
19,11204,10,100,0.0001,0.01,0.988,0.9988397001071047,5654,5550
19,11304,10,100,0.0001,0.01,0.984,0.9989384288747346,5695,5609
19,11404,10,100,0.0001,0.01,0.98,0.9957032620133287,5740,5664
19,11504,10,100,0.0001,0.01,0.99,0.999826147426982,5792,5712
19,11604,10,100,0.0001,0.01,0.986,0.9996552912788693,5837,5767
19,11704,10,100,0.0001,0.01,0.986,1.0,5885,5819
19,11804,10,100,0.0001,0.01,0.986,1.0,5934,5870
19,11904,10,100,0.0001,0.01,0.99,0.9998319892473119,5987,5917
19,12004,10,100,0.0001,0.01,0.986,0.9996667777407531,6036,5968
19,12104,10,100,0.0001,0.01,0.986,0.9987607402511567,6091,6013
19,12204,10,100,0.0001,0.01,0.978,0.9920517862995739,6140,6064
19,12304,10,100,0.0001,0.01,0.978,0.9956111833550065,6190,6114
19,12404,10,100,0.0001,0.01,0.984,0.9941954208319896,6242,6162
19,12504,10,100,0.0001,0.01,0.982,0.9948816378758797,6292,6212
19,12604,10,100,0.0001,0.01,0.99,0.9980165026975564,6341,6263
19,12704,10,100,0.0001,0.01,0.992,0.9996064231738035,6397,6307
19,12804,10,100,0.0001,0.01,0.992,1.0,6441,6363
19,12904,10,100,0.0001,0.01,0.99,0.9997675139491631,6490,6414
19,13004,10,100,0.0001,0.01,0.982,0.998077514610889,6530,6474
19,13104,10,100,0.0001,0.01,0.992,0.9993131868131868,6583,6521
19,13204,10,100,0.0001,0.01,0.984,0.9979551651014844,6629,6575
19,13304,10,100,0.0001,0.01,0.988,0.998346361996392,6677,6627
19,13404,10,100,0.0001,0.01,0.988,0.9961951656222023,6729,6675
19,13504,10,100,0.0001,0.01,0.992,0.998593009478673,6780,6724
19,13604,10,100,0.0001,0.01,0.988,0.9994119376653925,6838,6766
19,13704,10,100,0.0001,0.01,0.982,0.9970081727962639,6878,6826
19,13804,10,100,0.0001,0.01,0.99,0.9994929006085193,6923,6881
19,13904,10,100,0.0001,0.01,0.992,1.0,6971,6933
19,14004,10,100,0.0001,0.01,0.99,1.0,7019,6985
19,14104,10,100,0.0001,0.01,0.99,1.0,7069,7035
19,14204,10,100,0.0001,0.01,0.99,1.0,7113,7091
19,14304,10,100,0.0001,0.01,0.99,1.0,7158,7146
19,14404,10,100,0.0001,0.01,0.99,1.0,7216,7188
19,14504,10,100,0.0001,0.01,0.99,1.0,7269,7235
19,14604,10,100,0.0001,0.01,0.988,1.0,7315,7289
19,14704,10,100,0.0001,0.01,0.992,0.9976196953210011,7356,7348
19,14804,10,100,0.0001,0.01,0.988,0.9962172385841664,7407,7397
19,14904,10,100,0.0001,0.01,0.982,0.9906736446591519,7449,7455
19,15004,10,100,0.0001,0.01,0.988,0.9944014929352173,7495,7509
20,104,10,100,0.0001,0.01,0.51,0.6442307692307693,48,56
20,204,10,100,0.0001,0.01,0.472,0.5245098039215687,99,105
20,304,10,100,0.0001,0.01,0.47,0.6019736842105263,151,153
20,404,10,100,0.0001,0.01,0.516,0.5445544554455446,200,204
20,504,10,100,0.0001,0.01,0.502,0.5873015873015873,256,248
20,604,10,100,0.0001,0.01,0.47,0.6175496688741722,294,310
20,704,10,100,0.0001,0.01,0.504,0.6377840909090909,338,366
20,804,10,100,0.0001,0.01,0.498,0.6256218905472637,383,421
20,904,10,100,0.0001,0.01,0.504,0.6537610619469026,427,477
20,1004,10,100,0.0001,0.01,0.492,0.6822709163346613,476,528
20,1104,10,100,0.0001,0.01,0.468,0.6702898550724637,536,568
20,1204,10,100,0.0001,0.01,0.498,0.7051495016611296,601,603
20,1304,10,100,0.0001,0.01,0.478,0.6855828220858896,648,656
20,1404,10,100,0.0001,0.01,0.472,0.7022792022792023,700,704
20,1504,10,100,0.0001,0.01,0.526,0.7367021276595744,752,752
20,1604,10,100,0.0001,0.01,0.526,0.7630922693266833,803,801
20,1704,10,100,0.0001,0.01,0.492,0.7306338028169014,848,856
20,1804,10,100,0.0001,0.01,0.516,0.7732815964523282,896,908
20,1904,10,100,0.0001,0.01,0.518,0.7715336134453782,952,952
20,2004,10,100,0.0001,0.01,0.51,0.7599800399201597,997,1007
20,2104,10,100,0.0001,0.01,0.526,0.7685361216730038,1046,1058
20,2204,10,100,0.0001,0.01,0.55,0.808076225045372,1084,1120
20,2304,10,100,0.0001,0.01,0.544,0.8259548611111112,1135,1169
20,2404,10,100,0.0001,0.01,0.55,0.8598169717138103,1193,1211
20,2504,10,100,0.0001,0.01,0.576,0.8338658146964856,1245,1259
20,2604,10,100,0.0001,0.01,0.612,0.8552227342549923,1295,1309
20,2704,10,100,0.0001,0.01,0.586,0.8465236686390533,1336,1368
20,2804,10,100,0.0001,0.01,0.61,0.8726818830242511,1387,1417
20,2904,10,100,0.0001,0.01,0.64,0.9073691460055097,1441,1463
20,3004,10,100,0.0001,0.01,0.66,0.9144474034620506,1495,1509
20,3104,10,100,0.0001,0.01,0.648,0.8991623711340206,1545,1559
20,3204,10,100,0.0001,0.01,0.698,0.9185393258426966,1601,1603
20,3304,10,100,0.0001,0.01,0.684,0.9282687651331719,1643,1661
20,3404,10,100,0.0001,0.01,0.714,0.9333137485311398,1698,1706
20,3504,10,100,0.0001,0.01,0.742,0.9372146118721462,1747,1757
20,3604,10,100,0.0001,0.01,0.712,0.9536625971143174,1798,1806
20,3704,10,100,0.0001,0.01,0.766,0.9662526997840173,1844,1860
20,3804,10,100,0.0001,0.01,0.796,0.9718717139852786,1892,1912
20,3904,10,100,0.0001,0.01,0.79,0.9723360655737705,1942,1962
20,4004,10,100,0.0001,0.01,0.802,0.9707792207792207,1993,2011
20,4104,10,100,0.0001,0.01,0.812,0.9751461988304093,2042,2062
20,4204,10,100,0.0001,0.01,0.828,0.9838249286393911,2091,2113
20,4304,10,100,0.0001,0.01,0.832,0.9714219330855018,2141,2163
20,4404,10,100,0.0001,0.01,0.848,0.9775204359673024,2191,2213
20,4504,10,100,0.0001,0.01,0.83,0.9384991119005328,2243,2261
20,4604,10,100,0.0001,0.01,0.866,0.9739357080799305,2293,2311
20,4704,10,100,0.0001,0.01,0.894,0.9902210884353742,2337,2367
20,4804,10,100,0.0001,0.01,0.896,0.9904246461282264,2380,2424
20,4904,10,100,0.0001,0.01,0.92,0.9979608482871125,2430,2474
20,5004,10,100,0.0001,0.01,0.916,0.9990007993605116,2485,2519
20,5104,10,100,0.0001,0.01,0.922,0.9921630094043887,2543,2561
20,5204,10,100,0.0001,0.01,0.918,0.9888547271329746,2586,2618
20,5304,10,100,0.0001,0.01,0.914,0.9960407239819005,2635,2669
20,5404,10,100,0.0001,0.01,0.932,0.9929681717246485,2688,2716
20,5504,10,100,0.0001,0.01,0.932,0.9972747093023255,2730,2774
20,5604,10,100,0.0001,0.01,0.938,0.9985724482512491,2776,2828
20,5704,10,100,0.0001,0.01,0.94,0.9989481065918654,2822,2882
20,5804,10,100,0.0001,0.01,0.942,0.9994831150930393,2873,2931
20,5904,10,100,0.0001,0.01,0.938,0.9988143631436315,2924,2980
20,6004,10,100,0.0001,0.01,0.942,0.998834110592938,2972,3032
20,6104,10,100,0.0001,0.01,0.938,0.9990170380078637,3019,3085
20,6204,10,100,0.0001,0.01,0.954,0.9996776273372018,3076,3128
20,6304,10,100,0.0001,0.01,0.948,0.9990482233502538,3129,3175
20,6404,10,100,0.0001,0.01,0.948,0.9968769519050593,3164,3240
20,6504,10,100,0.0001,0.01,0.938,0.9960024600246002,3217,3287
20,6604,10,100,0.0001,0.01,0.922,0.9848576620230164,3265,3339
20,6704,10,100,0.0001,0.01,0.942,0.9904534606205251,3310,3394
20,6804,10,100,0.0001,0.01,0.932,0.9814814814814815,3365,3439
20,6904,10,100,0.0001,0.01,0.926,0.9879779837775203,3418,3486
20,7004,10,100,0.0001,0.01,0.956,0.9952884066247858,3471,3533
20,7104,10,100,0.0001,0.01,0.958,0.9980292792792793,3524,3580
20,7204,10,100,0.0001,0.01,0.96,0.998611882287618,3584,3620
20,7304,10,100,0.0001,0.01,0.968,0.9998630887185104,3634,3670
20,7404,10,100,0.0001,0.01,0.982,0.9979740680713128,3687,3717
20,7504,10,100,0.0001,0.01,0.972,0.9994669509594882,3733,3771
20,7604,10,100,0.0001,0.01,0.982,0.9989479221462388,3788,3816
20,7704,10,100,0.0001,0.01,0.972,0.9985721703011423,3852,3852
20,7804,10,100,0.0001,0.01,0.966,0.9997437211686314,3903,3901
20,7904,10,100,0.0001,0.01,0.966,0.9983552631578947,3951,3953
20,8004,10,100,0.0001,0.01,0.982,0.9998750624687656,3998,4006
20,8104,10,100,0.0001,0.01,0.972,1.0,4052,4052
20,8204,10,100,0.0001,0.01,0.974,0.999634324719649,4103,4101
20,8304,10,100,0.0001,0.01,0.982,0.997471098265896,4156,4148
20,8404,10,100,0.0001,0.01,0.97,0.9926225606853879,4200,4204
20,8504,10,100,0.0001,0.01,0.972,0.9976481655691439,4259,4245
20,8604,10,100,0.0001,0.01,0.968,0.9931427243142724,4308,4296
20,8704,10,100,0.0001,0.01,0.964,0.9946001838235294,4352,4352
20,8804,10,100,0.0001,0.01,0.982,0.997160381644707,4406,4398
20,8904,10,100,0.0001,0.01,0.986,0.9986522911051213,4459,4445
20,9004,10,100,0.0001,0.01,0.992,0.9978898267436694,4505,4499
20,9104,10,100,0.0001,0.01,0.984,1.0,4548,4556
20,9204,10,100,0.0001,0.01,0.986,1.0,4597,4607
20,9304,10,100,0.0001,0.01,0.984,0.9998925193465176,4652,4652
20,9404,10,100,0.0001,0.01,0.984,1.0,4701,4703
20,9504,10,100,0.0001,0.01,0.986,1.0,4750,4754
20,9604,10,100,0.0001,0.01,0.984,0.9996876301541024,4797,4807
20,9704,10,100,0.0001,0.01,0.982,0.9997938994229184,4853,4851
20,9804,10,100,0.0001,0.01,0.98,0.994594043247654,4895,4909
20,9904,10,100,0.0001,0.01,0.968,0.9907108239095315,4946,4958
20,10004,10,100,0.0001,0.01,0.958,0.9752099160335865,4993,5011
20,10104,10,100,0.0001,0.01,0.986,0.9958432304038005,5046,5058
20,10204,10,100,0.0001,0.01,0.98,0.9924539396315171,5096,5108
20,10304,10,100,0.0001,0.01,0.986,0.9938858695652174,5138,5166
20,10404,10,100,0.0001,0.01,0.992,0.9986543637062668,5177,5227
20,10504,10,100,0.0001,0.01,0.992,0.9994287890327495,5224,5280
20,10604,10,100,0.0001,0.01,0.994,0.9997170878913617,5279,5325
20,10704,10,100,0.0001,0.01,0.992,1.0,5332,5372
20,10804,10,100,0.0001,0.01,0.992,1.0,5383,5421
20,10904,10,100,0.0001,0.01,0.992,1.0,5442,5462
20,11004,10,100,0.0001,0.01,0.99,0.9995456197746274,5492,5512
20,11104,10,100,0.0001,0.01,0.988,0.9992795389048992,5540,5564
20,11204,10,100,0.0001,0.01,0.994,0.9996429846483399,5592,5612
20,11304,10,100,0.0001,0.01,0.994,1.0,5645,5659
20,11404,10,100,0.0001,0.01,0.994,0.9999123114696598,5696,5708
20,11504,10,100,0.0001,0.01,0.994,1.0,5749,5755
20,11604,10,100,0.0001,0.01,0.992,0.9995691140985867,5803,5801
20,11704,10,100,0.0001,0.01,0.994,0.9937628161312372,5862,5842
20,11804,10,100,0.0001,0.01,0.986,0.9963571670620128,5910,5894
20,11904,10,100,0.0001,0.01,0.986,0.9966397849462365,5953,5951
20,12004,10,100,0.0001,0.01,0.99,0.9986671109630123,6009,5995
20,12104,10,100,0.0001,0.01,0.986,0.9971910112359551,6069,6035
20,12204,10,100,0.0001,0.01,0.986,0.9965585054080629,6131,6073
20,12304,10,100,0.0001,0.01,0.99,0.9981306892067621,6186,6118
20,12404,10,100,0.0001,0.01,0.986,0.9987100935182199,6235,6169
20,12504,10,100,0.0001,0.01,0.99,0.9996801023672425,6292,6212
20,12604,10,100,0.0001,0.01,0.994,0.9999206601079023,6335,6269
20,12704,10,100,0.0001,0.01,0.996,0.9999212846347607,6387,6317
20,12804,10,100,0.0001,0.01,0.996,1.0,6435,6369
20,12904,10,100,0.0001,0.01,0.998,0.9997675139491631,6485,6419
20,13004,10,100,0.0001,0.01,0.996,1.0,6533,6471
20,13104,10,100,0.0001,0.01,0.996,1.0,6583,6521
20,13204,10,100,0.0001,0.01,0.996,1.0,6631,6573
20,13304,10,100,0.0001,0.01,0.992,0.9998496692723993,6675,6629
20,13404,10,100,0.0001,0.01,0.994,1.0,6722,6682
20,13504,10,100,0.0001,0.01,0.994,1.0,6777,6727
20,13604,10,100,0.0001,0.01,0.996,0.9992649220817407,6826,6778
20,13704,10,100,0.0001,0.01,0.976,0.9794220665499125,6868,6836
20,13804,10,100,0.0001,0.01,0.986,0.9906548826427123,6914,6890
20,13904,10,100,0.0001,0.01,0.994,0.9986334867663982,6966,6938
20,14004,10,100,0.0001,0.01,0.996,0.9990002856326764,7015,6989
20,14104,10,100,0.0001,0.01,1.0,0.9998581962563812,7071,7033
20,14204,10,100,0.0001,0.01,0.994,0.9996479864826809,7128,7076
20,14304,10,100,0.0001,0.01,0.998,0.9998601789709173,7169,7135
20,14404,10,100,0.0001,0.01,0.998,0.9999305748403221,7222,7182
20,14504,10,100,0.0001,0.01,1.0,0.9995173745173745,7277,7227
20,14604,10,100,0.0001,0.01,0.996,0.9984250890167078,7323,7281
20,14704,10,100,0.0001,0.01,0.998,0.9995919477693145,7375,7329
20,14804,10,100,0.0001,0.01,0.996,0.9980410699810862,7416,7388
20,14904,10,100,0.0001,0.01,0.998,0.9993290391841116,7465,7439
20,15004,10,100,0.0001,0.01,0.998,0.9998667022127433,7515,7489
1,104,10,100,0.001,0.01,0.512,0.5673076923076923,58,46
1,204,10,100,0.001,0.01,0.514,0.5931372549019608,114,90
1,304,10,100,0.001,0.01,0.492,0.631578947368421,168,136
1,404,10,100,0.001,0.01,0.488,0.5198019801980198,210,194
1,504,10,100,0.001,0.01,0.47,0.5734126984126984,260,244
1,604,10,100,0.001,0.01,0.502,0.6109271523178808,316,288
1,704,10,100,0.001,0.01,0.53,0.6122159090909091,370,334
1,804,10,100,0.001,0.01,0.5,0.6243781094527363,417,387
1,904,10,100,0.001,0.01,0.504,0.6283185840707964,470,434
1,1004,10,100,0.001,0.01,0.504,0.6573705179282868,519,485
1,1104,10,100,0.001,0.01,0.488,0.6739130434782609,571,533
1,1204,10,100,0.001,0.01,0.544,0.6602990033222591,621,583
1,1304,10,100,0.001,0.01,0.522,0.674079754601227,679,625
1,1404,10,100,0.001,0.01,0.51,0.6723646723646723,724,680
1,1504,10,100,0.001,0.01,0.534,0.644281914893617,787,717
1,1604,10,100,0.001,0.01,0.568,0.690149625935162,840,764
1,1704,10,100,0.001,0.01,0.558,0.7259389671361502,890,814
1,1804,10,100,0.001,0.01,0.572,0.7566518847006651,939,865
1,1904,10,100,0.001,0.01,0.586,0.7484243697478992,997,907
1,2004,10,100,0.001,0.01,0.612,0.7889221556886228,1040,964
1,2104,10,100,0.001,0.01,0.594,0.8046577946768061,1087,1017
1,2204,10,100,0.001,0.01,0.612,0.7912885662431942,1142,1062
1,2304,10,100,0.001,0.01,0.626,0.7751736111111112,1189,1115
1,2404,10,100,0.001,0.01,0.62,0.7774542429284526,1236,1168
1,2504,10,100,0.001,0.01,0.7,0.8298722044728435,1289,1215
1,2604,10,100,0.001,0.01,0.684,0.8283410138248848,1339,1265
1,2704,10,100,0.001,0.01,0.73,0.8905325443786982,1388,1316
1,2804,10,100,0.001,0.01,0.68,0.8637660485021398,1437,1367
1,2904,10,100,0.001,0.01,0.73,0.8694903581267218,1489,1415
1,3004,10,100,0.001,0.01,0.726,0.9051264980026631,1547,1457
1,3104,10,100,0.001,0.01,0.748,0.9165592783505154,1594,1510
1,3204,10,100,0.001,0.01,0.77,0.918227215980025,1645,1559
1,3304,10,100,0.001,0.01,0.768,0.8858958837772397,1699,1605
1,3404,10,100,0.001,0.01,0.778,0.8980611045828437,1759,1645
1,3504,10,100,0.001,0.01,0.782,0.9126712328767124,1807,1697
1,3604,10,100,0.001,0.01,0.794,0.9317425083240843,1856,1748
1,3704,10,100,0.001,0.01,0.806,0.9422246220302376,1906,1798
1,3804,10,100,0.001,0.01,0.844,0.96267087276551,1952,1852
1,3904,10,100,0.001,0.01,0.852,0.9792520491803278,1995,1909
1,4004,10,100,0.001,0.01,0.828,0.9517982017982018,2043,1961
1,4104,10,100,0.001,0.01,0.826,0.9446881091617934,2086,2018
1,4204,10,100,0.001,0.01,0.836,0.9538534728829686,2139,2065
1,4304,10,100,0.001,0.01,0.878,0.970957249070632,2190,2114
1,4404,10,100,0.001,0.01,0.868,0.9795640326975477,2242,2162
1,4504,10,100,0.001,0.01,0.866,0.9722468916518651,2285,2219
1,4604,10,100,0.001,0.01,0.858,0.9580799304952216,2336,2268
1,4704,10,100,0.001,0.01,0.882,0.9551445578231292,2393,2311
1,4804,10,100,0.001,0.01,0.86,0.9575353871773522,2439,2365
1,4904,10,100,0.001,0.01,0.876,0.9647226753670473,2491,2413
1,5004,10,100,0.001,0.01,0.898,0.9702238209432454,2539,2465
1,5104,10,100,0.001,0.01,0.908,0.9884404388714734,2578,2526
1,5204,10,100,0.001,0.01,0.916,0.995196003074558,2625,2579
1,5304,10,100,0.001,0.01,0.918,0.9969834087481146,2678,2626
1,5404,10,100,0.001,0.01,0.934,0.9951887490747594,2731,2673
1,5504,10,100,0.001,0.01,0.922,0.9981831395348837,2765,2739
1,5604,10,100,0.001,0.01,0.932,0.9987508922198429,2812,2792
1,5704,10,100,0.001,0.01,0.936,0.9973702664796634,2859,2845
1,5804,10,100,0.001,0.01,0.932,0.9965541006202618,2909,2895
1,5904,10,100,0.001,0.01,0.936,0.9967818428184282,2962,2942
1,6004,10,100,0.001,0.01,0.946,0.9926715522984677,3009,2995
1,6104,10,100,0.001,0.01,0.946,0.9937745740498034,3056,3048
1,6204,10,100,0.001,0.01,0.936,0.9935525467440361,3109,3095
1,6304,10,100,0.001,0.01,0.944,0.9963515228426396,3160,3144
1,6404,10,100,0.001,0.01,0.946,0.9982823235477827,3206,3198
1,6504,10,100,0.001,0.01,0.94,0.9970787207872078,3258,3246
1,6604,10,100,0.001,0.01,0.934,0.9868261659600243,3308,3296
1,6704,10,100,0.001,0.01,0.914,0.9710620525059666,3359,3345
1,6804,10,100,0.001,0.01,0.932,0.9847148736037625,3418,3386
1,6904,10,100,0.001,0.01,0.962,0.9952201622247973,3477,3427
1,7004,10,100,0.001,0.01,0.966,0.9957167332952599,3530,3474
1,7104,10,100,0.001,0.01,0.958,0.9963400900900901,3580,3524
1,7204,10,100,0.001,0.01,0.952,0.991671293725708,3634,3570
1,7304,10,100,0.001,0.01,0.956,0.9968510405257394,3682,3622
1,7404,10,100,0.001,0.01,0.96,0.9923014586709886,3726,3678
1,7504,10,100,0.001,0.01,0.962,0.9946695095948828,3771,3733
1,7604,10,100,0.001,0.01,0.954,0.9959231983166754,3817,3787
1,7704,10,100,0.001,0.01,0.966,0.9979231568016614,3863,3841
1,7804,10,100,0.001,0.01,0.968,0.998077908764736,3916,3888
1,7904,10,100,0.001,0.01,0.968,0.9986082995951417,3966,3938
1,8004,10,100,0.001,0.01,0.968,0.999000499750125,4009,3995
1,8104,10,100,0.001,0.01,0.974,0.9995064165844028,4060,4044
1,8204,10,100,0.001,0.01,0.972,0.999512432959532,4111,4093
1,8304,10,100,0.001,0.01,0.972,0.9967485549132948,4160,4144
1,8404,10,100,0.001,0.01,0.968,0.9904807234650167,4213,4191
1,8504,10,100,0.001,0.01,0.96,0.9869473189087489,4262,4242
1,8604,10,100,0.001,0.01,0.958,0.9937238493723849,4311,4293
1,8704,10,100,0.001,0.01,0.966,0.9947150735294118,4353,4351
1,8804,10,100,0.001,0.01,0.966,0.9937528396183553,4407,4397
1,8904,10,100,0.001,0.01,0.978,0.996967654986523,4456,4448
1,9004,10,100,0.001,0.01,0.974,0.9985561972456686,4497,4507
1,9104,10,100,0.001,0.01,0.974,0.9992311072056239,4554,4550
1,9204,10,100,0.001,0.01,0.966,0.9967405475880052,4602,4602
1,9304,10,100,0.001,0.01,0.98,0.9981728288907996,4653,4651
1,9404,10,100,0.001,0.01,0.974,0.9988302849851127,4694,4710
1,9504,10,100,0.001,0.01,0.974,0.9980008417508418,4747,4757
1,9604,10,100,0.001,0.01,0.97,0.9976051645147855,4795,4809
1,9704,10,100,0.001,0.01,0.978,0.9962901896125309,4844,4860
1,9804,10,100,0.001,0.01,0.972,0.9983680130558955,4886,4918
1,9904,10,100,0.001,0.01,0.97,0.9965670436187399,4931,4973
1,10004,10,100,0.001,0.01,0.97,0.9941023590563774,4980,5024
1,10104,10,100,0.001,0.01,0.966,0.9923792557403008,5018,5086
1,10204,10,100,0.001,0.01,0.948,0.9784398275186201,5072,5132
1,10304,10,100,0.001,0.01,0.97,0.9914596273291926,5128,5176
1,10404,10,100,0.001,0.01,0.976,0.9953863898500577,5167,5237
1,10504,10,100,0.001,0.01,0.978,0.9974295506473724,5221,5283
1,10604,10,100,0.001,0.01,0.986,0.9993398717465107,5265,5339
1,10704,10,100,0.001,0.01,0.98,0.9966367713004485,5318,5386
1,10804,10,100,0.001,0.01,0.976,0.9975009255831173,5375,5429
1,10904,10,100,0.001,0.01,0.986,0.998624358033749,5423,5481
1,11004,10,100,0.001,0.01,0.984,1.0,5486,5518
1,11104,10,100,0.001,0.01,0.986,0.9999099423631124,5548,5556
1,11204,10,100,0.001,0.01,0.98,0.9972331310246341,5606,5598
1,11304,10,100,0.001,0.01,0.98,0.9992038216560509,5659,5645
1,11404,10,100,0.001,0.01,0.98,0.9985969835145563,5709,5695
1,11504,10,100,0.001,0.01,0.974,0.9969575799721836,5751,5753
1,11604,10,100,0.001,0.01,0.984,0.9968976215098242,5802,5802
1,11704,10,100,0.001,0.01,0.98,0.9904306220095693,5853,5851
1,11804,10,100,0.001,0.01,0.966,0.9890715011860386,5907,5897
1,11904,10,100,0.001,0.01,0.974,0.9959677419354839,5964,5940
1,12004,10,100,0.001,0.01,0.986,0.9973342219260246,6023,5981
1,12104,10,100,0.001,0.01,0.99,0.9995042961004627,6073,6031
1,12204,10,100,0.001,0.01,0.99,0.999918059652573,6116,6088
1,12304,10,100,0.001,0.01,0.99,0.9999187256176854,6158,6146
1,12404,10,100,0.001,0.01,0.992,0.9999193808448887,6211,6193
1,12504,10,100,0.001,0.01,0.99,0.9979206653870761,6262,6242
1,12604,10,100,0.001,0.01,0.99,0.9997619803237068,6320,6284
1,12704,10,100,0.001,0.01,0.992,0.999448992443325,6364,6340
1,12804,10,100,0.001,0.01,0.994,0.9989065916900969,6415,6389
1,12904,10,100,0.001,0.01,0.99,0.9996125232486051,6464,6440
1,13004,10,100,0.001,0.01,0.988,0.9990003075976622,6515,6489
1,13104,10,100,0.001,0.01,0.986,0.9967185592185592,6563,6541
1,13204,10,100,0.001,0.01,0.984,0.9922750681611633,6613,6591
1,13304,10,100,0.001,0.01,0.978,0.9902285027059531,6661,6643
1,13404,10,100,0.001,0.01,0.978,0.990152193375112,6708,6696
1,13504,10,100,0.001,0.01,0.976,0.9889662322274881,6757,6747
1,13604,10,100,0.001,0.01,0.994,0.9980887974125258,6809,6795
1,13704,10,100,0.001,0.01,0.992,0.9989054290718039,6863,6841
1,13804,10,100,0.001,0.01,0.992,0.9997102289191538,6915,6889
1,13904,10,100,0.001,0.01,0.99,0.9992807825086306,6968,6936
1,14004,10,100,0.001,0.01,0.994,1.0,7023,6981
1,14104,10,100,0.001,0.01,0.994,0.9999290981281905,7070,7034
1,14204,10,100,0.001,0.01,0.99,0.9970430864545199,7112,7092
1,14304,10,100,0.001,0.01,0.994,0.9993008948545862,7162,7142
1,14404,10,100,0.001,0.01,0.994,0.9996528742016106,7208,7196
1,14504,10,100,0.001,0.01,0.994,1.0,7255,7249
1,14604,10,100,0.001,0.01,0.994,1.0,7302,7302
1,14704,10,100,0.001,0.01,0.994,1.0,7351,7353
1,14804,10,100,0.001,0.01,0.994,0.9997298027560119,7397,7407
1,14904,10,100,0.001,0.01,0.994,0.9979200214707461,7445,7459
1,15004,10,100,0.001,0.01,0.986,0.9906025059984004,7496,7508
2,104,10,100,0.001,0.01,0.51,0.5192307692307693,53,51
2,204,10,100,0.001,0.01,0.516,0.6764705882352942,99,105
2,304,10,100,0.001,0.01,0.524,0.6513157894736842,142,162
2,404,10,100,0.001,0.01,0.52,0.6683168316831684,189,215
2,504,10,100,0.001,0.01,0.532,0.6388888888888888,241,263
2,604,10,100,0.001,0.01,0.518,0.6639072847682119,295,309
2,704,10,100,0.001,0.01,0.508,0.6434659090909091,338,366
2,804,10,100,0.001,0.01,0.48,0.6268656716417911,388,416
2,904,10,100,0.001,0.01,0.474,0.6194690265486725,439,465
2,1004,10,100,0.001,0.01,0.448,0.6324701195219123,489,515
2,1104,10,100,0.001,0.01,0.456,0.6539855072463768,537,567
2,1204,10,100,0.001,0.01,0.47,0.6868770764119602,589,615
2,1304,10,100,0.001,0.01,0.484,0.6932515337423313,639,665
2,1404,10,100,0.001,0.01,0.468,0.6908831908831908,689,715
2,1504,10,100,0.001,0.01,0.508,0.706781914893617,734,770
2,1604,10,100,0.001,0.01,0.478,0.7549875311720698,784,820
2,1704,10,100,0.001,0.01,0.46,0.7400234741784038,834,870
2,1804,10,100,0.001,0.01,0.476,0.7760532150776053,885,919
2,1904,10,100,0.001,0.01,0.49,0.7531512605042017,927,977
2,2004,10,100,0.001,0.01,0.484,0.7799401197604791,977,1027
2,2104,10,100,0.001,0.01,0.524,0.785171102661597,1026,1078
2,2204,10,100,0.001,0.01,0.494,0.7831215970961888,1079,1125
2,2304,10,100,0.001,0.01,0.528,0.7599826388888888,1126,1178
2,2404,10,100,0.001,0.01,0.544,0.81738768718802,1179,1225
2,2504,10,100,0.001,0.01,0.56,0.8206869009584664,1233,1271
2,2604,10,100,0.001,0.01,0.554,0.8344854070660522,1282,1322
2,2704,10,100,0.001,0.01,0.598,0.860207100591716,1338,1366
2,2804,10,100,0.001,0.01,0.584,0.8723252496433667,1386,1418
2,2904,10,100,0.001,0.01,0.626,0.8991046831955923,1439,1465
2,3004,10,100,0.001,0.01,0.634,0.9181091877496671,1492,1512
2,3104,10,100,0.001,0.01,0.646,0.9255798969072165,1538,1566
2,3204,10,100,0.001,0.01,0.688,0.9288389513108615,1589,1615
2,3304,10,100,0.001,0.01,0.682,0.9309927360774818,1636,1668
2,3404,10,100,0.001,0.01,0.716,0.9341950646298472,1681,1723
2,3504,10,100,0.001,0.01,0.704,0.9306506849315068,1738,1766
2,3604,10,100,0.001,0.01,0.736,0.959211986681465,1785,1819
2,3704,10,100,0.001,0.01,0.724,0.9751619870410367,1837,1867
2,3804,10,100,0.001,0.01,0.746,0.9802839116719243,1891,1913
2,3904,10,100,0.001,0.01,0.782,0.9853995901639344,1943,1961
2,4004,10,100,0.001,0.01,0.776,0.99000999000999,1997,2007
2,4104,10,100,0.001,0.01,0.798,0.9914717348927875,2053,2051
2,4204,10,100,0.001,0.01,0.77,0.9726450999048525,2100,2104
2,4304,10,100,0.001,0.01,0.786,0.9530669144981413,2150,2154
2,4404,10,100,0.001,0.01,0.81,0.9648047229791099,2207,2197
2,4504,10,100,0.001,0.01,0.822,0.9731349911190054,2254,2250
2,4604,10,100,0.001,0.01,0.818,0.987619461337967,2303,2301
2,4704,10,100,0.001,0.01,0.836,0.9944727891156463,2343,2361
2,4804,10,100,0.001,0.01,0.842,0.9956286427976686,2397,2407
2,4904,10,100,0.001,0.01,0.866,0.9967373572593801,2448,2456
2,5004,10,100,0.001,0.01,0.84,0.9882094324540368,2509,2495
2,5104,10,100,0.001,0.01,0.844,0.9921630094043887,2559,2545
2,5204,10,100,0.001,0.01,0.866,0.9944273635664873,2612,2592
2,5304,10,100,0.001,0.01,0.888,0.9962292609351433,2669,2635
2,5404,10,100,0.001,0.01,0.888,0.9918578830495929,2725,2679
2,5504,10,100,0.001,0.01,0.888,0.9880087209302325,2771,2733
2,5604,10,100,0.001,0.01,0.878,0.9882226980728052,2830,2774
2,5704,10,100,0.001,0.01,0.892,0.990007012622721,2886,2818
2,5804,10,100,0.001,0.01,0.898,0.9939696760854583,2935,2869
2,5904,10,100,0.001,0.01,0.904,0.9911924119241192,2985,2919
2,6004,10,100,0.001,0.01,0.904,0.9938374417055297,3039,2965
2,6104,10,100,0.001,0.01,0.91,0.9949213630406291,3093,3011
2,6204,10,100,0.001,0.01,0.91,0.9921018697614442,3140,3064
2,6304,10,100,0.001,0.01,0.912,0.9933375634517766,3190,3114
2,6404,10,100,0.001,0.01,0.924,0.9957838850718301,3235,3169
2,6504,10,100,0.001,0.01,0.926,0.995079950799508,3286,3218
2,6604,10,100,0.001,0.01,0.922,0.994397334948516,3334,3270
2,6704,10,100,0.001,0.01,0.918,0.9913484486873508,3385,3319
2,6804,10,100,0.001,0.01,0.926,0.9861845972957084,3438,3366
2,6904,10,100,0.001,0.01,0.932,0.994351100811124,3483,3421
2,7004,10,100,0.001,0.01,0.946,0.9967161621930326,3526,3478
2,7104,10,100,0.001,0.01,0.926,0.9881756756756757,3568,3536
2,7204,10,100,0.001,0.01,0.948,0.9918101054969461,3614,3590
2,7304,10,100,0.001,0.01,0.934,0.9923329682365827,3658,3646
2,7404,10,100,0.001,0.01,0.944,0.9947325769854133,3707,3697
2,7504,10,100,0.001,0.01,0.956,0.9988006396588486,3747,3757
2,7604,10,100,0.001,0.01,0.962,0.9976328248290374,3788,3816
2,7704,10,100,0.001,0.01,0.962,0.9985721703011423,3833,3871
2,7804,10,100,0.001,0.01,0.962,0.9994874423372629,3877,3927
2,7904,10,100,0.001,0.01,0.958,0.9989878542510121,3918,3986
2,8004,10,100,0.001,0.01,0.954,0.9982508745627187,3964,4040
2,8104,10,100,0.001,0.01,0.964,0.9987660414610069,4021,4083
2,8204,10,100,0.001,0.01,0.966,0.9992686494392979,4073,4131
2,8304,10,100,0.001,0.01,0.968,0.9998795761078998,4122,4182
2,8404,10,100,0.001,0.01,0.966,0.9994050452165636,4173,4231
2,8504,10,100,0.001,0.01,0.962,0.9954139228598307,4229,4275
2,8604,10,100,0.001,0.01,0.948,0.9959321245932125,4280,4324
2,8704,10,100,0.001,0.01,0.95,0.9875919117647058,4333,4371
2,8804,10,100,0.001,0.01,0.958,0.9895502044525216,4385,4419
2,8904,10,100,0.001,0.01,0.928,0.9558625336927223,4430,4474
2,9004,10,100,0.001,0.01,0.944,0.9834517992003554,4486,4518
2,9104,10,100,0.001,0.01,0.968,0.9907732864674869,4536,4568
2,9204,10,100,0.001,0.01,0.97,0.9955454150369405,4593,4611
2,9304,10,100,0.001,0.01,0.976,0.9980653482373173,4639,4665
2,9404,10,100,0.001,0.01,0.972,0.998192258613356,4695,4709
2,9504,10,100,0.001,0.01,0.982,0.9981060606060606,4752,4752
2,9604,10,100,0.001,0.01,0.976,0.9973969179508538,4808,4796
2,9704,10,100,0.001,0.01,0.974,0.9984542456718879,4863,4841
2,9804,10,100,0.001,0.01,0.972,0.9992860057119543,4913,4891
2,9904,10,100,0.001,0.01,0.964,0.991013731825525,4964,4940
2,10004,10,100,0.001,0.01,0.986,0.999000399840064,5009,4995
2,10104,10,100,0.001,0.01,0.984,0.9946555819477435,5073,5031
2,10204,10,100,0.001,0.01,0.968,0.9867698941591533,5124,5080
2,10304,10,100,0.001,0.01,0.984,0.9957298136645962,5177,5127
2,10404,10,100,0.001,0.01,0.972,0.9954825067281815,5225,5179
2,10504,10,100,0.001,0.01,0.986,0.996953541507997,5289,5215
2,10604,10,100,0.001,0.01,0.988,0.9987740475292343,5341,5263
2,10704,10,100,0.001,0.01,0.988,0.9995328849028401,5390,5314
2,10804,10,100,0.001,0.01,0.986,0.9999074416882636,5430,5374
2,10904,10,100,0.001,0.01,0.984,0.9996331621423331,5475,5429
2,11004,10,100,0.001,0.01,0.982,0.999818247909851,5524,5480
2,11104,10,100,0.001,0.01,0.984,0.9999099423631124,5570,5534
2,11204,10,100,0.001,0.01,0.98,0.9992859692966798,5617,5587
2,11304,10,100,0.001,0.01,0.984,0.9990268931351733,5667,5637
2,11404,10,100,0.001,0.01,0.982,0.9991231146965976,5717,5687
2,11504,10,100,0.001,0.01,0.976,0.9962621696801113,5763,5741
2,11604,10,100,0.001,0.01,0.972,0.9942261289210617,5805,5799
2,11704,10,100,0.001,0.01,0.966,0.9894907723855092,5857,5847
2,11804,10,100,0.001,0.01,0.98,0.9971196204676381,5903,5901
2,11904,10,100,0.001,0.01,0.986,0.9994959677419355,5950,5954
2,12004,10,100,0.001,0.01,0.992,0.9996667777407531,6001,6003
2,12104,10,100,0.001,0.01,0.982,0.999256444150694,6050,6054
2,12204,10,100,0.001,0.01,0.988,0.9998361193051458,6100,6104
2,12304,10,100,0.001,0.01,0.986,0.9998374512353706,6152,6152
2,12404,10,100,0.001,0.01,0.976,0.9975814253466624,6202,6202
2,12504,10,100,0.001,0.01,0.988,0.9990403071017274,6252,6252
2,12604,10,100,0.001,0.01,0.994,0.9993652808632181,6302,6302
2,12704,10,100,0.001,0.01,0.99,0.9985044080604534,6353,6351
2,12804,10,100,0.001,0.01,0.988,0.9985941893158388,6411,6393
2,12904,10,100,0.001,0.01,0.99,0.9965902045877247,6464,6440
2,13004,10,100,0.001,0.01,0.99,0.9960781298062135,6508,6496
2,13104,10,100,0.001,0.01,0.98,0.9943528693528694,6556,6548
2,13204,10,100,0.001,0.01,0.984,0.9981066343532263,6604,6600
2,13304,10,100,0.001,0.01,0.988,0.9993986770895971,6662,6642
2,13404,10,100,0.001,0.01,0.986,0.9989555356609967,6716,6688
2,13504,10,100,0.001,0.01,0.992,0.9999259478672986,6768,6736
2,13604,10,100,0.001,0.01,0.99,0.9999264922081741,6821,6783
2,13704,10,100,0.001,0.01,0.992,1.0,6878,6826
2,13804,10,100,0.001,0.01,0.992,0.9999275572297884,6934,6870
2,13904,10,100,0.001,0.01,0.992,0.9989930955120828,6984,6920
2,14004,10,100,0.001,0.01,0.986,0.9942159383033419,7029,6975
2,14104,10,100,0.001,0.01,0.972,0.9924134997163925,7075,7029
2,14204,10,100,0.001,0.01,0.98,0.9945085891298225,7130,7074
2,14304,10,100,0.001,0.01,0.986,0.9985318791946308,7180,7124
2,14404,10,100,0.001,0.01,0.992,0.9998611496806442,7237,7167
2,14504,10,100,0.001,0.01,0.992,0.9995863210148924,7278,7226
2,14604,10,100,0.001,0.01,0.99,0.9999315256094221,7329,7275
2,14704,10,100,0.001,0.01,0.994,1.0,7374,7330
2,14804,10,100,0.001,0.01,0.994,1.0,7414,7390
2,14904,10,100,0.001,0.01,0.994,1.0,7466,7438
2,15004,10,100,0.001,0.01,0.994,0.9998000533191149,7510,7494
3,104,10,100,0.001,0.01,0.488,0.5673076923076923,59,45
3,204,10,100,0.001,0.01,0.504,0.5931372549019608,106,98
3,304,10,100,0.001,0.01,0.498,0.5427631578947368,163,141
3,404,10,100,0.001,0.01,0.482,0.5816831683168316,214,190
3,504,10,100,0.001,0.01,0.486,0.5515873015873016,264,240
3,604,10,100,0.001,0.01,0.492,0.5927152317880795,312,292
3,704,10,100,0.001,0.01,0.484,0.5994318181818182,360,344
3,804,10,100,0.001,0.01,0.508,0.6131840796019901,415,389
3,904,10,100,0.001,0.01,0.502,0.6382743362831859,467,437
3,1004,10,100,0.001,0.01,0.482,0.6802788844621513,513,491
3,1104,10,100,0.001,0.01,0.482,0.6358695652173914,556,548
3,1204,10,100,0.001,0.01,0.496,0.675249169435216,604,600
3,1304,10,100,0.001,0.01,0.506,0.6595092024539877,653,651
3,1404,10,100,0.001,0.01,0.488,0.698005698005698,694,710
3,1504,10,100,0.001,0.01,0.504,0.6901595744680851,739,765
3,1604,10,100,0.001,0.01,0.506,0.7001246882793017,796,808
3,1704,10,100,0.001,0.01,0.498,0.7417840375586855,841,863
3,1804,10,100,0.001,0.01,0.516,0.7544345898004434,889,915
3,1904,10,100,0.001,0.01,0.544,0.7615546218487395,949,955
3,2004,10,100,0.001,0.01,0.542,0.7759481037924152,1001,1003
3,2104,10,100,0.001,0.01,0.56,0.776615969581749,1047,1057
3,2204,10,100,0.001,0.01,0.552,0.7849364791288567,1104,1100
3,2304,10,100,0.001,0.01,0.594,0.8172743055555556,1156,1148
3,2404,10,100,0.001,0.01,0.596,0.8090682196339434,1209,1195
3,2504,10,100,0.001,0.01,0.646,0.810702875399361,1257,1247
3,2604,10,100,0.001,0.01,0.63,0.8325652841781874,1310,1294
3,2704,10,100,0.001,0.01,0.628,0.8398668639053254,1372,1332
3,2804,10,100,0.001,0.01,0.678,0.8698288159771754,1417,1387
3,2904,10,100,0.001,0.01,0.698,0.8942837465564738,1472,1432
3,3004,10,100,0.001,0.01,0.674,0.9041278295605859,1526,1478
3,3104,10,100,0.001,0.01,0.72,0.907860824742268,1569,1535
3,3204,10,100,0.001,0.01,0.73,0.9288389513108615,1613,1591
3,3304,10,100,0.001,0.01,0.772,0.9225181598062954,1673,1631
3,3404,10,100,0.001,0.01,0.788,0.9488836662749707,1731,1673
3,3504,10,100,0.001,0.01,0.824,0.9628995433789954,1782,1722
3,3604,10,100,0.001,0.01,0.812,0.9714206437291898,1826,1778
3,3704,10,100,0.001,0.01,0.802,0.9703023758099352,1875,1829
3,3804,10,100,0.001,0.01,0.816,0.9781808622502629,1928,1876
3,3904,10,100,0.001,0.01,0.826,0.9820696721311475,1981,1923
3,4004,10,100,0.001,0.01,0.82,0.9727772227772228,2027,1977
3,4104,10,100,0.001,0.01,0.846,0.9826998050682261,2079,2025
3,4204,10,100,0.001,0.01,0.836,0.972407231208373,2135,2069
3,4304,10,100,0.001,0.01,0.87,0.9851301115241635,2189,2115
3,4404,10,100,0.001,0.01,0.87,0.9906902815622162,2238,2166
3,4504,10,100,0.001,0.01,0.874,0.9935612788632326,2290,2214
3,4604,10,100,0.001,0.01,0.884,0.9950043440486533,2337,2267
3,4704,10,100,0.001,0.01,0.864,0.9946853741496599,2386,2318
3,4804,10,100,0.001,0.01,0.878,0.9966694421315571,2430,2374
3,4904,10,100,0.001,0.01,0.888,0.9971451876019576,2483,2421
3,5004,10,100,0.001,0.01,0.882,0.9958033573141487,2527,2477
3,5104,10,100,0.001,0.01,0.88,0.9911833855799373,2577,2527
3,5204,10,100,0.001,0.01,0.878,0.9934665641813989,2621,2583
3,5304,10,100,0.001,0.01,0.876,0.9964177978883861,2674,2630
3,5404,10,100,0.001,0.01,0.892,0.9953737971872687,2717,2687
3,5504,10,100,0.001,0.01,0.892,0.990734011627907,2779,2725
3,5604,10,100,0.001,0.01,0.882,0.9910778015703069,2825,2779
3,5704,10,100,0.001,0.01,0.882,0.9894810659186536,2872,2832
3,5804,10,100,0.001,0.01,0.888,0.9867332873880083,2915,2889
3,5904,10,100,0.001,0.01,0.878,0.9830623306233063,2958,2946
3,6004,10,100,0.001,0.01,0.912,0.9903397734843438,3006,2998
3,6104,10,100,0.001,0.01,0.912,0.9955766710353866,3053,3051
3,6204,10,100,0.001,0.01,0.916,0.996776273372018,3094,3110
3,6304,10,100,0.001,0.01,0.908,0.9923857868020305,3149,3155
3,6404,10,100,0.001,0.01,0.912,0.9939100562148657,3207,3197
3,6504,10,100,0.001,0.01,0.906,0.9958487084870848,3248,3256
3,6604,10,100,0.001,0.01,0.908,0.9950030284675954,3300,3304
3,6704,10,100,0.001,0.01,0.916,0.9968675417661098,3353,3351
3,6804,10,100,0.001,0.01,0.922,0.9964726631393298,3412,3392
3,6904,10,100,0.001,0.01,0.93,0.9959443800695249,3460,3444
3,7004,10,100,0.001,0.01,0.918,0.9930039977155911,3498,3506
3,7104,10,100,0.001,0.01,0.944,0.9871903153153153,3554,3550
3,7204,10,100,0.001,0.01,0.95,0.9925041643531372,3608,3596
3,7304,10,100,0.001,0.01,0.95,0.9909638554216867,3666,3638
3,7404,10,100,0.001,0.01,0.942,0.9893300918422474,3719,3685
3,7504,10,100,0.001,0.01,0.946,0.9938699360341151,3779,3725
3,7604,10,100,0.001,0.01,0.954,0.9957916885849553,3819,3785
3,7704,10,100,0.001,0.01,0.954,0.9966251298026999,3874,3830
3,7804,10,100,0.001,0.01,0.944,0.979625832906202,3924,3880
3,7904,10,100,0.001,0.01,0.934,0.9682439271255061,3982,3922
3,8004,10,100,0.001,0.01,0.954,0.9886306846576711,4039,3965
3,8104,10,100,0.001,0.01,0.964,0.9949407699901284,4086,4018
3,8204,10,100,0.001,0.01,0.966,0.9987810823988298,4137,4067
3,8304,10,100,0.001,0.01,0.966,0.9989161849710982,4178,4126
3,8404,10,100,0.001,0.01,0.968,0.9995240361732508,4228,4176
3,8504,10,100,0.001,0.01,0.97,0.998824082784572,4282,4222
3,8604,10,100,0.001,0.01,0.968,0.99953509995351,4334,4270
3,8704,10,100,0.001,0.01,0.968,1.0,4377,4327
3,8804,10,100,0.001,0.01,0.972,1.0,4428,4376
3,8904,10,100,0.001,0.01,0.972,0.9998876909254267,4483,4421
3,9004,10,100,0.001,0.01,0.974,0.9994446912483341,4542,4462
3,9104,10,100,0.001,0.01,0.976,0.999780316344464,4590,4514
3,9204,10,100,0.001,0.01,0.98,1.0,4641,4563
3,9304,10,100,0.001,0.01,0.98,0.9997850386930353,4692,4612
3,9404,10,100,0.001,0.01,0.982,0.9988302849851127,4737,4667
3,9504,10,100,0.001,0.01,0.972,0.9962121212121212,4786,4718
3,9604,10,100,0.001,0.01,0.972,0.9966680549770929,4836,4768
3,9704,10,100,0.001,0.01,0.966,0.9912407254740313,4882,4822
3,9804,10,100,0.001,0.01,0.978,0.9944920440636474,4928,4876
3,9904,10,100,0.001,0.01,0.97,0.9958602584814217,4982,4922
3,10004,10,100,0.001,0.01,0.98,0.9978008796481408,5038,4966
3,10104,10,100,0.001,0.01,0.98,0.9980205859065716,5087,5017
3,10204,10,100,0.001,0.01,0.976,0.9982359858878871,5134,5070
3,10304,10,100,0.001,0.01,0.982,0.9982531055900621,5181,5123
3,10404,10,100,0.001,0.01,0.982,0.9977893118031527,5232,5172
3,10504,10,100,0.001,0.01,0.984,0.9963823305407464,5282,5222
3,10604,10,100,0.001,0.01,0.986,0.9978310071671067,5322,5282
3,10704,10,100,0.001,0.01,0.982,0.9985986547085202,5373,5331
3,10804,10,100,0.001,0.01,0.976,0.9923176601258793,5417,5387
3,10904,10,100,0.001,0.01,0.978,0.9944057226705796,5464,5440
3,11004,10,100,0.001,0.01,0.994,0.9980007270083606,5510,5494
3,11104,10,100,0.001,0.01,0.99,0.9991894812680115,5564,5540
3,11204,10,100,0.001,0.01,0.988,0.9996429846483399,5610,5594
3,11304,10,100,0.001,0.01,0.986,0.9994692144373672,5657,5647
3,11404,10,100,0.001,0.01,0.992,0.9985969835145563,5711,5693
3,11504,10,100,0.001,0.01,0.992,0.9990438108484005,5757,5747
3,11604,10,100,0.001,0.01,0.988,0.9995691140985867,5815,5789
3,11704,10,100,0.001,0.01,0.996,0.9997436773752563,5871,5833
3,11804,10,100,0.001,0.01,0.986,0.9987292443239579,5920,5884
3,11904,10,100,0.001,0.01,0.988,0.9988239247311828,5963,5941
3,12004,10,100,0.001,0.01,0.98,0.9982505831389537,6011,5993
3,12104,10,100,0.001,0.01,0.98,0.9923992068737607,6057,6047
3,12204,10,100,0.001,0.01,0.984,0.984349393641429,6104,6100
3,12304,10,100,0.001,0.01,0.952,0.9749674902470741,6154,6150
3,12404,10,100,0.001,0.01,0.98,0.9940341825217671,6210,6194
3,12504,10,100,0.001,0.01,0.99,0.9979206653870761,6261,6243
3,12604,10,100,0.001,0.01,0.988,0.9988892415106315,6309,6295
3,12704,10,100,0.001,0.01,0.992,0.9999212846347607,6355,6349
3,12804,10,100,0.001,0.01,0.99,0.9999218994064355,6403,6401
3,12904,10,100,0.001,0.01,0.99,0.9997675139491631,6458,6446
3,13004,10,100,0.001,0.01,0.986,0.997385419870809,6514,6490
3,13104,10,100,0.001,0.01,0.988,0.9993131868131868,6561,6543
3,13204,10,100,0.001,0.01,0.982,0.9931081490457437,6616,6588
3,13304,10,100,0.001,0.01,0.986,0.9994738424533974,6663,6641
3,13404,10,100,0.001,0.01,0.992,0.9982840943002089,6715,6689
3,13504,10,100,0.001,0.01,0.99,0.9984449052132701,6760,6744
3,13604,10,100,0.001,0.01,0.99,0.9971331961187886,6815,6789
3,13704,10,100,0.001,0.01,0.986,0.9978108581436077,6861,6843
3,13804,10,100,0.001,0.01,0.984,0.996740075340481,6902,6902
3,13904,10,100,0.001,0.01,0.992,0.998849252013809,6948,6956
3,14004,10,100,0.001,0.01,0.992,0.9990002856326764,6994,7010
3,14104,10,100,0.001,0.01,0.99,0.9994327850255247,7049,7055
3,14204,10,100,0.001,0.01,0.992,0.9985919459307238,7100,7104
3,14304,10,100,0.001,0.01,0.994,0.99748322147651,7145,7159
3,14404,10,100,0.001,0.01,0.992,0.998958622604832,7193,7211
3,14504,10,100,0.001,0.01,0.992,0.9997242140099283,7249,7255
3,14604,10,100,0.001,0.01,0.998,1.0,7308,7296
3,14704,10,100,0.001,0.01,0.99,0.9999319912948857,7355,7349
3,14804,10,100,0.001,0.01,0.99,1.0,7407,7397
3,14904,10,100,0.001,0.01,0.992,1.0,7460,7444
3,15004,10,100,0.001,0.01,0.992,1.0,7508,7496
4,104,10,100,0.001,0.01,0.452,0.5192307692307693,54,50
4,204,10,100,0.001,0.01,0.524,0.5980392156862745,104,100
4,304,10,100,0.001,0.01,0.534,0.555921052631579,157,147
4,404,10,100,0.001,0.01,0.518,0.6435643564356436,208,196
4,504,10,100,0.001,0.01,0.466,0.6150793650793651,266,238
4,604,10,100,0.001,0.01,0.498,0.6390728476821192,311,293
4,704,10,100,0.001,0.01,0.548,0.6150568181818182,359,345
4,804,10,100,0.001,0.01,0.51,0.6554726368159204,417,387
4,904,10,100,0.001,0.01,0.474,0.6194690265486725,465,439
4,1004,10,100,0.001,0.01,0.502,0.6862549800796812,519,485
4,1104,10,100,0.001,0.01,0.514,0.6512681159420289,572,532
4,1204,10,100,0.001,0.01,0.49,0.7159468438538206,616,588
4,1304,10,100,0.001,0.01,0.512,0.7177914110429447,672,632
4,1404,10,100,0.001,0.01,0.518,0.7222222222222222,727,677
4,1504,10,100,0.001,0.01,0.504,0.7107712765957447,780,724
4,1604,10,100,0.001,0.01,0.52,0.756857855361596,820,784
4,1704,10,100,0.001,0.01,0.496,0.738849765258216,866,838
4,1804,10,100,0.001,0.01,0.532,0.7771618625277162,916,888
4,1904,10,100,0.001,0.01,0.518,0.7935924369747899,970,934
4,2004,10,100,0.001,0.01,0.512,0.7719560878243513,1016,988
4,2104,10,100,0.001,0.01,0.514,0.7713878326996197,1069,1035
4,2204,10,100,0.001,0.01,0.514,0.8103448275862069,1126,1078
4,2304,10,100,0.001,0.01,0.556,0.79296875,1167,1137
4,2404,10,100,0.001,0.01,0.588,0.8398502495840267,1226,1178
4,2504,10,100,0.001,0.01,0.59,0.8278753993610224,1276,1228
4,2604,10,100,0.001,0.01,0.564,0.82642089093702,1324,1280
4,2704,10,100,0.001,0.01,0.61,0.8472633136094675,1376,1328
4,2804,10,100,0.001,0.01,0.612,0.8783880171184023,1428,1376
4,2904,10,100,0.001,0.01,0.628,0.8953168044077136,1475,1429
4,3004,10,100,0.001,0.01,0.62,0.8958055925432756,1522,1482
4,3104,10,100,0.001,0.01,0.63,0.904639175257732,1569,1535
4,3204,10,100,0.001,0.01,0.686,0.9388264669163545,1612,1592
4,3304,10,100,0.001,0.01,0.69,0.9497578692493946,1670,1634
4,3404,10,100,0.001,0.01,0.718,0.9553466509988249,1714,1690
4,3504,10,100,0.001,0.01,0.732,0.9500570776255708,1767,1737
4,3604,10,100,0.001,0.01,0.712,0.9422863485016648,1816,1788
4,3704,10,100,0.001,0.01,0.734,0.9549136069114471,1872,1832
4,3804,10,100,0.001,0.01,0.754,0.944006309148265,1921,1883
4,3904,10,100,0.001,0.01,0.766,0.9582479508196722,1972,1932
4,4004,10,100,0.001,0.01,0.786,0.9807692307692307,2023,1981
4,4104,10,100,0.001,0.01,0.824,0.9897660818713451,2078,2026
4,4204,10,100,0.001,0.01,0.804,0.9845385347288297,2128,2076
4,4304,10,100,0.001,0.01,0.854,0.9867565055762082,2175,2129
4,4404,10,100,0.001,0.01,0.866,0.991371480472298,2234,2170
4,4504,10,100,0.001,0.01,0.862,0.9946714031971581,2283,2221
4,4604,10,100,0.001,0.01,0.876,0.9934839270199827,2336,2268
4,4704,10,100,0.001,0.01,0.876,0.983843537414966,2386,2318
4,4804,10,100,0.001,0.01,0.882,0.9837635303913406,2437,2367
4,4904,10,100,0.001,0.01,0.88,0.9932707993474714,2491,2413
4,5004,10,100,0.001,0.01,0.9,0.9976019184652278,2538,2466
4,5104,10,100,0.001,0.01,0.908,0.9964733542319749,2583,2521
4,5204,10,100,0.001,0.01,0.904,0.9963489623366641,2642,2562
4,5304,10,100,0.001,0.01,0.932,0.9981146304675717,2693,2611
4,5404,10,100,0.001,0.01,0.906,0.9955588452997779,2747,2657
4,5504,10,100,0.001,0.01,0.926,0.9978197674418605,2795,2709
4,5604,10,100,0.001,0.01,0.922,0.9862598144182727,2848,2756
4,5704,10,100,0.001,0.01,0.924,0.9940392706872371,2884,2820
4,5804,10,100,0.001,0.01,0.942,0.9982770503101309,2938,2866
4,5904,10,100,0.001,0.01,0.946,0.9981368563685636,2993,2911
4,6004,10,100,0.001,0.01,0.948,0.995836109260493,3033,2971
4,6104,10,100,0.001,0.01,0.94,0.9959043250327654,3071,3033
4,6204,10,100,0.001,0.01,0.942,0.9938749194068343,3118,3086
4,6304,10,100,0.001,0.01,0.932,0.9938134517766497,3163,3141
4,6404,10,100,0.001,0.01,0.936,0.9845409119300437,3215,3189
4,6504,10,100,0.001,0.01,0.956,0.9924661746617466,3264,3240
4,6604,10,100,0.001,0.01,0.954,0.9948516050878256,3326,3278
4,6704,10,100,0.001,0.01,0.964,0.9916467780429594,3377,3327
4,6804,10,100,0.001,0.01,0.958,0.993533215755438,3433,3371
4,6904,10,100,0.001,0.01,0.968,0.9963789107763615,3485,3419
4,7004,10,100,0.001,0.01,0.966,0.9984294688749286,3539,3465
4,7104,10,100,0.001,0.01,0.978,0.9998592342342343,3593,3511
4,7204,10,100,0.001,0.01,0.968,0.9990283176013326,3643,3561
4,7304,10,100,0.001,0.01,0.978,0.9994523548740416,3690,3614
4,7404,10,100,0.001,0.01,0.97,0.9963533225283631,3737,3667
4,7504,10,100,0.001,0.01,0.968,0.9964019189765458,3789,3715
4,7604,10,100,0.001,0.01,0.972,0.9997369805365597,3842,3762
4,7704,10,100,0.001,0.01,0.972,0.9961059190031153,3892,3812
4,7804,10,100,0.001,0.01,0.98,0.9991030240902101,3941,3863
4,7904,10,100,0.001,0.01,0.978,0.9986082995951417,3997,3907
4,8004,10,100,0.001,0.01,0.976,0.994127936031984,4044,3960
4,8104,10,100,0.001,0.01,0.962,0.9911154985192497,4091,4013
4,8204,10,100,0.001,0.01,0.982,0.9948805460750854,4138,4066
4,8304,10,100,0.001,0.01,0.982,0.9978323699421965,4200,4104
4,8404,10,100,0.001,0.01,0.986,0.9989290813898144,4243,4161
4,8504,10,100,0.001,0.01,0.986,0.9998824082784572,4306,4198
4,8604,10,100,0.001,0.01,0.986,0.999767549976755,4360,4244
4,8704,10,100,0.001,0.01,0.99,1.0,4411,4293
4,8804,10,100,0.001,0.01,0.988,1.0,4461,4343
4,8904,10,100,0.001,0.01,0.986,0.9997753818508536,4515,4389
4,9004,10,100,0.001,0.01,0.988,0.9996668147490004,4560,4444
4,9104,10,100,0.001,0.01,0.986,0.9995606326889279,4605,4499
4,9204,10,100,0.001,0.01,0.986,0.9966318991742721,4655,4549
4,9304,10,100,0.001,0.01,0.978,0.9886070507308684,4706,4598
4,9404,10,100,0.001,0.01,0.972,0.9878774989366227,4754,4650
4,9504,10,100,0.001,0.01,0.976,0.9956860269360269,4803,4701
4,9604,10,100,0.001,0.01,0.988,0.9978134110787172,4850,4754
4,9704,10,100,0.001,0.01,0.99,0.9990725474031328,4898,4806
4,9804,10,100,0.001,0.01,0.992,0.998062015503876,4940,4864
4,9904,10,100,0.001,0.01,0.992,0.997778675282714,4990,4914
4,10004,10,100,0.001,0.01,0.992,0.9997001199520192,5042,4962
4,10104,10,100,0.001,0.01,0.992,1.0,5096,5008
4,10204,10,100,0.001,0.01,0.994,1.0,5150,5054
4,10304,10,100,0.001,0.01,0.994,1.0,5192,5112
4,10404,10,100,0.001,0.01,0.994,0.9997116493656286,5242,5162
4,10504,10,100,0.001,0.01,0.994,1.0,5291,5213
4,10604,10,100,0.001,0.01,0.994,0.9999056959637872,5340,5264
4,10704,10,100,0.001,0.01,0.994,1.0,5381,5323
4,10804,10,100,0.001,0.01,0.992,0.9984265087004813,5426,5378
4,10904,10,100,0.001,0.01,0.986,0.9992663242846662,5477,5427
4,11004,10,100,0.001,0.01,0.992,0.999818247909851,5529,5475
4,11104,10,100,0.001,0.01,0.99,0.9994596541786743,5576,5528
4,11204,10,100,0.001,0.01,0.992,0.9995537308104249,5630,5574
4,11304,10,100,0.001,0.01,0.992,0.9935421089879689,5678,5626
4,11404,10,100,0.001,0.01,0.958,0.970799719396703,5735,5669
4,11504,10,100,0.001,0.01,0.972,0.9777468706536857,5779,5725
4,11604,10,100,0.001,0.01,0.994,0.9953464322647363,5823,5781
4,11704,10,100,0.001,0.01,0.992,0.9990601503759399,5867,5837
4,11804,10,100,0.001,0.01,0.992,0.9993222636394442,5923,5881
4,11904,10,100,0.001,0.01,0.994,1.0,5978,5926
4,12004,10,100,0.001,0.01,0.994,1.0,6022,5982
4,12104,10,100,0.001,0.01,0.994,1.0,6070,6034
4,12204,10,100,0.001,0.01,0.992,1.0,6110,6094
4,12304,10,100,0.001,0.01,0.994,0.9993498049414824,6153,6151
4,12404,10,100,0.001,0.01,0.99,0.9987907126733312,6202,6202
4,12504,10,100,0.001,0.01,0.996,0.9996001279590531,6252,6252
4,12604,10,100,0.001,0.01,0.994,1.0,6299,6305
4,12704,10,100,0.001,0.01,0.994,0.9999212846347607,6348,6356
4,12804,10,100,0.001,0.01,0.996,1.0,6406,6398
4,12904,10,100,0.001,0.01,0.992,0.9996900185988841,6464,6440
4,13004,10,100,0.001,0.01,0.992,0.9992310058443555,6517,6487
4,13104,10,100,0.001,0.01,0.99,0.9984737484737485,6557,6547
4,13204,10,100,0.001,0.01,1.0,0.9952287185701303,6607,6597
4,13304,10,100,0.001,0.01,0.992,0.9975195429945881,6660,6644
4,13404,10,100,0.001,0.01,0.996,0.999179349447926,6711,6693
4,13504,10,100,0.001,0.01,0.996,0.9995556872037915,6757,6747
4,13604,10,100,0.001,0.01,0.996,0.9997794766245222,6798,6806
4,13704,10,100,0.001,0.01,0.996,1.0,6847,6857
4,13804,10,100,0.001,0.01,0.994,1.0,6894,6910
4,13904,10,100,0.001,0.01,0.996,1.0,6947,6957
4,14004,10,100,0.001,0.01,0.996,1.0,6999,7005
4,14104,10,100,0.001,0.01,0.996,1.0,7053,7051
4,14204,10,100,0.001,0.01,0.994,0.9997887918896086,7107,7097
4,14304,10,100,0.001,0.01,0.996,1.0,7149,7155
4,14404,10,100,0.001,0.01,0.994,0.9995834490419327,7205,7199
4,14504,10,100,0.001,0.01,0.992,0.9955184776613348,7258,7246
4,14604,10,100,0.001,0.01,0.982,0.9882224048205971,7314,7290
4,14704,10,100,0.001,0.01,0.99,0.9977557127312296,7365,7339
4,14804,10,100,0.001,0.01,0.994,0.9993245068900297,7416,7388
4,14904,10,100,0.001,0.01,0.994,0.9999329039184112,7477,7427
4,15004,10,100,0.001,0.01,0.996,1.0,7526,7478
5,104,10,100,0.001,0.01,0.49,0.5192307692307693,51,53
5,204,10,100,0.001,0.01,0.478,0.6715686274509803,96,108
5,304,10,100,0.001,0.01,0.508,0.6513157894736842,154,150
5,404,10,100,0.001,0.01,0.518,0.6435643564356436,210,194
5,504,10,100,0.001,0.01,0.514,0.6408730158730159,268,236
5,604,10,100,0.001,0.01,0.506,0.652317880794702,320,284
5,704,10,100,0.001,0.01,0.466,0.6392045454545454,373,331
5,804,10,100,0.001,0.01,0.532,0.7002487562189055,432,372
5,904,10,100,0.001,0.01,0.532,0.668141592920354,475,429
5,1004,10,100,0.001,0.01,0.546,0.6962151394422311,528,476
5,1104,10,100,0.001,0.01,0.538,0.6893115942028986,580,524
5,1204,10,100,0.001,0.01,0.516,0.728405315614618,625,579
5,1304,10,100,0.001,0.01,0.552,0.7361963190184049,673,631
5,1404,10,100,0.001,0.01,0.512,0.6851851851851852,719,685
5,1504,10,100,0.001,0.01,0.536,0.6695478723404256,770,734
5,1604,10,100,0.001,0.01,0.52,0.7493765586034913,820,784
5,1704,10,100,0.001,0.01,0.548,0.732981220657277,867,837
5,1804,10,100,0.001,0.01,0.514,0.7621951219512195,913,891
5,1904,10,100,0.001,0.01,0.498,0.7610294117647058,960,944
5,2004,10,100,0.001,0.01,0.538,0.7869261477045908,1016,988
5,2104,10,100,0.001,0.01,0.55,0.8022813688212928,1067,1037
5,2204,10,100,0.001,0.01,0.56,0.7531760435571688,1113,1091
5,2304,10,100,0.001,0.01,0.536,0.7339409722222222,1168,1136
5,2404,10,100,0.001,0.01,0.584,0.8136439267886856,1219,1185
5,2504,10,100,0.001,0.01,0.604,0.8294728434504792,1260,1244
5,2604,10,100,0.001,0.01,0.632,0.8636712749615976,1315,1289
5,2704,10,100,0.001,0.01,0.61,0.8661242603550295,1354,1350
5,2804,10,100,0.001,0.01,0.638,0.8594864479315264,1414,1390
5,2904,10,100,0.001,0.01,0.63,0.8684573002754821,1467,1437
5,3004,10,100,0.001,0.01,0.67,0.9044607190412783,1518,1486
5,3104,10,100,0.001,0.01,0.696,0.9326675257731959,1571,1533
5,3204,10,100,0.001,0.01,0.74,0.9382022471910112,1626,1578
5,3304,10,100,0.001,0.01,0.736,0.9258474576271186,1680,1624
5,3404,10,100,0.001,0.01,0.756,0.9553466509988249,1727,1677
5,3504,10,100,0.001,0.01,0.786,0.9731735159817352,1782,1722
5,3604,10,100,0.001,0.01,0.804,0.9841842397336293,1834,1770
5,3704,10,100,0.001,0.01,0.828,0.9819114470842333,1884,1820
5,3804,10,100,0.001,0.01,0.846,0.991062039957939,1930,1874
5,3904,10,100,0.001,0.01,0.844,0.9925717213114754,1973,1931
5,4004,10,100,0.001,0.01,0.836,0.985014985014985,2024,1980
5,4104,10,100,0.001,0.01,0.842,0.9895224171539961,2077,2027
5,4204,10,100,0.001,0.01,0.88,0.9933396764985728,2118,2086
5,4304,10,100,0.001,0.01,0.86,0.9904739776951673,2168,2136
5,4404,10,100,0.001,0.01,0.88,0.9877384196185286,2227,2177
5,4504,10,100,0.001,0.01,0.896,0.991785079928952,2278,2226
5,4604,10,100,0.001,0.01,0.888,0.988488271068636,2323,2281
5,4704,10,100,0.001,0.01,0.886,0.9895833333333334,2375,2329
5,4804,10,100,0.001,0.01,0.906,0.9875104079933389,2426,2378
5,4904,10,100,0.001,0.01,0.92,0.9944942903752039,2481,2423
5,5004,10,100,0.001,0.01,0.932,0.9918065547561951,2528,2476
5,5104,10,100,0.001,0.01,0.924,0.9686520376175548,2570,2534
5,5204,10,100,0.001,0.01,0.928,0.9878939277478862,2619,2585
5,5304,10,100,0.001,0.01,0.936,0.9884992458521871,2657,2647
5,5404,10,100,0.001,0.01,0.932,0.9935233160621761,2708,2696
5,5504,10,100,0.001,0.01,0.94,0.995094476744186,2764,2740
5,5604,10,100,0.001,0.01,0.948,0.9976802284082797,2812,2792
5,5704,10,100,0.001,0.01,0.964,0.9987727910238429,2863,2841
5,5804,10,100,0.001,0.01,0.966,0.9972432804962095,2905,2899
5,5904,10,100,0.001,0.01,0.96,0.9950880758807588,2961,2943
5,6004,10,100,0.001,0.01,0.954,0.9953364423717521,3012,2992
5,6104,10,100,0.001,0.01,0.95,0.9960681520314548,3068,3036
5,6204,10,100,0.001,0.01,0.956,0.9956479690522244,3113,3091
5,6304,10,100,0.001,0.01,0.956,0.9976205583756346,3166,3138
5,6404,10,100,0.001,0.01,0.964,0.9985946283572767,3211,3193
5,6504,10,100,0.001,0.01,0.96,0.9986162361623616,3256,3248
5,6604,10,100,0.001,0.01,0.958,0.9909145972138098,3307,3297
5,6704,10,100,0.001,0.01,0.956,0.9928400954653938,3351,3353
5,6804,10,100,0.001,0.01,0.954,0.9933862433862434,3397,3407
5,6904,10,100,0.001,0.01,0.972,0.9944959443800695,3451,3453
5,7004,10,100,0.001,0.01,0.97,0.9994288977727013,3496,3508
5,7104,10,100,0.001,0.01,0.97,0.9997184684684685,3537,3567
5,7204,10,100,0.001,0.01,0.97,0.9997223764575236,3583,3621
5,7304,10,100,0.001,0.01,0.966,0.997946330777656,3638,3666
5,7404,10,100,0.001,0.01,0.984,0.9967585089141004,3680,3724
5,7504,10,100,0.001,0.01,0.986,1.0,3732,3772
5,7604,10,100,0.001,0.01,0.98,0.9993424513413993,3789,3815
5,7704,10,100,0.001,0.01,0.98,0.9994807892004154,3846,3858
5,7804,10,100,0.001,0.01,0.972,0.9996155817529472,3900,3904
5,7904,10,100,0.001,0.01,0.978,0.9994939271255061,3947,3957
5,8004,10,100,0.001,0.01,0.972,0.9892553723138431,3997,4007
5,8104,10,100,0.001,0.01,0.95,0.9719891411648569,4049,4055
5,8204,10,100,0.001,0.01,0.946,0.9792784007801073,4098,4106
5,8304,10,100,0.001,0.01,0.974,0.9932562620423893,4143,4161
5,8404,10,100,0.001,0.01,0.972,0.9964302712993812,4190,4214
5,8504,10,100,0.001,0.01,0.974,0.9985888993414863,4242,4262
5,8604,10,100,0.001,0.01,0.986,0.99953509995351,4293,4311
5,8704,10,100,0.001,0.01,0.988,0.9995404411764706,4345,4359
5,8804,10,100,0.001,0.01,0.98,0.9996592457973649,4394,4410
5,8904,10,100,0.001,0.01,0.992,1.0,4439,4465
5,9004,10,100,0.001,0.01,0.99,0.9997778764993336,4493,4511
5,9104,10,100,0.001,0.01,0.978,0.999890158172232,4549,4555
5,9204,10,100,0.001,0.01,0.99,0.9994567579313341,4604,4600
5,9304,10,100,0.001,0.01,0.99,0.9994625967325881,4652,4652
5,9404,10,100,0.001,0.01,0.992,1.0,4698,4706
5,9504,10,100,0.001,0.01,0.988,0.9996843434343434,4748,4756
5,9604,10,100,0.001,0.01,0.992,0.9957309454394002,4800,4804
5,9704,10,100,0.001,0.01,0.982,0.997320692497939,4855,4849
5,9804,10,100,0.001,0.01,0.988,0.9987760097919217,4907,4897
5,9904,10,100,0.001,0.01,0.996,0.9994951534733441,4949,4955
5,10004,10,100,0.001,0.01,0.98,0.9964014394242303,4995,5009
5,10104,10,100,0.001,0.01,0.982,0.9982185273159145,5039,5065
5,10204,10,100,0.001,0.01,0.968,0.9889259114072912,5094,5110
5,10304,10,100,0.001,0.01,0.986,0.9984472049689441,5144,5160
5,10404,10,100,0.001,0.01,0.98,0.9986543637062668,5198,5206
5,10504,10,100,0.001,0.01,0.988,0.9984767707539984,5255,5249
5,10604,10,100,0.001,0.01,0.988,0.9998113919275745,5315,5289
5,10704,10,100,0.001,0.01,0.99,1.0,5363,5341
5,10804,10,100,0.001,0.01,0.99,1.0,5420,5384
5,10904,10,100,0.001,0.01,0.988,0.9994497432134997,5474,5430
5,11004,10,100,0.001,0.01,0.992,0.9984551072337332,5525,5479
5,11104,10,100,0.001,0.01,0.988,0.9998198847262247,5575,5529
5,11204,10,100,0.001,0.01,0.982,0.9967868618350589,5626,5578
5,11304,10,100,0.001,0.01,0.976,0.9890304317055909,5668,5636
5,11404,10,100,0.001,0.01,0.984,0.996580147316731,5720,5684
5,11504,10,100,0.001,0.01,0.99,0.9985222531293463,5775,5729
5,11604,10,100,0.001,0.01,0.992,0.9996552912788693,5822,5782
5,11704,10,100,0.001,0.01,0.994,0.9994873547505126,5861,5843
5,11804,10,100,0.001,0.01,0.994,0.9998305659098611,5909,5895
5,11904,10,100,0.001,0.01,0.994,1.0,5967,5937
5,12004,10,100,0.001,0.01,0.994,1.0,6015,5989
5,12104,10,100,0.001,0.01,0.99,1.0,6078,6026
5,12204,10,100,0.001,0.01,0.992,0.9987708947885939,6133,6071
5,12304,10,100,0.001,0.01,0.996,0.9995123537061118,6175,6129
5,12404,10,100,0.001,0.01,0.992,0.9998387616897775,6234,6170
5,12504,10,100,0.001,0.01,0.992,0.9998400511836213,6278,6226
5,12604,10,100,0.001,0.01,0.994,0.9949222469057442,6330,6274
5,12704,10,100,0.001,0.01,0.99,0.9966152392947103,6383,6321
5,12804,10,100,0.001,0.01,0.998,0.9954701655732584,6422,6382
5,12904,10,100,0.001,0.01,0.99,0.9948078115313082,6463,6441
5,13004,10,100,0.001,0.01,0.992,0.9980006151953246,6510,6494
5,13104,10,100,0.001,0.01,0.998,0.9961843711843712,6555,6549
5,13204,10,100,0.001,0.01,0.992,0.9989397152378068,6604,6600
5,13304,10,100,0.001,0.01,0.998,0.9997745039085989,6651,6653
5,13404,10,100,0.001,0.01,0.996,0.9995523724261415,6694,6710
5,13504,10,100,0.001,0.01,0.994,0.99948163507109,6742,6762
5,13604,10,100,0.001,0.01,0.998,0.9998529844163482,6793,6811
5,13704,10,100,0.001,0.01,1.0,1.0,6846,6858
5,13804,10,100,0.001,0.01,1.0,0.9999275572297884,6888,6916
5,13904,10,100,0.001,0.01,0.998,0.999928078250863,6943,6961
5,14004,10,100,0.001,0.01,1.0,0.9999285918309054,6986,7018
5,14104,10,100,0.001,0.01,1.0,0.9981565513329552,7036,7068
5,14204,10,100,0.001,0.01,0.988,0.9951422134609968,7081,7123
5,14304,10,100,0.001,0.01,0.992,0.9983221476510067,7143,7161
5,14404,10,100,0.001,0.01,0.99,0.9976395445709525,7190,7214
5,14504,10,100,0.001,0.01,0.992,0.999103695532267,7243,7261
5,14604,10,100,0.001,0.01,0.99,0.9977403451109285,7295,7309
5,14704,10,100,0.001,0.01,0.996,1.0,7354,7350
5,14804,10,100,0.001,0.01,0.994,1.0,7402,7402
5,14904,10,100,0.001,0.01,0.994,1.0,7454,7450
5,15004,10,100,0.001,0.01,0.996,1.0,7499,7505
6,104,10,100,0.001,0.01,0.486,0.5673076923076923,45,59
6,204,10,100,0.001,0.01,0.436,0.6029411764705882,97,107
6,304,10,100,0.001,0.01,0.504,0.6151315789473685,152,152
6,404,10,100,0.001,0.01,0.502,0.6212871287128713,206,198
6,504,10,100,0.001,0.01,0.458,0.6329365079365079,263,241
6,604,10,100,0.001,0.01,0.48,0.6754966887417219,308,296
6,704,10,100,0.001,0.01,0.498,0.671875,353,351
6,804,10,100,0.001,0.01,0.504,0.6691542288557214,402,402
6,904,10,100,0.001,0.01,0.524,0.6670353982300885,452,452
6,1004,10,100,0.001,0.01,0.486,0.6772908366533864,509,495
6,1104,10,100,0.001,0.01,0.506,0.6648550724637681,554,550
6,1204,10,100,0.001,0.01,0.542,0.7043189368770764,598,606
6,1304,10,100,0.001,0.01,0.536,0.7177914110429447,651,653
6,1404,10,100,0.001,0.01,0.552,0.7215099715099715,697,707
6,1504,10,100,0.001,0.01,0.58,0.7007978723404256,749,755
6,1604,10,100,0.001,0.01,0.604,0.7605985037406484,798,806
6,1704,10,100,0.001,0.01,0.626,0.7634976525821596,839,865
6,1804,10,100,0.001,0.01,0.63,0.7472283813747228,884,920
6,1904,10,100,0.001,0.01,0.584,0.7237394957983193,938,966
6,2004,10,100,0.001,0.01,0.606,0.779441117764471,989,1015
6,2104,10,100,0.001,0.01,0.608,0.782319391634981,1040,1064
6,2204,10,100,0.001,0.01,0.598,0.7876588021778584,1092,1112
6,2304,10,100,0.001,0.01,0.666,0.7942708333333334,1141,1163
6,2404,10,100,0.001,0.01,0.696,0.829450915141431,1197,1207
6,2504,10,100,0.001,0.01,0.708,0.8594249201277955,1249,1255
6,2604,10,100,0.001,0.01,0.738,0.858678955453149,1295,1309
6,2704,10,100,0.001,0.01,0.788,0.9138313609467456,1350,1354
6,2804,10,100,0.001,0.01,0.768,0.9233238231098431,1400,1404
6,2904,10,100,0.001,0.01,0.774,0.8966942148760331,1454,1450
6,3004,10,100,0.001,0.01,0.818,0.9310918774966711,1508,1496
6,3104,10,100,0.001,0.01,0.844,0.9494201030927835,1553,1551
6,3204,10,100,0.001,0.01,0.856,0.9606741573033708,1600,1604
6,3304,10,100,0.001,0.01,0.842,0.9639830508474576,1642,1662
6,3404,10,100,0.001,0.01,0.85,0.9606345475910694,1696,1708
6,3504,10,100,0.001,0.01,0.854,0.9746004566210046,1746,1758
6,3604,10,100,0.001,0.01,0.872,0.97669256381798,1791,1813
6,3704,10,100,0.001,0.01,0.882,0.978401727861771,1839,1865
6,3804,10,100,0.001,0.01,0.884,0.9826498422712934,1891,1913
6,3904,10,100,0.001,0.01,0.872,0.9774590163934426,1944,1960
6,4004,10,100,0.001,0.01,0.856,0.9475524475524476,1993,2011
6,4104,10,100,0.001,0.01,0.86,0.929093567251462,2040,2064
6,4204,10,100,0.001,0.01,0.904,0.972882968601332,2098,2106
6,4304,10,100,0.001,0.01,0.892,0.9837360594795539,2145,2159
6,4404,10,100,0.001,0.01,0.888,0.9822888283378747,2187,2217
6,4504,10,100,0.001,0.01,0.89,0.9775754884547069,2241,2263
6,4604,10,100,0.001,0.01,0.898,0.9837098175499566,2301,2303
6,4704,10,100,0.001,0.01,0.91,0.9861819727891157,2350,2354
6,4804,10,100,0.001,0.01,0.912,0.9864696086594504,2398,2406
6,4904,10,100,0.001,0.01,0.93,0.9951060358890701,2450,2454
6,5004,10,100,0.001,0.01,0.914,0.9942046362909672,2496,2508
6,5104,10,100,0.001,0.01,0.936,0.9980407523510971,2544,2560
6,5204,10,100,0.001,0.01,0.934,0.999423520368947,2598,2606
6,5304,10,100,0.001,0.01,0.932,0.9986802413273002,2642,2662
6,5404,10,100,0.001,0.01,0.942,0.999259807549963,2684,2720
6,5504,10,100,0.001,0.01,0.944,0.9992732558139535,2733,2771
6,5604,10,100,0.001,0.01,0.948,0.9991077801570307,2786,2818
6,5704,10,100,0.001,0.01,0.936,0.9950911640953717,2838,2866
6,5804,10,100,0.001,0.01,0.906,0.9819090282563749,2892,2912
6,5904,10,100,0.001,0.01,0.946,0.9927168021680217,2940,2964
6,6004,10,100,0.001,0.01,0.936,0.9935043304463691,2980,3024
6,6104,10,100,0.001,0.01,0.932,0.9955766710353866,3031,3073
6,6204,10,100,0.001,0.01,0.936,0.9962927143778207,3077,3127
6,6304,10,100,0.001,0.01,0.934,0.9881027918781726,3121,3183
6,6404,10,100,0.001,0.01,0.928,0.9840724547158026,3167,3237
6,6504,10,100,0.001,0.01,0.956,0.9946186961869619,3215,3289
6,6604,10,100,0.001,0.01,0.932,0.9947001817080557,3264,3340
6,6704,10,100,0.001,0.01,0.958,0.9962708830548926,3313,3391
6,6804,10,100,0.001,0.01,0.966,0.9975014697236919,3368,3436
6,6904,10,100,0.001,0.01,0.952,0.9982618771726536,3420,3484
6,7004,10,100,0.001,0.01,0.956,0.9985722444317533,3471,3533
6,7104,10,100,0.001,0.01,0.968,0.9997184684684685,3519,3585
6,7204,10,100,0.001,0.01,0.97,0.9997223764575236,3573,3631
6,7304,10,100,0.001,0.01,0.972,0.9998630887185104,3630,3674
6,7404,10,100,0.001,0.01,0.964,1.0,3670,3734
6,7504,10,100,0.001,0.01,0.97,0.9964019189765458,3711,3793
6,7604,10,100,0.001,0.01,0.958,0.9786954234613361,3752,3852
6,7704,10,100,0.001,0.01,0.954,0.9858515057113187,3804,3900
6,7804,10,100,0.001,0.01,0.952,0.993208610968734,3857,3947
6,7904,10,100,0.001,0.01,0.958,0.9919028340080972,3902,4002
6,8004,10,100,0.001,0.01,0.958,0.9968765617191404,3949,4055
6,8104,10,100,0.001,0.01,0.964,0.998025666337611,3997,4107
6,8204,10,100,0.001,0.01,0.97,0.999756216479766,4050,4154
6,8304,10,100,0.001,0.01,0.964,0.9989161849710982,4100,4204
6,8404,10,100,0.001,0.01,0.956,0.9961922893860067,4155,4249
6,8504,10,100,0.001,0.01,0.974,0.9971777986829727,4204,4300
6,8604,10,100,0.001,0.01,0.964,0.9989539748953975,4256,4348
6,8704,10,100,0.001,0.01,0.97,1.0,4306,4398
6,8804,10,100,0.001,0.01,0.976,1.0,4358,4446
6,8904,10,100,0.001,0.01,0.978,0.9998876909254267,4409,4495
6,9004,10,100,0.001,0.01,0.978,1.0,4465,4539
6,9104,10,100,0.001,0.01,0.978,1.0,4512,4592
6,9204,10,100,0.001,0.01,0.982,0.9996740547588006,4565,4639
6,9304,10,100,0.001,0.01,0.974,0.9954858125537404,4617,4687
6,9404,10,100,0.001,0.01,0.97,0.9971288813270949,4674,4730
6,9504,10,100,0.001,0.01,0.974,0.9964225589225589,4728,4776
6,9604,10,100,0.001,0.01,0.918,0.948771345272803,4772,4832
6,9704,10,100,0.001,0.01,0.97,0.9824814509480626,4823,4881
6,9804,10,100,0.001,0.01,0.976,0.9931660546715626,4875,4929
6,9904,10,100,0.001,0.01,0.98,0.9974757673667205,4923,4981
6,10004,10,100,0.001,0.01,0.982,0.9988004798080767,4969,5035
6,10104,10,100,0.001,0.01,0.984,0.9997030878859857,5030,5074
6,10204,10,100,0.001,0.01,0.986,0.9993139945119561,5079,5125
6,10304,10,100,0.001,0.01,0.978,0.999126552795031,5138,5166
6,10404,10,100,0.001,0.01,0.984,0.9996155324875048,5183,5221
6,10504,10,100,0.001,0.01,0.976,0.996001523229246,5227,5277
6,10604,10,100,0.001,0.01,0.982,0.999622783855149,5273,5331
6,10704,10,100,0.001,0.01,0.99,0.9985052316890882,5318,5386
6,10804,10,100,0.001,0.01,0.976,0.9975009255831173,5361,5443
6,10904,10,100,0.001,0.01,0.982,0.9977989728539985,5413,5491
6,11004,10,100,0.001,0.01,0.982,0.9959105779716467,5461,5543
6,11104,10,100,0.001,0.01,0.986,0.999549711815562,5514,5590
6,11204,10,100,0.001,0.01,0.988,0.9996429846483399,5580,5624
6,11304,10,100,0.001,0.01,0.99,0.9998230714791224,5631,5673
6,11404,10,100,0.001,0.01,0.99,1.0,5678,5726
6,11504,10,100,0.001,0.01,0.99,1.0,5724,5780
6,11604,10,100,0.001,0.01,0.992,1.0,5773,5831
6,11704,10,100,0.001,0.01,0.99,0.9994019138755981,5825,5879
6,11804,10,100,0.001,0.01,0.992,0.9991528295493053,5873,5931
6,11904,10,100,0.001,0.01,0.984,0.9952116935483871,5923,5981
6,12004,10,100,0.001,0.01,0.982,0.9870876374541819,5977,6027
6,12104,10,100,0.001,0.01,0.978,0.9932253800396563,6021,6083
6,12204,10,100,0.001,0.01,0.978,0.99664044575549,6070,6134
6,12304,10,100,0.001,0.01,0.988,0.9991059817945384,6119,6185
6,12404,10,100,0.001,0.01,0.984,0.9974201870364399,6168,6236
6,12504,10,100,0.001,0.01,0.988,0.9994401791426744,6226,6278
6,12604,10,100,0.001,0.01,0.988,0.9999206601079023,6275,6329
6,12704,10,100,0.001,0.01,0.99,1.0,6314,6390
6,12804,10,100,0.001,0.01,0.99,1.0,6359,6445
6,12904,10,100,0.001,0.01,0.986,0.9984500929944203,6418,6486
6,13004,10,100,0.001,0.01,0.98,0.998077514610889,6462,6542
6,13104,10,100,0.001,0.01,0.98,0.990460927960928,6513,6591
6,13204,10,100,0.001,0.01,0.988,0.9914419872765828,6558,6646
6,13304,10,100,0.001,0.01,0.988,0.9969182200841852,6607,6697
6,13404,10,100,0.001,0.01,0.988,0.9978364667263503,6663,6741
6,13504,10,100,0.001,0.01,0.99,0.9998518957345972,6720,6784
6,13604,10,100,0.001,0.01,0.986,0.9995589532490444,6769,6835
6,13704,10,100,0.001,0.01,0.992,0.9999270286047869,6817,6887
6,13804,10,100,0.001,0.01,0.984,0.9996377861489424,6870,6934
6,13904,10,100,0.001,0.01,0.99,1.0,6931,6973
6,14004,10,100,0.001,0.01,0.988,1.0,6978,7026
6,14104,10,100,0.001,0.01,0.992,0.9999290981281905,7029,7075
6,14204,10,100,0.001,0.01,0.992,1.0,7086,7118
6,14304,10,100,0.001,0.01,0.992,1.0,7144,7160
6,14404,10,100,0.001,0.01,0.99,0.9970147181338517,7188,7216
6,14504,10,100,0.001,0.01,0.986,0.9966216216216216,7236,7268
6,14604,10,100,0.001,0.01,0.96,0.983771569433032,7290,7314
6,14704,10,100,0.001,0.01,0.982,0.9955794341675734,7337,7367
6,14804,10,100,0.001,0.01,0.988,0.9973655768711159,7386,7418
6,14904,10,100,0.001,0.01,0.99,0.9996645195920558,7440,7464
6,15004,10,100,0.001,0.01,0.99,0.9998667022127433,7495,7509
7,104,10,100,0.001,0.01,0.52,0.5288461538461539,53,51
7,204,10,100,0.001,0.01,0.504,0.6274509803921569,98,106
7,304,10,100,0.001,0.01,0.502,0.625,154,150
7,404,10,100,0.001,0.01,0.528,0.5866336633663366,201,203
7,504,10,100,0.001,0.01,0.484,0.6130952380952381,245,259
7,604,10,100,0.001,0.01,0.52,0.5860927152317881,294,310
7,704,10,100,0.001,0.01,0.512,0.6193181818181818,347,357
7,804,10,100,0.001,0.01,0.488,0.6716417910447762,393,411
7,904,10,100,0.001,0.01,0.5,0.6946902654867256,437,467
7,1004,10,100,0.001,0.01,0.498,0.6444223107569721,488,516
7,1104,10,100,0.001,0.01,0.494,0.6485507246376812,544,560
7,1204,10,100,0.001,0.01,0.462,0.6818936877076412,596,608
7,1304,10,100,0.001,0.01,0.498,0.6817484662576687,643,661
7,1404,10,100,0.001,0.01,0.506,0.7172364672364673,697,707
7,1504,10,100,0.001,0.01,0.482,0.71875,753,751
7,1604,10,100,0.001,0.01,0.558,0.7119700748129676,805,799
7,1704,10,100,0.001,0.01,0.506,0.7341549295774648,853,851
7,1804,10,100,0.001,0.01,0.556,0.7605321507760532,907,897
7,1904,10,100,0.001,0.01,0.574,0.7242647058823529,952,952
7,2004,10,100,0.001,0.01,0.594,0.7649700598802395,999,1005
7,2104,10,100,0.001,0.01,0.574,0.7604562737642585,1050,1054
7,2204,10,100,0.001,0.01,0.582,0.7686025408348457,1111,1093
7,2304,10,100,0.001,0.01,0.602,0.7625868055555556,1156,1148
7,2404,10,100,0.001,0.01,0.594,0.7574875207986689,1207,1197
7,2504,10,100,0.001,0.01,0.634,0.7799520766773163,1258,1246
7,2604,10,100,0.001,0.01,0.61,0.804147465437788,1304,1300
7,2704,10,100,0.001,0.01,0.644,0.7880917159763313,1360,1344
7,2804,10,100,0.001,0.01,0.63,0.8049215406562055,1411,1393
7,2904,10,100,0.001,0.01,0.638,0.8181818181818182,1461,1443
7,3004,10,100,0.001,0.01,0.66,0.8478695073235686,1513,1491
7,3104,10,100,0.001,0.01,0.706,0.8337628865979382,1564,1540
7,3204,10,100,0.001,0.01,0.714,0.8686017478152309,1611,1593
7,3304,10,100,0.001,0.01,0.754,0.8837772397094431,1657,1647
7,3404,10,100,0.001,0.01,0.784,0.9018801410105758,1712,1692
7,3504,10,100,0.001,0.01,0.79,0.8889840182648402,1770,1734
7,3604,10,100,0.001,0.01,0.792,0.9014983351831298,1813,1791
7,3704,10,100,0.001,0.01,0.864,0.9505939524838013,1866,1838
7,3804,10,100,0.001,0.01,0.87,0.9616193480546793,1918,1886
7,3904,10,100,0.001,0.01,0.904,0.975922131147541,1963,1941
7,4004,10,100,0.001,0.01,0.894,0.9787712287712288,2014,1990
7,4104,10,100,0.001,0.01,0.898,0.9632066276803118,2069,2035
7,4204,10,100,0.001,0.01,0.93,0.9845385347288297,2121,2083
7,4304,10,100,0.001,0.01,0.936,0.9923327137546468,2172,2132
7,4404,10,100,0.001,0.01,0.95,0.9920526793823796,2217,2187
7,4504,10,100,0.001,0.01,0.97,0.9975577264653641,2265,2239
7,4604,10,100,0.001,0.01,0.968,0.9952215464813206,2319,2285
7,4704,10,100,0.001,0.01,0.956,0.9823554421768708,2372,2332
7,4804,10,100,0.001,0.01,0.952,0.985428809325562,2420,2384
7,4904,10,100,0.001,0.01,0.968,0.990415986949429,2479,2425
7,5004,10,100,0.001,0.01,0.976,0.996203037569944,2533,2471
7,5104,10,100,0.001,0.01,0.97,0.9943181818181818,2588,2516
7,5204,10,100,0.001,0.01,0.95,0.977901614142967,2638,2566
7,5304,10,100,0.001,0.01,0.938,0.955316742081448,2697,2607
7,5404,10,100,0.001,0.01,0.976,0.9913027387120651,2750,2654
7,5504,10,100,0.001,0.01,0.976,0.9969113372093024,2791,2713
7,5604,10,100,0.001,0.01,0.982,0.9989293361884368,2839,2765
7,5704,10,100,0.001,0.01,0.982,0.9998246844319776,2888,2816
7,5804,10,100,0.001,0.01,0.982,1.0,2929,2875
7,5904,10,100,0.001,0.01,0.984,1.0,2979,2925
7,6004,10,100,0.001,0.01,0.988,1.0,3021,2983
7,6104,10,100,0.001,0.01,0.986,1.0,3074,3030
7,6204,10,100,0.001,0.01,0.986,1.0,3124,3080
7,6304,10,100,0.001,0.01,0.986,0.9998413705583756,3170,3134
7,6404,10,100,0.001,0.01,0.99,1.0,3223,3181
7,6504,10,100,0.001,0.01,0.986,0.9998462484624846,3273,3231
7,6604,10,100,0.001,0.01,0.986,0.9998485766202302,3328,3276
7,6704,10,100,0.001,0.01,0.988,1.0,3379,3325
7,6804,10,100,0.001,0.01,0.988,1.0,3428,3376
7,6904,10,100,0.001,0.01,0.986,1.0,3479,3425
7,7004,10,100,0.001,0.01,0.988,1.0,3532,3472
7,7104,10,100,0.001,0.01,0.99,0.9995777027027027,3585,3519
7,7204,10,100,0.001,0.01,0.984,0.9962520821765686,3636,3568
7,7304,10,100,0.001,0.01,0.986,0.9987677984665937,3680,3624
7,7404,10,100,0.001,0.01,0.986,0.9863587250135062,3730,3674
7,7504,10,100,0.001,0.01,0.976,0.9894722814498934,3777,3727
7,7604,10,100,0.001,0.01,0.982,0.9922409258285113,3831,3773
7,7704,10,100,0.001,0.01,0.984,0.9963655244029076,3879,3825
7,7804,10,100,0.001,0.01,0.978,0.9941055868785238,3928,3876
7,7904,10,100,0.001,0.01,0.974,0.9913967611336032,3982,3922
7,8004,10,100,0.001,0.01,0.98,0.9976261869065467,4030,3974
7,8104,10,100,0.001,0.01,0.984,0.9988894373149062,4087,4017
7,8204,10,100,0.001,0.01,0.988,0.999390541199415,4140,4064
7,8304,10,100,0.001,0.01,0.99,0.9998795761078998,4190,4114
7,8404,10,100,0.001,0.01,0.988,0.9996430271299381,4249,4155
7,8504,10,100,0.001,0.01,0.99,1.0,4295,4209
7,8604,10,100,0.001,0.01,0.988,0.9998837749883775,4340,4264
7,8704,10,100,0.001,0.01,0.99,1.0,4385,4319
7,8804,10,100,0.001,0.01,0.986,0.9989777373920945,4427,4377
7,8904,10,100,0.001,0.01,0.986,0.998989218328841,4471,4433
7,9004,10,100,0.001,0.01,0.988,0.9984451354953354,4519,4485
7,9104,10,100,0.001,0.01,0.986,0.9963752196836555,4569,4535
7,9204,10,100,0.001,0.01,0.972,0.9873967840069535,4619,4585
7,9304,10,100,0.001,0.01,0.966,0.9824806534823731,4667,4637
7,9404,10,100,0.001,0.01,0.984,0.9928753721820502,4720,4684
7,9504,10,100,0.001,0.01,0.99,0.9982112794612794,4771,4733
7,9604,10,100,0.001,0.01,0.992,0.9984381507705122,4814,4790
7,9704,10,100,0.001,0.01,0.992,0.9997938994229184,4865,4839
7,9804,10,100,0.001,0.01,0.992,0.9995920032639739,4912,4892
7,9904,10,100,0.001,0.01,0.992,0.9990912762520194,4955,4949
7,10004,10,100,0.001,0.01,0.988,0.999500199920032,5001,5003
7,10104,10,100,0.001,0.01,0.99,0.9998020585906572,5059,5045
7,10204,10,100,0.001,0.01,0.986,0.9984319874558997,5109,5095
7,10304,10,100,0.001,0.01,0.986,0.999902950310559,5164,5140
7,10404,10,100,0.001,0.01,0.988,0.9984621299500193,5221,5183
7,10504,10,100,0.001,0.01,0.988,0.9974295506473724,5268,5236
7,10604,10,100,0.001,0.01,0.99,0.9991512636740852,5320,5284
7,10704,10,100,0.001,0.01,0.986,0.9987855007473841,5369,5335
7,10804,10,100,0.001,0.01,0.99,0.996482784154017,5414,5390
7,10904,10,100,0.001,0.01,0.994,0.9995414526779164,5468,5436
7,11004,10,100,0.001,0.01,0.992,0.9999091239549255,5513,5491
7,11104,10,100,0.001,0.01,0.994,0.9990994236311239,5563,5541
7,11204,10,100,0.001,0.01,0.99,0.9992859692966798,5615,5589
7,11304,10,100,0.001,0.01,0.99,0.9986730360934183,5673,5631
7,11404,10,100,0.001,0.01,0.988,0.9959663276043493,5722,5682
7,11504,10,100,0.001,0.01,0.992,0.9980006954102921,5769,5735
7,11604,10,100,0.001,0.01,0.988,0.9938814201999311,5820,5784
7,11704,10,100,0.001,0.01,0.986,0.9975222146274778,5866,5838
7,11804,10,100,0.001,0.01,0.99,0.9983903761436801,5905,5899
7,11904,10,100,0.001,0.01,0.968,0.9690860215053764,5951,5953
7,12004,10,100,0.001,0.01,0.99,0.9925858047317561,6001,6003
7,12104,10,100,0.001,0.01,0.99,0.9938037012557832,6044,6060
7,12204,10,100,0.001,0.01,0.992,0.9987708947885939,6091,6113
7,12304,10,100,0.001,0.01,0.992,0.9996749024707412,6143,6161
7,12404,10,100,0.001,0.01,0.99,1.0,6194,6210
7,12504,10,100,0.001,0.01,0.994,1.0,6246,6258
7,12604,10,100,0.001,0.01,0.992,1.0,6294,6310
7,12704,10,100,0.001,0.01,0.99,0.9997638539042821,6350,6354
7,12804,10,100,0.001,0.01,0.994,0.999843798812871,6390,6414
7,12904,10,100,0.001,0.01,0.99,0.999845009299442,6446,6458
7,13004,10,100,0.001,0.01,0.992,0.9998462011688711,6493,6511
7,13104,10,100,0.001,0.01,0.996,1.0,6548,6556
7,13204,10,100,0.001,0.01,0.992,1.0,6594,6610
7,13304,10,100,0.001,0.01,0.992,1.0,6629,6675
7,13404,10,100,0.001,0.01,0.992,1.0,6675,6729
7,13504,10,100,0.001,0.01,0.992,1.0,6731,6773
7,13604,10,100,0.001,0.01,0.992,1.0,6785,6819
7,13704,10,100,0.001,0.01,0.992,1.0,6833,6871
7,13804,10,100,0.001,0.01,0.992,1.0,6877,6927
7,13904,10,100,0.001,0.01,0.992,1.0,6927,6977
7,14004,10,100,0.001,0.01,0.992,1.0,6979,7025
7,14104,10,100,0.001,0.01,0.992,1.0,7029,7075
7,14204,10,100,0.001,0.01,0.974,0.9819769079132639,7085,7119
7,14304,10,100,0.001,0.01,0.972,0.9879054809843401,7136,7168
7,14404,10,100,0.001,0.01,0.99,0.9953485143015829,7181,7223
7,14504,10,100,0.001,0.01,0.992,0.9995173745173745,7233,7271
7,14604,10,100,0.001,0.01,0.994,0.9991783073130649,7291,7313
7,14704,10,100,0.001,0.01,0.994,0.999455930359086,7340,7364
7,14804,10,100,0.001,0.01,0.996,1.0,7393,7411
7,14904,10,100,0.001,0.01,0.994,0.9999329039184112,7432,7472
7,15004,10,100,0.001,0.01,0.994,0.9996667555318581,7492,7512
8,104,10,100,0.001,0.01,0.528,0.7307692307692307,49,55
8,204,10,100,0.001,0.01,0.498,0.5588235294117647,107,97
8,304,10,100,0.001,0.01,0.482,0.6480263157894737,158,146
8,404,10,100,0.001,0.01,0.514,0.6658415841584159,212,192
8,504,10,100,0.001,0.01,0.516,0.626984126984127,261,243
8,604,10,100,0.001,0.01,0.52,0.6125827814569537,306,298
8,704,10,100,0.001,0.01,0.542,0.6605113636363636,368,336
8,804,10,100,0.001,0.01,0.5,0.6654228855721394,421,383
8,904,10,100,0.001,0.01,0.506,0.6482300884955752,468,436
8,1004,10,100,0.001,0.01,0.508,0.7071713147410359,513,491
8,1104,10,100,0.001,0.01,0.506,0.707427536231884,560,544
8,1204,10,100,0.001,0.01,0.528,0.686046511627907,612,592
8,1304,10,100,0.001,0.01,0.49,0.6955521472392638,654,650
8,1404,10,100,0.001,0.01,0.496,0.7471509971509972,713,691
8,1504,10,100,0.001,0.01,0.49,0.738031914893617,766,738
8,1604,10,100,0.001,0.01,0.5,0.7450124688279302,820,784
8,1704,10,100,0.001,0.01,0.478,0.7312206572769953,871,833
8,1804,10,100,0.001,0.01,0.488,0.7594235033259423,918,886
8,1904,10,100,0.001,0.01,0.512,0.7773109243697479,967,937
8,2004,10,100,0.001,0.01,0.538,0.8068862275449101,1021,983
8,2104,10,100,0.001,0.01,0.534,0.7709125475285171,1078,1026
8,2204,10,100,0.001,0.01,0.566,0.8112522686025408,1123,1081
8,2304,10,100,0.001,0.01,0.546,0.8194444444444444,1167,1137
8,2404,10,100,0.001,0.01,0.552,0.8306988352745425,1216,1188
8,2504,10,100,0.001,0.01,0.586,0.8138977635782748,1262,1242
8,2604,10,100,0.001,0.01,0.578,0.793778801843318,1316,1288
8,2704,10,100,0.001,0.01,0.556,0.830991124260355,1365,1339
8,2804,10,100,0.001,0.01,0.606,0.8684022824536377,1422,1382
8,2904,10,100,0.001,0.01,0.61,0.8836088154269972,1480,1424
8,3004,10,100,0.001,0.01,0.644,0.892809587217044,1530,1474
8,3104,10,100,0.001,0.01,0.666,0.8817654639175257,1592,1512
8,3204,10,100,0.001,0.01,0.654,0.91167290886392,1645,1559
8,3304,10,100,0.001,0.01,0.658,0.9085956416464891,1694,1610
8,3404,10,100,0.001,0.01,0.702,0.8927732079905993,1737,1667
8,3504,10,100,0.001,0.01,0.736,0.9246575342465754,1787,1717
8,3604,10,100,0.001,0.01,0.768,0.947558268590455,1841,1763
8,3704,10,100,0.001,0.01,0.772,0.9692224622030238,1888,1816
8,3804,10,100,0.001,0.01,0.736,0.9505783385909569,1943,1861
8,3904,10,100,0.001,0.01,0.762,0.9282786885245902,1989,1915
8,4004,10,100,0.001,0.01,0.81,0.9572927072927073,2031,1973
8,4104,10,100,0.001,0.01,0.812,0.9619883040935673,2081,2023
8,4204,10,100,0.001,0.01,0.806,0.9636060894386299,2135,2069
8,4304,10,100,0.001,0.01,0.802,0.9472583643122676,2183,2121
8,4404,10,100,0.001,0.01,0.828,0.9827429609445958,2225,2179
8,4504,10,100,0.001,0.01,0.846,0.9931172291296625,2283,2221
8,4604,10,100,0.001,0.01,0.836,0.9830582102519548,2331,2273
8,4704,10,100,0.001,0.01,0.86,0.9787414965986394,2381,2323
8,4804,10,100,0.001,0.01,0.872,0.9725228975853455,2433,2371
8,4904,10,100,0.001,0.01,0.876,0.9918433931484503,2481,2423
8,5004,10,100,0.001,0.01,0.884,0.9932054356514788,2520,2484
8,5104,10,100,0.001,0.01,0.886,0.9939263322884012,2567,2537
8,5204,10,100,0.001,0.01,0.898,0.9971176018447349,2612,2592
8,5304,10,100,0.001,0.01,0.908,0.9983031674208145,2675,2629
8,5404,10,100,0.001,0.01,0.904,0.9972242783123613,2725,2679
8,5504,10,100,0.001,0.01,0.89,0.9671148255813954,2770,2734
8,5604,10,100,0.001,0.01,0.918,0.987152034261242,2817,2787
8,5704,10,100,0.001,0.01,0.906,0.989656381486676,2867,2837
8,5804,10,100,0.001,0.01,0.916,0.9946588559614059,2912,2892
8,5904,10,100,0.001,0.01,0.92,0.9900067750677507,2964,2940
8,6004,10,100,0.001,0.01,0.922,0.9868421052631579,3017,2987
8,6104,10,100,0.001,0.01,0.91,0.9895150720838795,3064,3040
8,6204,10,100,0.001,0.01,0.928,0.9906511927788524,3108,3096
8,6304,10,100,0.001,0.01,0.914,0.985247461928934,3154,3150
8,6404,10,100,0.001,0.01,0.92,0.9926608369768894,3208,3196
8,6504,10,100,0.001,0.01,0.936,0.9956949569495694,3257,3247
8,6604,10,100,0.001,0.01,0.926,0.9947001817080557,3303,3301
8,6704,10,100,0.001,0.01,0.924,0.9980608591885441,3349,3355
8,6804,10,100,0.001,0.01,0.914,0.9941211052322163,3392,3412
8,6904,10,100,0.001,0.01,0.918,0.9992757821552724,3431,3473
8,7004,10,100,0.001,0.01,0.928,0.9964306110793832,3482,3522
8,7104,10,100,0.001,0.01,0.932,0.997043918918919,3533,3571
8,7204,10,100,0.001,0.01,0.93,0.9948639644641866,3581,3623
8,7304,10,100,0.001,0.01,0.914,0.9832968236582694,3633,3671
8,7404,10,100,0.001,0.01,0.914,0.9773095623987034,3682,3722
8,7504,10,100,0.001,0.01,0.944,0.9916044776119403,3738,3766
8,7604,10,100,0.001,0.01,0.936,0.9944765912677538,3787,3817
8,7704,10,100,0.001,0.01,0.934,0.9976635514018691,3831,3873
8,7804,10,100,0.001,0.01,0.94,0.9919272168118913,3882,3922
8,7904,10,100,0.001,0.01,0.958,0.9932945344129555,3937,3967
8,8004,10,100,0.001,0.01,0.932,0.9952523738130935,3989,4015
8,8104,10,100,0.001,0.01,0.948,0.9913622902270484,4029,4075
8,8204,10,100,0.001,0.01,0.94,0.9919551438322769,4078,4126
8,8304,10,100,0.001,0.01,0.954,0.9979527938342967,4130,4174
8,8404,10,100,0.001,0.01,0.964,0.9884578772013327,4179,4225
8,8504,10,100,0.001,0.01,0.95,0.989181561618062,4238,4266
8,8604,10,100,0.001,0.01,0.956,0.9943049744304975,4287,4317
8,8704,10,100,0.001,0.01,0.96,0.9964384191176471,4344,4360
8,8804,10,100,0.001,0.01,0.958,0.9975011358473421,4399,4405
8,8904,10,100,0.001,0.01,0.96,0.998989218328841,4445,4459
8,9004,10,100,0.001,0.01,0.964,0.9992225677476677,4496,4508
8,9104,10,100,0.001,0.01,0.964,0.9975834797891037,4549,4555
8,9204,10,100,0.001,0.01,0.964,0.9980443285528031,4592,4612
8,9304,10,100,0.001,0.01,0.962,0.9979578675838349,4641,4663
8,9404,10,100,0.001,0.01,0.978,0.9965971926839643,4700,4704
8,9504,10,100,0.001,0.01,0.972,0.9988425925925926,4751,4753
8,9604,10,100,0.001,0.01,0.972,0.9997917534360683,4796,4808
8,9704,10,100,0.001,0.01,0.974,1.0,4846,4858
8,9804,10,100,0.001,0.01,0.968,0.996532027743778,4897,4907
8,9904,10,100,0.001,0.01,0.972,0.9969709208400647,4949,4955
8,10004,10,100,0.001,0.01,0.968,0.9895041983206717,4993,5011
8,10104,10,100,0.001,0.01,0.966,0.9972288202692003,5044,5060
8,10204,10,100,0.001,0.01,0.976,0.9941199529596236,5093,5111
8,10304,10,100,0.001,0.01,0.97,0.9938858695652174,5135,5169
8,10404,10,100,0.001,0.01,0.982,0.9926951172625913,5180,5224
8,10504,10,100,0.001,0.01,0.974,0.9937166793602438,5229,5275
8,10604,10,100,0.001,0.01,0.976,0.9917955488494907,5266,5338
8,10704,10,100,0.001,0.01,0.972,0.9971038863976084,5323,5381
8,10804,10,100,0.001,0.01,0.974,0.9836171788226583,5378,5426
8,10904,10,100,0.001,0.01,0.972,0.9903705062362436,5424,5480
8,11004,10,100,0.001,0.01,0.97,0.9908215194474737,5469,5535
8,11104,10,100,0.001,0.01,0.984,0.9982889048991355,5529,5575
8,11204,10,100,0.001,0.01,0.98,0.9990182077829347,5580,5624
8,11304,10,100,0.001,0.01,0.986,0.9991153573956122,5636,5668
8,11404,10,100,0.001,0.01,0.986,1.0,5686,5718
8,11504,10,100,0.001,0.01,0.988,0.9999130737134909,5734,5770
8,11604,10,100,0.001,0.01,0.988,1.0,5786,5818
8,11704,10,100,0.001,0.01,0.986,1.0,5839,5865
8,11804,10,100,0.001,0.01,0.986,1.0,5883,5921
8,11904,10,100,0.001,0.01,0.986,0.9995799731182796,5937,5967
8,12004,10,100,0.001,0.01,0.982,0.9996667777407531,5984,6020
8,12104,10,100,0.001,0.01,0.986,0.999256444150694,6039,6065
8,12204,10,100,0.001,0.01,0.978,0.995575221238938,6092,6112
8,12304,10,100,0.001,0.01,0.988,0.99601755526658,6142,6162
8,12404,10,100,0.001,0.01,0.968,0.9827475008061916,6195,6209
8,12504,10,100,0.001,0.01,0.982,0.9951215611004478,6250,6254
8,12604,10,100,0.001,0.01,0.986,0.9981751824817519,6307,6297
8,12704,10,100,0.001,0.01,0.986,0.9996064231738035,6366,6338
8,12804,10,100,0.001,0.01,0.986,1.0,6409,6395
8,12904,10,100,0.001,0.01,0.99,1.0,6454,6450
8,13004,10,100,0.001,0.01,0.99,1.0,6509,6495
8,13104,10,100,0.001,0.01,0.988,1.0,6558,6546
8,13204,10,100,0.001,0.01,0.988,0.9998485307482581,6610,6594
8,13304,10,100,0.001,0.01,0.99,0.9999248346361996,6662,6642
8,13404,10,100,0.001,0.01,0.984,0.9983586988958519,6716,6688
8,13504,10,100,0.001,0.01,0.988,0.9965195497630331,6766,6738
8,13604,10,100,0.001,0.01,0.984,0.9966186415760071,6811,6793
8,13704,10,100,0.001,0.01,0.968,0.9787653239929948,6871,6833
8,13804,10,100,0.001,0.01,0.98,0.9950738916256158,6926,6878
8,13904,10,100,0.001,0.01,0.99,0.9978423475258918,6967,6937
8,14004,10,100,0.001,0.01,0.992,0.9990002856326764,7019,6985
8,14104,10,100,0.001,0.01,0.988,0.9979438457175269,7072,7032
8,14204,10,100,0.001,0.01,0.988,0.9992959729653619,7116,7088
8,14304,10,100,0.001,0.01,0.99,0.999650447427293,7166,7138
8,14404,10,100,0.001,0.01,0.992,0.9997222993612885,7218,7186
8,14504,10,100,0.001,0.01,0.992,1.0,7268,7236
8,14604,10,100,0.001,0.01,0.992,1.0,7313,7291
8,14704,10,100,0.001,0.01,0.992,1.0,7358,7346
8,14804,10,100,0.001,0.01,0.992,1.0,7409,7395
8,14904,10,100,0.001,0.01,0.992,1.0,7454,7450
8,15004,10,100,0.001,0.01,0.992,1.0,7503,7501
9,104,10,100,0.001,0.01,0.544,0.5,53,51
9,204,10,100,0.001,0.01,0.468,0.6078431372549019,102,102
9,304,10,100,0.001,0.01,0.46,0.5526315789473685,147,157
9,404,10,100,0.001,0.01,0.49,0.6336633663366337,200,204
9,504,10,100,0.001,0.01,0.488,0.6150793650793651,247,257
9,604,10,100,0.001,0.01,0.432,0.6639072847682119,290,314
9,704,10,100,0.001,0.01,0.464,0.640625,340,364
9,804,10,100,0.001,0.01,0.502,0.6878109452736318,389,415
9,904,10,100,0.001,0.01,0.478,0.6747787610619469,445,459
9,1004,10,100,0.001,0.01,0.52,0.701195219123506,498,506
9,1104,10,100,0.001,0.01,0.52,0.6766304347826086,549,555
9,1204,10,100,0.001,0.01,0.518,0.71843853820598,596,608
9,1304,10,100,0.001,0.01,0.516,0.7085889570552147,651,653
9,1404,10,100,0.001,0.01,0.562,0.7101139601139601,705,699
9,1504,10,100,0.001,0.01,0.506,0.726063829787234,753,751
9,1604,10,100,0.001,0.01,0.532,0.7425187032418953,804,800
9,1704,10,100,0.001,0.01,0.534,0.7411971830985915,850,854
9,1804,10,100,0.001,0.01,0.534,0.7544345898004434,907,897
9,1904,10,100,0.001,0.01,0.542,0.7442226890756303,950,954
9,2004,10,100,0.001,0.01,0.55,0.7634730538922155,989,1015
9,2104,10,100,0.001,0.01,0.532,0.7628326996197718,1044,1060
9,2204,10,100,0.001,0.01,0.528,0.7826678765880217,1093,1111
9,2304,10,100,0.001,0.01,0.568,0.7981770833333334,1138,1166
9,2404,10,100,0.001,0.01,0.562,0.8078202995008319,1184,1220
9,2504,10,100,0.001,0.01,0.572,0.8458466453674122,1234,1270
9,2604,10,100,0.001,0.01,0.586,0.8636712749615976,1284,1320
9,2704,10,100,0.001,0.01,0.606,0.8849852071005917,1331,1373
9,2804,10,100,0.001,0.01,0.594,0.9033523537803139,1379,1425
9,2904,10,100,0.001,0.01,0.59,0.8477961432506887,1429,1475
9,3004,10,100,0.001,0.01,0.608,0.861185086551265,1478,1526
9,3104,10,100,0.001,0.01,0.652,0.9191365979381443,1531,1573
9,3204,10,100,0.001,0.01,0.664,0.9257178526841449,1579,1625
9,3304,10,100,0.001,0.01,0.662,0.9421912832929782,1633,1671
9,3404,10,100,0.001,0.01,0.668,0.9556404230317274,1691,1713
9,3504,10,100,0.001,0.01,0.682,0.951769406392694,1737,1767
9,3604,10,100,0.001,0.01,0.71,0.9389567147613762,1786,1818
9,3704,10,100,0.001,0.01,0.718,0.9198164146868251,1829,1875
9,3804,10,100,0.001,0.01,0.736,0.9461093585699264,1878,1926
9,3904,10,100,0.001,0.01,0.73,0.9533811475409836,1930,1974
9,4004,10,100,0.001,0.01,0.752,0.9555444555444556,1975,2029
9,4104,10,100,0.001,0.01,0.776,0.9437134502923976,2024,2080
9,4204,10,100,0.001,0.01,0.76,0.9419600380589914,2086,2118
9,4304,10,100,0.001,0.01,0.744,0.8961431226765799,2136,2168
9,4404,10,100,0.001,0.01,0.778,0.9336966394187103,2187,2217
9,4504,10,100,0.001,0.01,0.76,0.9298401420959147,2241,2263
9,4604,10,100,0.001,0.01,0.78,0.9533014769765421,2289,2315
9,4704,10,100,0.001,0.01,0.816,0.9736394557823129,2345,2359
9,4804,10,100,0.001,0.01,0.834,0.9816819317235637,2391,2413
9,4904,10,100,0.001,0.01,0.824,0.9877650897226754,2443,2461
9,5004,10,100,0.001,0.01,0.838,0.9960031974420464,2500,2504
9,5104,10,100,0.001,0.01,0.836,0.9949059561128527,2549,2555
9,5204,10,100,0.001,0.01,0.84,0.9913528055342045,2605,2599
9,5304,10,100,0.001,0.01,0.816,0.976998491704374,2660,2644
9,5404,10,100,0.001,0.01,0.85,0.9927831236121392,2707,2697
9,5504,10,100,0.001,0.01,0.864,0.9827398255813954,2761,2743
9,5604,10,100,0.001,0.01,0.854,0.9867951463240543,2814,2790
9,5704,10,100,0.001,0.01,0.858,0.9873772791023843,2872,2832
9,5804,10,100,0.001,0.01,0.88,0.9913852515506547,2921,2883
9,5904,10,100,0.001,0.01,0.88,0.997289972899729,2966,2938
9,6004,10,100,0.001,0.01,0.886,0.9986675549633578,3015,2989
9,6104,10,100,0.001,0.01,0.896,0.9998361730013107,3060,3044
9,6204,10,100,0.001,0.01,0.884,0.9988716956802063,3122,3082
9,6304,10,100,0.001,0.01,0.894,0.9961928934010152,3176,3128
9,6404,10,100,0.001,0.01,0.902,0.9979700187382886,3221,3183
9,6504,10,100,0.001,0.01,0.9,0.9958487084870848,3272,3232
9,6604,10,100,0.001,0.01,0.882,0.9771350696547547,3311,3293
9,6704,10,100,0.001,0.01,0.884,0.9750894988066826,3359,3345
9,6804,10,100,0.001,0.01,0.888,0.979864785420341,3403,3401
9,6904,10,100,0.001,0.01,0.898,0.9695828505214369,3453,3451
9,7004,10,100,0.001,0.01,0.898,0.9847230154197602,3501,3503
9,7104,10,100,0.001,0.01,0.924,0.9971846846846847,3550,3554
9,7204,10,100,0.001,0.01,0.93,0.998611882287618,3606,3598
9,7304,10,100,0.001,0.01,0.932,0.9971248630887185,3661,3643
9,7404,10,100,0.001,0.01,0.924,0.9986493787142086,3711,3693
9,7504,10,100,0.001,0.01,0.934,0.9996002132196162,3764,3740
9,7604,10,100,0.001,0.01,0.94,0.9996054708048395,3818,3786
9,7704,10,100,0.001,0.01,0.934,0.9997403946002077,3874,3830
9,7804,10,100,0.001,0.01,0.934,0.9966683751922091,3928,3876
9,7904,10,100,0.001,0.01,0.928,0.9930414979757085,3977,3927
9,8004,10,100,0.001,0.01,0.938,0.993128435782109,4040,3964
9,8104,10,100,0.001,0.01,0.942,0.9953109575518263,4088,4016
9,8204,10,100,0.001,0.01,0.936,0.9937835202340322,4134,4070
9,8304,10,100,0.001,0.01,0.944,0.9979527938342967,4181,4123
9,8404,10,100,0.001,0.01,0.954,0.995478343645883,4224,4180
9,8504,10,100,0.001,0.01,0.952,0.9958842897460018,4273,4231
9,8604,10,100,0.001,0.01,0.938,0.9936076243607624,4317,4287
9,8704,10,100,0.001,0.01,0.942,0.9928768382352942,4367,4337
9,8804,10,100,0.001,0.01,0.958,0.9942071785552021,4407,4397
9,8904,10,100,0.001,0.01,0.944,0.9891060197663971,4465,4439
9,9004,10,100,0.001,0.01,0.952,0.9956685917370057,4512,4492
9,9104,10,100,0.001,0.01,0.962,0.9986818980667839,4560,4544
9,9204,10,100,0.001,0.01,0.96,0.9971751412429378,4600,4604
9,9304,10,100,0.001,0.01,0.966,0.9979578675838349,4650,4654
9,9404,10,100,0.001,0.01,0.968,0.9977669076988516,4702,4702
9,9504,10,100,0.001,0.01,0.97,0.9954755892255892,4754,4750
9,9604,10,100,0.001,0.01,0.954,0.9976051645147855,4809,4795
9,9704,10,100,0.001,0.01,0.956,0.9909315746084089,4851,4853
9,9804,10,100,0.001,0.01,0.954,0.9922480620155039,4896,4908
9,9904,10,100,0.001,0.01,0.962,0.995456381260097,4947,4957
9,10004,10,100,0.001,0.01,0.96,0.9911035585765694,5001,5003
9,10104,10,100,0.001,0.01,0.952,0.9915874901029296,5043,5061
9,10204,10,100,0.001,0.01,0.974,0.9987259898079185,5100,5104
9,10304,10,100,0.001,0.01,0.972,0.9983501552795031,5145,5159
9,10404,10,100,0.001,0.01,0.98,0.9988465974625144,5199,5205
9,10504,10,100,0.001,0.01,0.984,0.9994287890327495,5254,5250
9,10604,10,100,0.001,0.01,0.976,0.9997170878913617,5305,5299
9,10704,10,100,0.001,0.01,0.968,0.9968236173393124,5359,5345
9,10804,10,100,0.001,0.01,0.982,0.9988893002591632,5401,5403
9,10904,10,100,0.001,0.01,0.976,0.9994497432134997,5444,5460
9,11004,10,100,0.001,0.01,0.976,0.997364594692839,5496,5508
9,11104,10,100,0.001,0.01,0.976,0.9978386167146974,5552,5552
9,11204,10,100,0.001,0.01,0.976,0.9955373081042485,5607,5597
9,11304,10,100,0.001,0.01,0.968,0.9943382873319179,5651,5653
9,11404,10,100,0.001,0.01,0.98,0.9940371799368642,5704,5700
9,11504,10,100,0.001,0.01,0.982,0.9949582753824756,5749,5755
9,11604,10,100,0.001,0.01,0.978,0.9972423302309549,5798,5806
9,11704,10,100,0.001,0.01,0.974,0.9972658920027341,5843,5861
9,11804,10,100,0.001,0.01,0.982,0.9978820738732633,5893,5911
9,11904,10,100,0.001,0.01,0.98,0.9996639784946236,5945,5959
9,12004,10,100,0.001,0.01,0.976,0.9997500833055648,5998,6006
9,12104,10,100,0.001,0.01,0.972,0.9952081956378057,6049,6055
9,12204,10,100,0.001,0.01,0.986,0.9990167158308751,6098,6106
9,12304,10,100,0.001,0.01,0.984,0.9991872561768531,6147,6157
9,12404,10,100,0.001,0.01,0.984,0.9997581425346662,6203,6201
9,12504,10,100,0.001,0.01,0.978,0.9988003838771593,6253,6251
9,12604,10,100,0.001,0.01,0.986,0.9976198032370676,6304,6300
9,12704,10,100,0.001,0.01,0.976,0.9963003778337531,6349,6355
9,12804,10,100,0.001,0.01,0.96,0.9861761949390815,6397,6407
9,12904,10,100,0.001,0.01,0.978,0.9950402975821451,6444,6460
9,13004,10,100,0.001,0.01,0.976,0.9953091356505691,6491,6513
9,13104,10,100,0.001,0.01,0.986,0.9973290598290598,6534,6570
9,13204,10,100,0.001,0.01,0.994,0.9987125113601939,6587,6617
9,13304,10,100,0.001,0.01,0.986,0.9996241731809982,6632,6672
9,13404,10,100,0.001,0.01,0.99,0.9997015816174276,6681,6723
9,13504,10,100,0.001,0.01,0.992,0.9998518957345972,6720,6784
9,13604,10,100,0.001,0.01,0.992,0.9990443987062628,6765,6839
9,13704,10,100,0.001,0.01,0.986,0.9985405720957384,6827,6877
9,13804,10,100,0.001,0.01,0.984,0.9949290060851927,6877,6927
9,13904,10,100,0.001,0.01,0.99,0.9969073647871116,6927,6977
9,14004,10,100,0.001,0.01,0.978,0.9961439588688946,6985,7019
9,14104,10,100,0.001,0.01,0.984,0.9974475326148611,7030,7074
9,14204,10,100,0.001,0.01,0.986,0.996620670233737,7072,7132
9,14304,10,100,0.001,0.01,0.984,0.997832774049217,7121,7183
9,14404,10,100,0.001,0.01,0.984,0.9975006942515968,7171,7233
9,14504,10,100,0.001,0.01,0.99,1.0,7229,7275
9,14604,10,100,0.001,0.01,0.99,1.0,7276,7328
9,14704,10,100,0.001,0.01,0.992,0.9996599564744287,7326,7378
9,14804,10,100,0.001,0.01,0.988,0.9987841124020534,7380,7424
9,14904,10,100,0.001,0.01,0.994,0.9992619431025228,7425,7479
9,15004,10,100,0.001,0.01,0.99,0.9993335110637164,7480,7524
10,104,10,100,0.001,0.01,0.488,0.5673076923076923,50,54
10,204,10,100,0.001,0.01,0.514,0.6617647058823529,96,108
10,304,10,100,0.001,0.01,0.502,0.6217105263157895,145,159
10,404,10,100,0.001,0.01,0.5,0.6237623762376238,199,205
10,504,10,100,0.001,0.01,0.506,0.6170634920634921,251,253
10,604,10,100,0.001,0.01,0.506,0.6440397350993378,303,301
10,704,10,100,0.001,0.01,0.524,0.6548295454545454,349,355
10,804,10,100,0.001,0.01,0.528,0.6629353233830846,401,403
10,904,10,100,0.001,0.01,0.518,0.661504424778761,450,454
10,1004,10,100,0.001,0.01,0.52,0.6832669322709163,500,504
10,1104,10,100,0.001,0.01,0.514,0.6820652173913043,544,560
10,1204,10,100,0.001,0.01,0.498,0.6993355481727574,594,610
10,1304,10,100,0.001,0.01,0.504,0.7085889570552147,644,660
10,1404,10,100,0.001,0.01,0.51,0.7172364672364673,699,705
10,1504,10,100,0.001,0.01,0.512,0.6848404255319149,753,751
10,1604,10,100,0.001,0.01,0.484,0.7231920199501247,794,810
10,1704,10,100,0.001,0.01,0.49,0.7071596244131455,849,855
10,1804,10,100,0.001,0.01,0.5,0.7472283813747228,905,899
10,1904,10,100,0.001,0.01,0.484,0.7463235294117647,963,941
10,2004,10,100,0.001,0.01,0.514,0.7604790419161677,1011,993
10,2104,10,100,0.001,0.01,0.486,0.782319391634981,1061,1043
10,2204,10,100,0.001,0.01,0.54,0.7917422867513612,1107,1097
10,2304,10,100,0.001,0.01,0.528,0.7556423611111112,1161,1143
10,2404,10,100,0.001,0.01,0.556,0.8024126455906821,1211,1193
10,2504,10,100,0.001,0.01,0.558,0.8087060702875399,1266,1238
10,2604,10,100,0.001,0.01,0.62,0.8598310291858678,1322,1282
10,2704,10,100,0.001,0.01,0.6,0.8461538461538461,1375,1329
10,2804,10,100,0.001,0.01,0.608,0.8459343794579173,1422,1382
10,2904,10,100,0.001,0.01,0.6,0.8691460055096418,1473,1431
10,3004,10,100,0.001,0.01,0.654,0.90745672436751,1520,1484
10,3104,10,100,0.001,0.01,0.688,0.8975515463917526,1576,1528
10,3204,10,100,0.001,0.01,0.678,0.901685393258427,1630,1574
10,3304,10,100,0.001,0.01,0.694,0.8768159806295399,1677,1627
10,3404,10,100,0.001,0.01,0.73,0.9145123384253819,1739,1665
10,3504,10,100,0.001,0.01,0.714,0.9223744292237442,1796,1708
10,3604,10,100,0.001,0.01,0.746,0.9506104328523862,1841,1763
10,3704,10,100,0.001,0.01,0.778,0.964902807775378,1902,1802
10,3804,10,100,0.001,0.01,0.776,0.9692429022082019,1951,1853
10,3904,10,100,0.001,0.01,0.79,0.9769467213114754,2010,1894
10,4004,10,100,0.001,0.01,0.82,0.98001998001998,2065,1939
10,4104,10,100,0.001,0.01,0.824,0.9846491228070176,2114,1990
10,4204,10,100,0.001,0.01,0.82,0.9897716460513797,2165,2039
10,4304,10,100,0.001,0.01,0.836,0.9642193308550185,2219,2085
10,4404,10,100,0.001,0.01,0.832,0.976158038147139,2269,2135
10,4504,10,100,0.001,0.01,0.854,0.9893428063943162,2326,2178
10,4604,10,100,0.001,0.01,0.866,0.9891398783666377,2368,2236
10,4704,10,100,0.001,0.01,0.88,0.9965986394557823,2414,2290
10,4804,10,100,0.001,0.01,0.89,0.9933388842631141,2463,2341
10,4904,10,100,0.001,0.01,0.9,0.9898042414355628,2515,2389
10,5004,10,100,0.001,0.01,0.89,0.9918065547561951,2555,2449
10,5104,10,100,0.001,0.01,0.876,0.9733542319749217,2613,2491
10,5204,10,100,0.001,0.01,0.898,0.9955803228285934,2672,2532
10,5304,10,100,0.001,0.01,0.926,0.9958521870286576,2723,2581
10,5404,10,100,0.001,0.01,0.898,0.9888971132494448,2774,2630
10,5504,10,100,0.001,0.01,0.926,0.9967296511627907,2815,2689
10,5604,10,100,0.001,0.01,0.924,0.9958957887223412,2861,2743
10,5704,10,100,0.001,0.01,0.928,0.9963183730715287,2915,2789
10,5804,10,100,0.001,0.01,0.936,0.9982770503101309,2969,2835
10,5904,10,100,0.001,0.01,0.938,0.9962737127371274,3013,2891
10,6004,10,100,0.001,0.01,0.938,0.9941705529646903,3062,2942
10,6104,10,100,0.001,0.01,0.934,0.9973787680209698,3117,2987
10,6204,10,100,0.001,0.01,0.958,0.9995164410058027,3165,3039
10,6304,10,100,0.001,0.01,0.938,0.9936548223350253,3215,3089
10,6404,10,100,0.001,0.01,0.954,0.9985946283572767,3257,3147
10,6504,10,100,0.001,0.01,0.956,0.998769987699877,3306,3198
10,6604,10,100,0.001,0.01,0.956,0.991671714112659,3352,3252
10,6704,10,100,0.001,0.01,0.928,0.9759844868735084,3408,3296
10,6804,10,100,0.001,0.01,0.94,0.9822163433274544,3465,3339
10,6904,10,100,0.001,0.01,0.956,0.9940614136732329,3524,3380
10,7004,10,100,0.001,0.01,0.958,0.9975728155339806,3570,3434
10,7104,10,100,0.001,0.01,0.964,0.9991554054054054,3618,3486
10,7204,10,100,0.001,0.01,0.968,0.9987506940588562,3660,3544
10,7304,10,100,0.001,0.01,0.96,0.9998630887185104,3709,3595
10,7404,10,100,0.001,0.01,0.97,0.9995948136142626,3760,3644
10,7504,10,100,0.001,0.01,0.962,0.9989339019189766,3813,3691
10,7604,10,100,0.001,0.01,0.978,0.996449237243556,3866,3738
10,7704,10,100,0.001,0.01,0.972,0.9977933541017653,3914,3790
10,7804,10,100,0.001,0.01,0.968,0.998077908764736,3959,3845
10,7904,10,100,0.001,0.01,0.98,0.9982287449392713,4009,3895
10,8004,10,100,0.001,0.01,0.968,0.9987506246876562,4053,3951
10,8104,10,100,0.001,0.01,0.968,0.9942003948667325,4107,3997
10,8204,10,100,0.001,0.01,0.97,0.9981716235982447,4170,4034
10,8304,10,100,0.001,0.01,0.982,0.9983140655105973,4222,4082
10,8404,10,100,0.001,0.01,0.976,0.9988100904331271,4268,4136
10,8504,10,100,0.001,0.01,0.976,1.0,4315,4189
10,8604,10,100,0.001,0.01,0.98,1.0,4363,4241
10,8704,10,100,0.001,0.01,0.978,1.0,4412,4292
10,8804,10,100,0.001,0.01,0.972,0.9948886869604725,4470,4334
10,8904,10,100,0.001,0.01,0.972,0.9975292003593891,4514,4390
10,9004,10,100,0.001,0.01,0.968,0.989227010217681,4566,4438
10,9104,10,100,0.001,0.01,0.972,0.9892355008787346,4619,4485
10,9204,10,100,0.001,0.01,0.974,0.9920686657974793,4665,4539
10,9304,10,100,0.001,0.01,0.974,0.9960232158211522,4725,4579
10,9404,10,100,0.001,0.01,0.976,0.9973415567843471,4777,4627
10,9504,10,100,0.001,0.01,0.976,0.9955808080808081,4826,4678
10,9604,10,100,0.001,0.01,0.98,0.9978134110787172,4877,4727
10,9704,10,100,0.001,0.01,0.986,0.9982481450948063,4931,4773
10,9804,10,100,0.001,0.01,0.982,0.9989800081599347,4977,4827
10,9904,10,100,0.001,0.01,0.988,0.9998990306946688,5032,4872
10,10004,10,100,0.001,0.01,0.988,0.9999000399840065,5080,4924
10,10104,10,100,0.001,0.01,0.986,0.9999010292953285,5123,4981
10,10204,10,100,0.001,0.01,0.99,1.0,5176,5028
10,10304,10,100,0.001,0.01,0.99,1.0,5218,5086
10,10404,10,100,0.001,0.01,0.988,1.0,5271,5133
10,10504,10,100,0.001,0.01,0.99,1.0,5323,5181
10,10604,10,100,0.001,0.01,0.986,0.9993398717465107,5375,5229
10,10704,10,100,0.001,0.01,0.986,0.9995328849028401,5428,5276
10,10804,10,100,0.001,0.01,0.99,1.0,5475,5329
10,10904,10,100,0.001,0.01,0.986,0.9996331621423331,5522,5382
10,11004,10,100,0.001,0.01,0.976,0.9932751726644856,5563,5441
10,11104,10,100,0.001,0.01,0.972,0.9878422190201729,5607,5497
10,11204,10,100,0.001,0.01,0.976,0.9932167083184577,5660,5544
10,11304,10,100,0.001,0.01,0.992,0.9986730360934183,5711,5593
10,11404,10,100,0.001,0.01,0.99,0.9996492458786391,5761,5643
10,11504,10,100,0.001,0.01,0.984,0.9996522948539638,5810,5694
10,11604,10,100,0.001,0.01,0.984,0.9995691140985867,5854,5750
10,11704,10,100,0.001,0.01,0.984,0.9995727956254272,5903,5801
10,11804,10,100,0.001,0.01,0.984,0.9981362250084717,5951,5853
10,11904,10,100,0.001,0.01,0.988,0.9997479838709677,5994,5910
10,12004,10,100,0.001,0.01,0.984,0.9985004998333888,6042,5962
10,12104,10,100,0.001,0.01,0.988,0.9991738268341044,6083,6021
10,12204,10,100,0.001,0.01,0.986,0.9973779088823337,6140,6064
10,12304,10,100,0.001,0.01,0.986,0.9968302990897269,6181,6123
10,12404,10,100,0.001,0.01,0.992,0.9991131892937762,6224,6180
10,12504,10,100,0.001,0.01,0.98,0.9896033269353807,6276,6228
10,12604,10,100,0.001,0.01,0.988,0.9969057442081879,6321,6283
10,12704,10,100,0.001,0.01,0.99,0.9989767002518891,6373,6331
10,12804,10,100,0.001,0.01,0.992,0.9991408934707904,6417,6387
10,12904,10,100,0.001,0.01,0.99,0.999845009299442,6473,6431
10,13004,10,100,0.001,0.01,0.99,0.9996924023377423,6525,6479
10,13104,10,100,0.001,0.01,0.986,0.9996947496947497,6575,6529
10,13204,10,100,0.001,0.01,0.994,0.9992426537412905,6625,6579
10,13304,10,100,0.001,0.01,0.99,1.0,6682,6622
10,13404,10,100,0.001,0.01,0.99,1.0,6727,6677
10,13504,10,100,0.001,0.01,0.99,1.0,6783,6721
10,13604,10,100,0.001,0.01,0.99,0.9999264922081741,6833,6771
10,13704,10,100,0.001,0.01,0.976,0.9915353181552832,6881,6823
10,13804,10,100,0.001,0.01,0.986,0.9952187771660388,6932,6872
10,13904,10,100,0.001,0.01,0.98,0.9909378596087457,6982,6922
10,14004,10,100,0.001,0.01,0.99,0.9964295915452728,7028,6976
10,14104,10,100,0.001,0.01,0.982,0.9975893363584799,7071,7033
10,14204,10,100,0.001,0.01,0.982,0.9960574486060265,7129,7075
10,14304,10,100,0.001,0.01,0.99,0.998182326621924,7174,7130
10,14404,10,100,0.001,0.01,0.992,0.9993751735628992,7223,7181
10,14504,10,100,0.001,0.01,0.99,0.9968284611141754,7278,7226
10,14604,10,100,0.001,0.01,0.99,0.9991783073130649,7329,7275
10,14704,10,100,0.001,0.01,0.994,0.9999319912948857,7379,7325
10,14804,10,100,0.001,0.01,0.992,0.9987165630910565,7413,7391
10,14904,10,100,0.001,0.01,0.996,0.9989264626945786,7464,7440
10,15004,10,100,0.001,0.01,0.996,0.9998000533191149,7512,7492
11,104,10,100,0.001,0.01,0.51,0.5480769230769231,52,52
11,204,10,100,0.001,0.01,0.518,0.553921568627451,105,99
11,304,10,100,0.001,0.01,0.514,0.625,159,145
11,404,10,100,0.001,0.01,0.492,0.5717821782178217,212,192
11,504,10,100,0.001,0.01,0.5,0.6507936507936508,255,249
11,604,10,100,0.001,0.01,0.512,0.6076158940397351,300,304
11,704,10,100,0.001,0.01,0.516,0.6292613636363636,349,355
11,804,10,100,0.001,0.01,0.52,0.6256218905472637,401,403
11,904,10,100,0.001,0.01,0.524,0.6238938053097345,460,444
11,1004,10,100,0.001,0.01,0.524,0.6523904382470119,518,486
11,1104,10,100,0.001,0.01,0.542,0.6639492753623188,567,537
11,1204,10,100,0.001,0.01,0.552,0.6918604651162791,605,599
11,1304,10,100,0.001,0.01,0.542,0.6871165644171779,653,651
11,1404,10,100,0.001,0.01,0.548,0.7229344729344729,706,698
11,1504,10,100,0.001,0.01,0.516,0.7147606382978723,751,753
11,1604,10,100,0.001,0.01,0.506,0.7256857855361596,808,796
11,1704,10,100,0.001,0.01,0.556,0.7453051643192489,861,843
11,1804,10,100,0.001,0.01,0.534,0.720620842572062,902,902
11,1904,10,100,0.001,0.01,0.552,0.7184873949579832,968,936
11,2004,10,100,0.001,0.01,0.546,0.7644710578842315,1021,983
11,2104,10,100,0.001,0.01,0.562,0.7747148288973384,1072,1032
11,2204,10,100,0.001,0.01,0.608,0.7958257713248639,1134,1070
11,2304,10,100,0.001,0.01,0.576,0.7660590277777778,1183,1121
11,2404,10,100,0.001,0.01,0.612,0.8074043261231281,1233,1171
11,2504,10,100,0.001,0.01,0.646,0.8386581469648562,1275,1229
11,2604,10,100,0.001,0.01,0.686,0.8559907834101382,1323,1281
11,2704,10,100,0.001,0.01,0.686,0.8539201183431953,1374,1330
11,2804,10,100,0.001,0.01,0.692,0.9012125534950072,1428,1376
11,2904,10,100,0.001,0.01,0.708,0.9028925619834711,1478,1426
11,3004,10,100,0.001,0.01,0.7,0.8988015978695073,1534,1470
11,3104,10,100,0.001,0.01,0.704,0.9004510309278351,1584,1520
11,3204,10,100,0.001,0.01,0.742,0.8573657927590512,1629,1575
11,3304,10,100,0.001,0.01,0.756,0.9037530266343826,1668,1636
11,3404,10,100,0.001,0.01,0.792,0.9245005875440658,1721,1683
11,3504,10,100,0.001,0.01,0.756,0.8975456621004566,1763,1741
11,3604,10,100,0.001,0.01,0.812,0.9389567147613762,1810,1794
11,3704,10,100,0.001,0.01,0.832,0.951133909287257,1862,1842
11,3804,10,100,0.001,0.01,0.834,0.9658254468980021,1917,1887
11,3904,10,100,0.001,0.01,0.882,0.9789959016393442,1963,1941
11,4004,10,100,0.001,0.01,0.844,0.9567932067932068,2014,1990
11,4104,10,100,0.001,0.01,0.808,0.9147173489278753,2064,2040
11,4204,10,100,0.001,0.01,0.868,0.9590865842055185,2113,2091
11,4304,10,100,0.001,0.01,0.87,0.9653810408921933,2173,2131
11,4404,10,100,0.001,0.01,0.91,0.9829700272479565,2219,2185
11,4504,10,100,0.001,0.01,0.91,0.9897868561278863,2264,2240
11,4604,10,100,0.001,0.01,0.936,0.9854474370112946,2312,2292
11,4704,10,100,0.001,0.01,0.882,0.9706632653061225,2359,2345
11,4804,10,100,0.001,0.01,0.912,0.9885512073272273,2408,2396
11,4904,10,100,0.001,0.01,0.936,0.9940864600326265,2454,2450
11,5004,10,100,0.001,0.01,0.95,0.9976019184652278,2497,2507
11,5104,10,100,0.001,0.01,0.946,0.997257053291536,2547,2557
11,5204,10,100,0.001,0.01,0.95,0.9980784012298232,2594,2610
11,5304,10,100,0.001,0.01,0.944,0.9932126696832579,2636,2668
11,5404,10,100,0.001,0.01,0.946,0.9979644707623982,2690,2714
11,5504,10,100,0.001,0.01,0.96,0.9990915697674418,2743,2761
11,5604,10,100,0.001,0.01,0.954,0.9930406852248393,2793,2811
11,5704,10,100,0.001,0.01,0.96,0.9994740532959326,2842,2862
11,5804,10,100,0.001,0.01,0.964,0.9994831150930393,2899,2905
11,5904,10,100,0.001,0.01,0.97,0.9998306233062331,2944,2960
11,6004,10,100,0.001,0.01,0.96,0.9998334443704198,2999,3005
11,6104,10,100,0.001,0.01,0.968,0.9993446920052425,3052,3052
11,6204,10,100,0.001,0.01,0.964,0.9935525467440361,3110,3094
11,6304,10,100,0.001,0.01,0.964,0.9963515228426396,3163,3141
11,6404,10,100,0.001,0.01,0.972,0.9985946283572767,3217,3187
11,6504,10,100,0.001,0.01,0.978,0.9995387453874539,3265,3239
11,6604,10,100,0.001,0.01,0.972,0.9881889763779528,3314,3290
11,6704,10,100,0.001,0.01,0.978,0.9979116945107399,3358,3346
11,6804,10,100,0.001,0.01,0.982,0.9980893592004703,3408,3396
11,6904,10,100,0.001,0.01,0.978,0.9997103128621089,3454,3450
11,7004,10,100,0.001,0.01,0.976,0.9985722444317533,3502,3502
11,7104,10,100,0.001,0.01,0.974,0.9980292792792793,3545,3559
11,7204,10,100,0.001,0.01,0.962,0.9900055524708495,3593,3611
11,7304,10,100,0.001,0.01,0.966,0.9709748083242059,3642,3662
11,7404,10,100,0.001,0.01,0.968,0.993517017828201,3696,3708
11,7504,10,100,0.001,0.01,0.986,0.9973347547974414,3743,3761
11,7604,10,100,0.001,0.01,0.978,0.9981588637559179,3788,3816
11,7704,10,100,0.001,0.01,0.992,0.9992211838006231,3841,3863
11,7804,10,100,0.001,0.01,0.992,0.9997437211686314,3888,3916
11,7904,10,100,0.001,0.01,0.994,1.0,3937,3967
11,8004,10,100,0.001,0.01,0.994,0.9997501249375312,3990,4014
11,8104,10,100,0.001,0.01,0.99,0.9996298124383021,4040,4064
11,8204,10,100,0.001,0.01,0.986,0.9962213554363725,4095,4109
11,8304,10,100,0.001,0.01,0.978,0.9961464354527938,4147,4157
11,8404,10,100,0.001,0.01,0.99,0.9978581627796288,4210,4194
11,8504,10,100,0.001,0.01,0.992,0.9984713076199435,4256,4248
11,8604,10,100,0.001,0.01,0.988,0.999302649930265,4308,4296
11,8704,10,100,0.001,0.01,0.992,0.9994255514705882,4362,4342
11,8804,10,100,0.001,0.01,0.99,0.9994320763289414,4413,4391
11,8904,10,100,0.001,0.01,0.99,0.9998876909254267,4459,4445
11,9004,10,100,0.001,0.01,0.992,0.9997778764993336,4511,4493
11,9104,10,100,0.001,0.01,0.994,1.0,4559,4545
11,9204,10,100,0.001,0.01,0.994,1.0,4612,4592
11,9304,10,100,0.001,0.01,0.986,0.9978503869303526,4657,4647
11,9404,10,100,0.001,0.01,0.988,1.0,4708,4696
11,9504,10,100,0.001,0.01,0.994,1.0,4761,4743
11,9604,10,100,0.001,0.01,0.994,1.0,4815,4789
11,9704,10,100,0.001,0.01,0.992,0.9995877988458368,4869,4835
11,9804,10,100,0.001,0.01,0.992,0.9995920032639739,4920,4884
11,9904,10,100,0.001,0.01,0.992,1.0,4964,4940
11,10004,10,100,0.001,0.01,0.99,0.999000399840064,5016,4988
11,10104,10,100,0.001,0.01,0.986,0.9983174980205859,5066,5038
11,10204,10,100,0.001,0.01,0.98,0.9945119560956488,5114,5090
11,10304,10,100,0.001,0.01,0.978,0.9822399068322981,5169,5135
11,10404,10,100,0.001,0.01,0.988,0.9952902729719338,5216,5188
11,10504,10,100,0.001,0.01,0.978,0.9913366336633663,5265,5239
11,10604,10,100,0.001,0.01,0.996,0.9983968313843833,5313,5291
11,10704,10,100,0.001,0.01,0.996,0.999626307922272,5360,5344
11,10804,10,100,0.001,0.01,0.998,0.9999074416882636,5414,5390
11,10904,10,100,0.001,0.01,0.994,1.0,5468,5436
11,11004,10,100,0.001,0.01,0.994,1.0,5514,5490
11,11104,10,100,0.001,0.01,0.996,0.9999099423631124,5561,5543
11,11204,10,100,0.001,0.01,0.996,1.0,5613,5591
11,11304,10,100,0.001,0.01,0.994,1.0,5670,5634
11,11404,10,100,0.001,0.01,0.994,1.0,5723,5681
11,11504,10,100,0.001,0.01,0.994,0.9996522948539638,5777,5727
11,11604,10,100,0.001,0.01,0.994,0.9977593933126508,5826,5778
11,11704,10,100,0.001,0.01,0.99,0.9972658920027341,5888,5816
11,11804,10,100,0.001,0.01,0.994,0.9998305659098611,5942,5862
11,11904,10,100,0.001,0.01,0.992,0.9971438172043011,6001,5903
11,12004,10,100,0.001,0.01,0.998,0.9997500833055648,6046,5958
11,12104,10,100,0.001,0.01,0.998,0.9996695307336417,6100,6004
11,12204,10,100,0.001,0.01,0.996,0.9997541789577188,6143,6061
11,12304,10,100,0.001,0.01,0.996,0.9995123537061118,6195,6109
11,12404,10,100,0.001,0.01,0.95,0.9712189616252822,6235,6169
11,12504,10,100,0.001,0.01,0.99,0.9944017914267435,6288,6216
11,12604,10,100,0.001,0.01,0.998,0.9975404633449698,6341,6263
11,12704,10,100,0.001,0.01,1.0,0.9996851385390428,6391,6313
11,12804,10,100,0.001,0.01,0.998,0.9992189940643549,6428,6376
11,12904,10,100,0.001,0.01,0.998,0.9997675139491631,6476,6428
11,13004,10,100,0.001,0.01,1.0,1.0,6528,6476
11,13104,10,100,0.001,0.01,1.0,1.0,6567,6537
11,13204,10,100,0.001,0.01,1.0,1.0,6599,6605
11,13304,10,100,0.001,0.01,1.0,1.0,6648,6656
11,13404,10,100,0.001,0.01,0.998,0.9998507908087139,6696,6708
11,13504,10,100,0.001,0.01,1.0,1.0,6748,6756
11,13604,10,100,0.001,0.01,1.0,0.9998529844163482,6800,6804
11,13704,10,100,0.001,0.01,1.0,0.9997081144191476,6844,6860
11,13804,10,100,0.001,0.01,0.996,0.9941321356128658,6891,6913
11,13904,10,100,0.001,0.01,0.994,0.9884205983889528,6943,6961
11,14004,10,100,0.001,0.01,1.0,0.9991431019708654,6991,7013
11,14104,10,100,0.001,0.01,1.0,0.9997163925127623,7040,7064
11,14204,10,100,0.001,0.01,0.998,0.9991551675584343,7087,7117
11,14304,10,100,0.001,0.01,0.994,0.9949664429530202,7136,7168
11,14404,10,100,0.001,0.01,0.996,0.9993751735628992,7190,7214
11,14504,10,100,0.001,0.01,0.998,0.9997931605074463,7241,7263
11,14604,10,100,0.001,0.01,0.994,0.9989728841413311,7294,7310
11,14704,10,100,0.001,0.01,0.998,0.9996599564744287,7345,7359
11,14804,10,100,0.001,0.01,0.998,0.9991218589570386,7399,7405
11,14904,10,100,0.001,0.01,1.0,0.999194847020934,7454,7450
11,15004,10,100,0.001,0.01,0.998,0.999466808850973,7498,7506
12,104,10,100,0.001,0.01,0.478,0.5192307692307693,48,56
12,204,10,100,0.001,0.01,0.492,0.6274509803921569,95,109
12,304,10,100,0.001,0.01,0.514,0.5460526315789473,144,160
12,404,10,100,0.001,0.01,0.472,0.6633663366336634,191,213
12,504,10,100,0.001,0.01,0.456,0.5853174603174603,237,267
12,604,10,100,0.001,0.01,0.452,0.6307947019867549,290,314
12,704,10,100,0.001,0.01,0.47,0.6590909090909091,341,363
12,804,10,100,0.001,0.01,0.502,0.677860696517413,381,423
12,904,10,100,0.001,0.01,0.502,0.668141592920354,433,471
12,1004,10,100,0.001,0.01,0.484,0.6872509960159362,483,521
12,1104,10,100,0.001,0.01,0.474,0.6802536231884058,532,572
12,1204,10,100,0.001,0.01,0.488,0.7018272425249169,580,624
12,1304,10,100,0.001,0.01,0.5,0.7124233128834356,625,679
12,1404,10,100,0.001,0.01,0.51,0.7115384615384616,677,727
12,1504,10,100,0.001,0.01,0.526,0.7287234042553191,722,782
12,1604,10,100,0.001,0.01,0.51,0.7475062344139651,778,826
12,1704,10,100,0.001,0.01,0.56,0.7265258215962441,823,881
12,1804,10,100,0.001,0.01,0.514,0.7167405764966741,877,927
12,1904,10,100,0.001,0.01,0.546,0.7888655462184874,935,969
12,2004,10,100,0.001,0.01,0.588,0.8013972055888223,987,1017
12,2104,10,100,0.001,0.01,0.572,0.8284220532319392,1043,1061
12,2204,10,100,0.001,0.01,0.594,0.8452813067150635,1091,1113
12,2304,10,100,0.001,0.01,0.606,0.8198784722222222,1145,1159
12,2404,10,100,0.001,0.01,0.618,0.8527454242928453,1190,1214
12,2504,10,100,0.001,0.01,0.658,0.8893769968051118,1241,1263
12,2604,10,100,0.001,0.01,0.684,0.8740399385560675,1292,1312
12,2704,10,100,0.001,0.01,0.686,0.8964497041420119,1338,1366
12,2804,10,100,0.001,0.01,0.716,0.8887303851640513,1392,1412
12,2904,10,100,0.001,0.01,0.748,0.9238980716253443,1444,1460
12,3004,10,100,0.001,0.01,0.754,0.9237683089214381,1487,1517
12,3104,10,100,0.001,0.01,0.76,0.9278350515463918,1541,1563
12,3204,10,100,0.001,0.01,0.78,0.9428838951310862,1586,1618
12,3304,10,100,0.001,0.01,0.85,0.9712469733656174,1630,1674
12,3404,10,100,0.001,0.01,0.862,0.9753231492361927,1684,1720
12,3504,10,100,0.001,0.01,0.87,0.9897260273972602,1729,1775
12,3604,10,100,0.001,0.01,0.876,0.9811320754716981,1780,1824
12,3704,10,100,0.001,0.01,0.832,0.9559935205183585,1833,1871
12,3804,10,100,0.001,0.01,0.89,0.979758149316509,1890,1914
12,3904,10,100,0.001,0.01,0.896,0.9874487704918032,1940,1964
12,4004,10,100,0.001,0.01,0.906,0.9872627372627373,1987,2017
12,4104,10,100,0.001,0.01,0.904,0.990009746588694,2044,2060
12,4204,10,100,0.001,0.01,0.928,0.994291151284491,2092,2112
12,4304,10,100,0.001,0.01,0.92,0.9974442379182156,2153,2151
12,4404,10,100,0.001,0.01,0.928,0.9920526793823796,2196,2208
12,4504,10,100,0.001,0.01,0.944,0.997113676731794,2241,2263
12,4604,10,100,0.001,0.01,0.932,0.9950043440486533,2297,2307
12,4704,10,100,0.001,0.01,0.922,0.9893707482993197,2342,2362
12,4804,10,100,0.001,0.01,0.918,0.9885512073272273,2396,2408
12,4904,10,100,0.001,0.01,0.946,0.9916394779771615,2446,2458
12,5004,10,100,0.001,0.01,0.916,0.9872102318145484,2494,2510
12,5104,10,100,0.001,0.01,0.94,0.9941222570532915,2546,2558
12,5204,10,100,0.001,0.01,0.96,0.9959646425826287,2595,2609
12,5304,10,100,0.001,0.01,0.944,0.9922699849170438,2651,2653
12,5404,10,100,0.001,0.01,0.942,0.9938934122871946,2706,2698
12,5504,10,100,0.001,0.01,0.966,0.9978197674418605,2750,2754
12,5604,10,100,0.001,0.01,0.962,0.9953604568165596,2803,2801
12,5704,10,100,0.001,0.01,0.962,0.9971949509116409,2853,2851
12,5804,10,100,0.001,0.01,0.964,0.994486560992419,2907,2897
12,5904,10,100,0.001,0.01,0.96,0.9969512195121951,2950,2954
12,6004,10,100,0.001,0.01,0.964,0.9995003331112592,3003,3001
12,6104,10,100,0.001,0.01,0.978,0.9980340760157274,3055,3049
12,6204,10,100,0.001,0.01,0.972,0.9970986460348162,3104,3100
12,6304,10,100,0.001,0.01,0.974,0.9996827411167513,3152,3152
12,6404,10,100,0.001,0.01,0.976,0.9993753903810119,3206,3198
12,6504,10,100,0.001,0.01,0.974,0.9989237392373924,3253,3251
12,6604,10,100,0.001,0.01,0.98,0.9978800726832223,3298,3306
12,6704,10,100,0.001,0.01,0.974,0.9947792362768496,3340,3364
12,6804,10,100,0.001,0.01,0.926,0.9466490299823633,3383,3421
12,6904,10,100,0.001,0.01,0.964,0.9879779837775203,3423,3481
12,7004,10,100,0.001,0.01,0.97,0.9944317532838378,3484,3520
12,7104,10,100,0.001,0.01,0.98,0.9976069819819819,3531,3573
12,7204,10,100,0.001,0.01,0.974,0.9952803997779012,3584,3620
12,7304,10,100,0.001,0.01,0.984,0.9982201533406353,3632,3672
12,7404,10,100,0.001,0.01,0.984,0.9978390059427337,3681,3723
12,7504,10,100,0.001,0.01,0.974,0.99613539445629,3730,3774
12,7604,10,100,0.001,0.01,0.976,0.9940820620725934,3788,3816
12,7704,10,100,0.001,0.01,0.984,0.9970145379023884,3842,3862
12,7804,10,100,0.001,0.01,0.982,0.9969246540235777,3893,3911
12,7904,10,100,0.001,0.01,0.98,0.9991143724696356,3952,3952
12,8004,10,100,0.001,0.01,0.98,0.9966266866566716,4009,3995
12,8104,10,100,0.001,0.01,0.99,0.9967917077986179,4061,4043
12,8204,10,100,0.001,0.01,0.988,0.9987810823988298,4112,4092
12,8304,10,100,0.001,0.01,0.982,0.9963872832369942,4170,4134
12,8404,10,100,0.001,0.01,0.984,0.9969062351261304,4221,4183
12,8504,10,100,0.001,0.01,0.988,0.9987064910630291,4281,4223
12,8604,10,100,0.001,0.01,0.984,0.9940725244072525,4327,4277
12,8704,10,100,0.001,0.01,0.992,0.9988511029411765,4381,4323
12,8804,10,100,0.001,0.01,0.982,0.9932985006815084,4425,4379
12,8904,10,100,0.001,0.01,0.98,0.993486073674753,4474,4430
12,9004,10,100,0.001,0.01,0.984,0.9917814304753443,4526,4478
12,9104,10,100,0.001,0.01,0.986,0.9951669595782073,4570,4534
12,9204,10,100,0.001,0.01,0.978,0.9898956975228161,4610,4594
12,9304,10,100,0.001,0.01,0.982,0.9965606190885641,4659,4645
12,9404,10,100,0.001,0.01,0.988,0.9945767758400681,4715,4689
12,9504,10,100,0.001,0.01,0.988,0.9969486531986532,4765,4739
12,9604,10,100,0.001,0.01,0.988,0.9988546438983756,4811,4793
12,9704,10,100,0.001,0.01,0.986,0.999484748557296,4857,4847
12,9804,10,100,0.001,0.01,0.988,0.9996940024479805,4899,4905
12,9904,10,100,0.001,0.01,0.984,0.999394184168013,4955,4949
12,10004,10,100,0.001,0.01,0.992,0.9994002399040384,4997,5007
12,10104,10,100,0.001,0.01,0.99,0.998812351543943,5051,5053
12,10204,10,100,0.001,0.01,0.994,0.9995099960799686,5102,5102
12,10304,10,100,0.001,0.01,0.988,0.9956327639751553,5157,5147
12,10404,10,100,0.001,0.01,0.984,0.9948096885813149,5203,5201
12,10504,10,100,0.001,0.01,0.99,0.9979055597867479,5258,5246
12,10604,10,100,0.001,0.01,0.988,0.9987740475292343,5315,5289
12,10704,10,100,0.001,0.01,0.982,0.9955156950672646,5368,5336
12,10804,10,100,0.001,0.01,0.99,0.9953720844131803,5422,5382
12,10904,10,100,0.001,0.01,0.988,0.9981658107116654,5471,5433
12,11004,10,100,0.001,0.01,0.988,0.9972737186477645,5513,5491
12,11104,10,100,0.001,0.01,0.972,0.9922550432276657,5564,5540
12,11204,10,100,0.001,0.01,0.99,0.9962513388075688,5609,5595
12,11304,10,100,0.001,0.01,0.99,0.9973460721868365,5663,5641
12,11404,10,100,0.001,0.01,0.994,0.9989477376359173,5705,5699
12,11504,10,100,0.001,0.01,0.99,0.9980876216968011,5763,5741
12,11604,10,100,0.001,0.01,0.994,0.9981902792140641,5805,5799
12,11704,10,100,0.001,0.01,0.992,0.9967532467532467,5859,5845
12,11804,10,100,0.001,0.01,0.99,0.997458488647916,5902,5902
12,11904,10,100,0.001,0.01,0.994,0.9976478494623656,5950,5954
12,12004,10,100,0.001,0.01,0.988,0.9936687770743086,5992,6012
12,12104,10,100,0.001,0.01,0.99,0.9980998017184401,6044,6060
12,12204,10,100,0.001,0.01,0.994,0.9963946247132088,6091,6113
12,12304,10,100,0.001,0.01,0.996,0.9980494148244473,6138,6166
12,12404,10,100,0.001,0.01,0.98,0.9909706546275395,6185,6219
12,12504,10,100,0.001,0.01,0.996,0.9988003838771593,6228,6276
12,12604,10,100,0.001,0.01,0.996,0.9998413202158045,6274,6330
12,12704,10,100,0.001,0.01,0.996,0.9995277078085643,6325,6379
12,12804,10,100,0.001,0.01,0.996,0.999687597625742,6370,6434
12,12904,10,100,0.001,0.01,0.998,0.999845009299442,6414,6490
12,13004,10,100,0.001,0.01,0.998,0.9998462011688711,6470,6534
12,13104,10,100,0.001,0.01,0.998,1.0,6521,6583
12,13204,10,100,0.001,0.01,0.998,1.0,6577,6627
12,13304,10,100,0.001,0.01,0.994,0.9994738424533974,6632,6672
12,13404,10,100,0.001,0.01,0.992,0.9967920023873471,6683,6721
12,13504,10,100,0.001,0.01,0.996,0.9981486966824644,6741,6763
12,13604,10,100,0.001,0.01,0.994,0.9991179064980888,6791,6813
12,13704,10,100,0.001,0.01,0.988,0.9941622883829538,6847,6857
12,13804,10,100,0.001,0.01,0.988,0.9969574036511156,6891,6913
12,13904,10,100,0.001,0.01,0.994,0.9996403912543153,6952,6952
12,14004,10,100,0.001,0.01,0.994,0.9995715509854327,7012,6992
12,14104,10,100,0.001,0.01,0.996,1.0,7061,7043
12,14204,10,100,0.001,0.01,0.998,1.0,7117,7087
12,14304,10,100,0.001,0.01,0.998,0.9999300894854586,7170,7134
12,14404,10,100,0.001,0.01,0.998,0.9986809219661206,7214,7190
12,14504,10,100,0.001,0.01,0.986,0.9939327082184225,7268,7236
12,14604,10,100,0.001,0.01,0.99,0.9973979731580389,7322,7282
12,14704,10,100,0.001,0.01,0.99,0.9939472252448314,7372,7332
12,14804,10,100,0.001,0.01,0.996,0.9973655768711159,7415,7389
12,14904,10,100,0.001,0.01,0.994,0.9992619431025228,7463,7441
12,15004,10,100,0.001,0.01,0.992,0.9989336177019461,7514,7490
13,104,10,100,0.001,0.01,0.504,0.5096153846153846,51,53
13,204,10,100,0.001,0.01,0.492,0.6666666666666666,87,117
13,304,10,100,0.001,0.01,0.464,0.6743421052631579,136,168
13,404,10,100,0.001,0.01,0.474,0.6163366336633663,185,219
13,504,10,100,0.001,0.01,0.462,0.6547619047619048,229,275
13,604,10,100,0.001,0.01,0.486,0.6390728476821192,280,324
13,704,10,100,0.001,0.01,0.478,0.6164772727272727,338,366
13,804,10,100,0.001,0.01,0.458,0.6442786069651741,386,418
13,904,10,100,0.001,0.01,0.5,0.6493362831858407,436,468
13,1004,10,100,0.001,0.01,0.508,0.6872509960159362,488,516
13,1104,10,100,0.001,0.01,0.528,0.6856884057971014,538,566
13,1204,10,100,0.001,0.01,0.516,0.6802325581395349,581,623
13,1304,10,100,0.001,0.01,0.512,0.7024539877300614,631,673
13,1404,10,100,0.001,0.01,0.522,0.7172364672364673,676,728
13,1504,10,100,0.001,0.01,0.578,0.7373670212765957,728,776
13,1604,10,100,0.001,0.01,0.534,0.7450124688279302,784,820
13,1704,10,100,0.001,0.01,0.56,0.7376760563380281,836,868
13,1804,10,100,0.001,0.01,0.606,0.791019955654102,881,923
13,1904,10,100,0.001,0.01,0.532,0.7373949579831933,939,965
13,2004,10,100,0.001,0.01,0.588,0.748003992015968,989,1015
13,2104,10,100,0.001,0.01,0.592,0.7286121673003803,1039,1065
13,2204,10,100,0.001,0.01,0.626,0.7858439201451906,1095,1109
13,2304,10,100,0.001,0.01,0.64,0.82421875,1141,1163
13,2404,10,100,0.001,0.01,0.624,0.7757903494176372,1190,1214
13,2504,10,100,0.001,0.01,0.69,0.8278753993610224,1243,1261
13,2604,10,100,0.001,0.01,0.684,0.8540706605222734,1283,1321
13,2704,10,100,0.001,0.01,0.682,0.8557692307692307,1332,1372
13,2804,10,100,0.001,0.01,0.714,0.8962196861626248,1380,1424
13,2904,10,100,0.001,0.01,0.732,0.915633608815427,1425,1479
13,3004,10,100,0.001,0.01,0.736,0.9211051930758988,1476,1528
13,3104,10,100,0.001,0.01,0.772,0.9265463917525774,1532,1572
13,3204,10,100,0.001,0.01,0.766,0.9572409488139825,1577,1627
13,3304,10,100,0.001,0.01,0.772,0.951271186440678,1628,1676
13,3404,10,100,0.001,0.01,0.796,0.9585781433607521,1669,1735
13,3504,10,100,0.001,0.01,0.808,0.9666095890410958,1720,1784
13,3604,10,100,0.001,0.01,0.818,0.967258601553829,1768,1836
13,3704,10,100,0.001,0.01,0.808,0.9613930885529157,1817,1887
13,3804,10,100,0.001,0.01,0.83,0.9674027339642481,1858,1946
13,3904,10,100,0.001,0.01,0.842,0.9797643442622951,1909,1995
13,4004,10,100,0.001,0.01,0.842,0.9887612387612388,1958,2046
13,4104,10,100,0.001,0.01,0.862,0.9953703703703703,2014,2090
13,4204,10,100,0.001,0.01,0.872,0.9952426260704091,2059,2145
13,4304,10,100,0.001,0.01,0.876,0.9951208178438662,2115,2189
13,4404,10,100,0.001,0.01,0.878,0.9961398728428701,2175,2229
13,4504,10,100,0.001,0.01,0.9,0.9937833037300178,2221,2283
13,4604,10,100,0.001,0.01,0.872,0.9937011294526499,2280,2324
13,4704,10,100,0.001,0.01,0.894,0.9974489795918368,2336,2368
13,4804,10,100,0.001,0.01,0.89,0.9891756869275604,2390,2414
13,4904,10,100,0.001,0.01,0.904,0.9855220228384992,2439,2465
13,5004,10,100,0.001,0.01,0.904,0.9890087929656275,2483,2521
13,5104,10,100,0.001,0.01,0.89,0.9853056426332288,2531,2573
13,5204,10,100,0.001,0.01,0.896,0.9942352036894696,2581,2623
13,5304,10,100,0.001,0.01,0.9,0.9922699849170438,2637,2667
13,5404,10,100,0.001,0.01,0.92,0.9946336047372317,2693,2711
13,5504,10,100,0.001,0.01,0.916,0.9947311046511628,2748,2756
13,5604,10,100,0.001,0.01,0.936,0.9960742326909351,2795,2809
13,5704,10,100,0.001,0.01,0.92,0.9838709677419355,2853,2851
13,5804,10,100,0.001,0.01,0.922,0.9956926257753274,2898,2906
13,5904,10,100,0.001,0.01,0.946,0.9977981029810298,2954,2950
13,6004,10,100,0.001,0.01,0.896,0.955363091272485,3003,3001
13,6104,10,100,0.001,0.01,0.878,0.9557667103538663,3055,3049
13,6204,10,100,0.001,0.01,0.93,0.9821083172147002,3105,3099
13,6304,10,100,0.001,0.01,0.932,0.9801713197969543,3159,3145
13,6404,10,100,0.001,0.01,0.944,0.9867270455965022,3209,3195
13,6504,10,100,0.001,0.01,0.936,0.9875461254612546,3263,3241
13,6604,10,100,0.001,0.01,0.942,0.9869775893397941,3308,3296
13,6704,10,100,0.001,0.01,0.952,0.9943317422434368,3364,3340
13,6804,10,100,0.001,0.01,0.958,0.9973544973544973,3415,3389
13,6904,10,100,0.001,0.01,0.962,0.9991309385863267,3454,3450
13,7004,10,100,0.001,0.01,0.964,0.999143346659052,3502,3502
13,7104,10,100,0.001,0.01,0.962,0.9997184684684685,3556,3548
13,7204,10,100,0.001,0.01,0.964,0.9998611882287618,3603,3601
13,7304,10,100,0.001,0.01,0.974,0.9994523548740416,3653,3651
13,7404,10,100,0.001,0.01,0.958,0.9998649378714208,3709,3695
13,7504,10,100,0.001,0.01,0.968,0.9998667377398721,3762,3742
13,7604,10,100,0.001,0.01,0.966,0.9976328248290374,3815,3789
13,7704,10,100,0.001,0.01,0.968,0.9985721703011423,3863,3841
13,7804,10,100,0.001,0.01,0.966,0.9996155817529472,3908,3896
13,7904,10,100,0.001,0.01,0.966,1.0,3961,3943
13,8004,10,100,0.001,0.01,0.97,0.9991254372813593,4004,4000
13,8104,10,100,0.001,0.01,0.966,0.9998766041461007,4053,4051
13,8204,10,100,0.001,0.01,0.968,0.999634324719649,4100,4104
13,8304,10,100,0.001,0.01,0.958,0.9985549132947977,4146,4158
13,8404,10,100,0.001,0.01,0.974,0.9991670633031889,4191,4213
13,8504,10,100,0.001,0.01,0.964,0.998824082784572,4238,4266
13,8604,10,100,0.001,0.01,0.972,0.9977917247791724,4299,4305
13,8704,10,100,0.001,0.01,0.968,0.9904641544117647,4348,4356
13,8804,10,100,0.001,0.01,0.978,0.9932985006815084,4399,4405
13,8904,10,100,0.001,0.01,0.962,0.9853998203054807,4443,4461
13,9004,10,100,0.001,0.01,0.968,0.9882274544646824,4491,4513
13,9104,10,100,0.001,0.01,0.968,0.9974736379613357,4537,4567
13,9204,10,100,0.001,0.01,0.978,0.999348109517601,4587,4617
13,9304,10,100,0.001,0.01,0.976,0.9979578675838349,4643,4661
13,9404,10,100,0.001,0.01,0.974,0.998192258613356,4683,4721
13,9504,10,100,0.001,0.01,0.984,0.9996843434343434,4735,4769
13,9604,10,100,0.001,0.01,0.98,0.9994793835901707,4777,4827
13,9704,10,100,0.001,0.01,0.982,0.999484748557296,4833,4871
13,9804,10,100,0.001,0.01,0.976,0.9973480212158303,4874,4930
13,9904,10,100,0.001,0.01,0.962,0.9865710823909531,4919,4985
13,10004,10,100,0.001,0.01,0.974,0.9974010395841664,4972,5032
13,10104,10,100,0.001,0.01,0.976,0.9991092636579573,5027,5077
13,10204,10,100,0.001,0.01,0.978,0.9986279890239121,5076,5128
13,10304,10,100,0.001,0.01,0.976,0.999126552795031,5120,5184
13,10404,10,100,0.001,0.01,0.984,0.999038831218762,5170,5234
13,10504,10,100,0.001,0.01,0.982,0.9982863670982483,5229,5275
13,10604,10,100,0.001,0.01,0.984,0.9976423990946812,5281,5323
13,10704,10,100,0.001,0.01,0.988,0.9964499252615845,5336,5368
13,10804,10,100,0.001,0.01,0.982,0.9950944094779711,5395,5409
13,10904,10,100,0.001,0.01,0.992,0.9977989728539985,5443,5461
13,11004,10,100,0.001,0.01,0.986,0.9953653217011995,5490,5514
13,11104,10,100,0.001,0.01,0.978,0.9973883285302594,5545,5559
13,11204,10,100,0.001,0.01,0.986,0.9983934309175294,5595,5609
13,11304,10,100,0.001,0.01,0.988,0.9996461429582448,5648,5656
13,11404,10,100,0.001,0.01,0.982,1.0,5692,5712
13,11504,10,100,0.001,0.01,0.984,1.0,5751,5753
13,11604,10,100,0.001,0.01,0.982,1.0,5805,5799
13,11704,10,100,0.001,0.01,0.984,1.0,5849,5855
13,11804,10,100,0.001,0.01,0.984,0.9994916977295832,5901,5903
13,11904,10,100,0.001,0.01,0.99,0.9997479838709677,5944,5960
13,12004,10,100,0.001,0.01,0.994,0.9995001666111296,5988,6016
13,12104,10,100,0.001,0.01,0.99,0.9984302709847984,6042,6062
13,12204,10,100,0.001,0.01,0.958,0.9636184857423795,6087,6117
13,12304,10,100,0.001,0.01,0.982,0.9874024707412223,6144,6160
13,12404,10,100,0.001,0.01,0.984,0.9929055143502096,6194,6210
13,12504,10,100,0.001,0.01,0.99,0.9935220729366603,6247,6257
13,12604,10,100,0.001,0.01,0.994,0.9986512218343383,6300,6304
13,12704,10,100,0.001,0.01,0.996,0.999448992443325,6353,6351
13,12804,10,100,0.001,0.01,0.994,0.9999218994064355,6402,6402
13,12904,10,100,0.001,0.01,0.994,1.0,6460,6444
13,13004,10,100,0.001,0.01,0.994,1.0,6507,6497
13,13104,10,100,0.001,0.01,0.994,1.0,6555,6549
13,13204,10,100,0.001,0.01,0.994,1.0,6605,6599
13,13304,10,100,0.001,0.01,0.98,0.9806825015033073,6655,6649
13,13404,10,100,0.001,0.01,0.99,0.9945538645180543,6705,6699
13,13504,10,100,0.001,0.01,0.988,0.9953347156398105,6760,6744
13,13604,10,100,0.001,0.01,0.994,0.9997794766245222,6810,6794
13,13704,10,100,0.001,0.01,0.998,0.9998540572095739,6868,6836
13,13804,10,100,0.001,0.01,1.0,0.9999275572297884,6921,6883
13,13904,10,100,0.001,0.01,0.998,0.9998561565017261,6971,6933
13,14004,10,100,0.001,0.01,0.998,1.0,7018,6986
13,14104,10,100,0.001,0.01,0.998,1.0,7067,7037
13,14204,10,100,0.001,0.01,1.0,1.0,7114,7090
13,14304,10,100,0.001,0.01,0.998,1.0,7166,7138
13,14404,10,100,0.001,0.01,0.998,1.0,7207,7197
13,14504,10,100,0.001,0.01,1.0,1.0,7251,7253
13,14604,10,100,0.001,0.01,1.0,1.0,7296,7308
13,14704,10,100,0.001,0.01,0.994,0.9970076169749728,7349,7355
13,14804,10,100,0.001,0.01,0.996,0.9979735206700892,7399,7405
13,14904,10,100,0.001,0.01,0.994,0.9996645195920558,7449,7455
13,15004,10,100,0.001,0.01,0.998,1.0,7500,7504
14,104,10,100,0.001,0.01,0.512,0.7115384615384616,61,43
14,204,10,100,0.001,0.01,0.528,0.7009803921568627,117,87
14,304,10,100,0.001,0.01,0.518,0.6743421052631579,167,137
14,404,10,100,0.001,0.01,0.5,0.6460396039603961,220,184
14,504,10,100,0.001,0.01,0.512,0.6388888888888888,270,234
14,604,10,100,0.001,0.01,0.498,0.6423841059602649,331,273
14,704,10,100,0.001,0.01,0.524,0.6463068181818182,387,317
14,804,10,100,0.001,0.01,0.51,0.6927860696517413,431,373
14,904,10,100,0.001,0.01,0.508,0.6736725663716814,482,422
14,1004,10,100,0.001,0.01,0.52,0.6902390438247012,533,471
14,1104,10,100,0.001,0.01,0.448,0.634963768115942,575,529
14,1204,10,100,0.001,0.01,0.508,0.7126245847176079,628,576
14,1304,10,100,0.001,0.01,0.518,0.6725460122699386,675,629
14,1404,10,100,0.001,0.01,0.504,0.7129629629629629,727,677
14,1504,10,100,0.001,0.01,0.508,0.7287234042553191,781,723
14,1604,10,100,0.001,0.01,0.494,0.7356608478802993,823,781
14,1704,10,100,0.001,0.01,0.526,0.7435446009389671,876,828
14,1804,10,100,0.001,0.01,0.508,0.7854767184035477,923,881
14,1904,10,100,0.001,0.01,0.512,0.7899159663865546,962,942
14,2004,10,100,0.001,0.01,0.56,0.7749500998003992,1027,977
14,2104,10,100,0.001,0.01,0.57,0.776615969581749,1087,1017
14,2204,10,100,0.001,0.01,0.582,0.8475499092558983,1139,1065
14,2304,10,100,0.001,0.01,0.598,0.8194444444444444,1190,1114
14,2404,10,100,0.001,0.01,0.648,0.8523294509151415,1240,1164
14,2504,10,100,0.001,0.01,0.668,0.889776357827476,1296,1208
14,2604,10,100,0.001,0.01,0.69,0.8832565284178188,1344,1260
14,2704,10,100,0.001,0.01,0.7,0.8857248520710059,1406,1298
14,2804,10,100,0.001,0.01,0.72,0.8962196861626248,1459,1345
14,2904,10,100,0.001,0.01,0.772,0.9376721763085399,1510,1394
14,3004,10,100,0.001,0.01,0.772,0.9364181091877497,1559,1445
14,3104,10,100,0.001,0.01,0.792,0.9403994845360825,1614,1490
14,3204,10,100,0.001,0.01,0.784,0.9556803995006242,1659,1545
14,3304,10,100,0.001,0.01,0.802,0.9630750605326877,1706,1598
14,3404,10,100,0.001,0.01,0.79,0.9609283196239718,1766,1638
14,3504,10,100,0.001,0.01,0.844,0.9780251141552512,1821,1683
14,3604,10,100,0.001,0.01,0.854,0.9764150943396226,1874,1730
14,3704,10,100,0.001,0.01,0.856,0.9732721382289417,1922,1782
14,3804,10,100,0.001,0.01,0.866,0.9860672975814931,1962,1842
14,3904,10,100,0.001,0.01,0.852,0.9920594262295082,2012,1892
14,4004,10,100,0.001,0.01,0.89,0.986013986013986,2059,1945
14,4104,10,100,0.001,0.01,0.888,0.9848927875243665,2113,1991
14,4204,10,100,0.001,0.01,0.882,0.9883444338725024,2161,2043
14,4304,10,100,0.001,0.01,0.89,0.9842007434944238,2200,2104
14,4404,10,100,0.001,0.01,0.896,0.9677565849227975,2253,2151
14,4504,10,100,0.001,0.01,0.88,0.969582593250444,2305,2199
14,4604,10,100,0.001,0.01,0.908,0.9824066029539531,2359,2245
14,4704,10,100,0.001,0.01,0.916,0.9929846938775511,2407,2297
14,4804,10,100,0.001,0.01,0.922,0.9929225645295587,2460,2344
14,4904,10,100,0.001,0.01,0.93,0.9951060358890701,2507,2397
14,5004,10,100,0.001,0.01,0.926,0.9976019184652278,2559,2445
14,5104,10,100,0.001,0.01,0.934,0.9986285266457681,2616,2488
14,5204,10,100,0.001,0.01,0.928,0.9923136049192929,2669,2535
14,5304,10,100,0.001,0.01,0.924,0.9932126696832579,2720,2584
14,5404,10,100,0.001,0.01,0.912,0.9914877868245744,2767,2637
14,5504,10,100,0.001,0.01,0.93,0.9932776162790697,2818,2686
14,5604,10,100,0.001,0.01,0.932,0.9957173447537473,2872,2732
14,5704,10,100,0.001,0.01,0.942,0.995617110799439,2915,2789
14,5804,10,100,0.001,0.01,0.926,0.9922467263955892,2963,2841
14,5904,10,100,0.001,0.01,0.936,0.9962737127371274,3016,2888
14,6004,10,100,0.001,0.01,0.95,0.9948367754830113,3068,2936
14,6104,10,100,0.001,0.01,0.948,0.9882044560943644,3112,2992
14,6204,10,100,0.001,0.01,0.93,0.9806576402321083,3164,3040
14,6304,10,100,0.001,0.01,0.946,0.9939720812182741,3210,3094
14,6404,10,100,0.001,0.01,0.952,0.9960961898813242,3252,3152
14,6504,10,100,0.001,0.01,0.946,0.9944649446494465,3293,3211
14,6604,10,100,0.001,0.01,0.944,0.9931859479103574,3341,3263
14,6704,10,100,0.001,0.01,0.962,0.9986575178997613,3393,3311
14,6804,10,100,0.001,0.01,0.954,0.9973544973544973,3446,3358
14,6904,10,100,0.001,0.01,0.958,0.996234067207416,3493,3411
14,7004,10,100,0.001,0.01,0.962,0.9931467732724157,3543,3461
14,7104,10,100,0.001,0.01,0.95,0.9921171171171171,3593,3511
14,7204,10,100,0.001,0.01,0.958,0.9952803997779012,3631,3573
14,7304,10,100,0.001,0.01,0.962,0.994934282584885,3677,3627
14,7404,10,100,0.001,0.01,0.958,0.9972987574284171,3719,3685
14,7504,10,100,0.001,0.01,0.962,0.9982675906183369,3759,3745
14,7604,10,100,0.001,0.01,0.962,0.9989479221462388,3812,3792
14,7704,10,100,0.001,0.01,0.964,0.9971443406022845,3859,3845
14,7804,10,100,0.001,0.01,0.964,0.9979497693490518,3906,3898
14,7904,10,100,0.001,0.01,0.952,0.9958248987854251,3955,3949
14,8004,10,100,0.001,0.01,0.968,0.999000499750125,4006,3998
14,8104,10,100,0.001,0.01,0.974,0.9993830207305034,4056,4048
14,8204,10,100,0.001,0.01,0.966,0.9960994636762555,4099,4105
14,8304,10,100,0.001,0.01,0.954,0.9883188824662813,4139,4165
14,8404,10,100,0.001,0.01,0.974,0.9933365064255116,4186,4218
14,8504,10,100,0.001,0.01,0.964,0.9937676387582314,4223,4281
14,8604,10,100,0.001,0.01,0.954,0.9788470478847048,4274,4330
14,8704,10,100,0.001,0.01,0.97,0.9978170955882353,4317,4387
14,8804,10,100,0.001,0.01,0.972,0.9990913221263062,4360,4444
14,8904,10,100,0.001,0.01,0.976,0.9996630727762803,4405,4499
14,9004,10,100,0.001,0.01,0.976,0.9986672589960017,4451,4553
14,9104,10,100,0.001,0.01,0.984,0.9982425307557118,4500,4604
14,9204,10,100,0.001,0.01,0.978,0.9994567579313341,4564,4640
14,9304,10,100,0.001,0.01,0.98,0.9988177128116938,4616,4688
14,9404,10,100,0.001,0.01,0.978,0.9980859208847299,4671,4733
14,9504,10,100,0.001,0.01,0.98,0.998526936026936,4724,4780
14,9604,10,100,0.001,0.01,0.98,0.9970845481049563,4777,4827
14,9704,10,100,0.001,0.01,0.98,0.9995877988458368,4823,4881
14,9804,10,100,0.001,0.01,0.974,0.9998980008159934,4871,4933
14,9904,10,100,0.001,0.01,0.978,0.9995961227786753,4923,4981
14,10004,10,100,0.001,0.01,0.978,0.9987005197920832,4970,5034
14,10104,10,100,0.001,0.01,0.986,0.9986144101346002,5024,5080
14,10204,10,100,0.001,0.01,0.982,0.9994119952959624,5076,5128
14,10304,10,100,0.001,0.01,0.98,0.9978649068322981,5132,5172
14,10404,10,100,0.001,0.01,0.97,0.9920222991157247,5184,5220
14,10504,10,100,0.001,0.01,0.976,0.9940974866717441,5235,5269
14,10604,10,100,0.001,0.01,0.976,0.9934930215013202,5282,5322
14,10704,10,100,0.001,0.01,0.986,0.992526158445441,5334,5370
14,10804,10,100,0.001,0.01,0.98,0.9932432432432432,5387,5417
14,10904,10,100,0.001,0.01,0.984,0.9975238444607484,5435,5469
14,11004,10,100,0.001,0.01,0.988,0.9992729916394039,5483,5521
14,11104,10,100,0.001,0.01,0.99,0.999549711815562,5536,5568
14,11204,10,100,0.001,0.01,0.986,0.9996429846483399,5591,5613
14,11304,10,100,0.001,0.01,0.99,0.9999115357395613,5637,5667
14,11404,10,100,0.001,0.01,0.984,1.0,5693,5711
14,11504,10,100,0.001,0.01,0.986,1.0,5742,5762
14,11604,10,100,0.001,0.01,0.986,1.0,5795,5809
14,11704,10,100,0.001,0.01,0.986,1.0,5844,5860
14,11804,10,100,0.001,0.01,0.984,0.9999152829549305,5893,5911
14,11904,10,100,0.001,0.01,0.984,1.0,5940,5964
14,12004,10,100,0.001,0.01,0.988,0.9980839720093302,5979,6025
14,12104,10,100,0.001,0.01,0.984,0.9947124917382684,6030,6074
14,12204,10,100,0.001,0.01,0.976,0.9902490986561783,6075,6129
14,12304,10,100,0.001,0.01,0.98,0.9756176853055917,6132,6172
14,12404,10,100,0.001,0.01,0.98,0.9943566591422122,6182,6222
14,12504,10,100,0.001,0.01,0.98,0.9925623800383877,6232,6272
14,12604,10,100,0.001,0.01,0.984,0.9980165026975564,6287,6317
14,12704,10,100,0.001,0.01,0.988,0.9993702770780857,6331,6373
14,12804,10,100,0.001,0.01,0.992,0.999687597625742,6378,6426
14,12904,10,100,0.001,0.01,0.99,0.999845009299442,6429,6475
14,13004,10,100,0.001,0.01,0.99,0.9999231005844356,6485,6519
14,13104,10,100,0.001,0.01,0.988,1.0,6538,6566
14,13204,10,100,0.001,0.01,0.99,1.0,6593,6611
14,13304,10,100,0.001,0.01,0.99,1.0,6640,6664
14,13404,10,100,0.001,0.01,0.99,1.0,6676,6728
14,13504,10,100,0.001,0.01,0.99,1.0,6725,6779
14,13604,10,100,0.001,0.01,0.988,0.9995589532490444,6779,6825
14,13704,10,100,0.001,0.01,0.988,0.9945271453590193,6823,6881
14,13804,10,100,0.001,0.01,0.98,0.9966676325702695,6871,6933
14,13904,10,100,0.001,0.01,0.986,0.9978423475258918,6920,6984
14,14004,10,100,0.001,0.01,0.99,0.9970722650671237,6976,7028
14,14104,10,100,0.001,0.01,0.988,0.999503686897334,7026,7078
14,14204,10,100,0.001,0.01,0.99,0.9999295972965362,7081,7123
14,14304,10,100,0.001,0.01,0.988,0.9998601789709173,7129,7175
14,14404,10,100,0.001,0.01,0.99,0.9998611496806442,7185,7219
14,14504,10,100,0.001,0.01,0.99,1.0,7238,7266
14,14604,10,100,0.001,0.01,0.99,0.9999315256094221,7287,7317
14,14704,10,100,0.001,0.01,0.99,1.0,7335,7369
14,14804,10,100,0.001,0.01,0.984,0.9988516617130505,7387,7417
14,14904,10,100,0.001,0.01,0.95,0.9769860440150295,7440,7464
14,15004,10,100,0.001,0.01,0.98,0.9946680885097308,7484,7520
15,104,10,100,0.001,0.01,0.524,0.5576923076923077,58,46
15,204,10,100,0.001,0.01,0.524,0.5637254901960784,115,89
15,304,10,100,0.001,0.01,0.492,0.6381578947368421,164,140
15,404,10,100,0.001,0.01,0.478,0.5420792079207921,213,191
15,504,10,100,0.001,0.01,0.476,0.5436507936507936,258,246
15,604,10,100,0.001,0.01,0.494,0.6142384105960265,312,292
15,704,10,100,0.001,0.01,0.52,0.6065340909090909,358,346
15,804,10,100,0.001,0.01,0.512,0.6082089552238806,406,398
15,904,10,100,0.001,0.01,0.486,0.620575221238938,462,442
15,1004,10,100,0.001,0.01,0.496,0.6394422310756972,518,486
15,1104,10,100,0.001,0.01,0.48,0.6512681159420289,565,539
15,1204,10,100,0.001,0.01,0.512,0.6528239202657807,618,586
15,1304,10,100,0.001,0.01,0.534,0.6434049079754601,660,644
15,1404,10,100,0.001,0.01,0.516,0.6894586894586895,711,693
15,1504,10,100,0.001,0.01,0.506,0.6702127659574468,757,747
15,1604,10,100,0.001,0.01,0.534,0.7094763092269327,815,789
15,1704,10,100,0.001,0.01,0.532,0.704225352112676,862,842
15,1804,10,100,0.001,0.01,0.506,0.6951219512195121,907,897
15,1904,10,100,0.001,0.01,0.522,0.729516806722689,953,951
15,2004,10,100,0.001,0.01,0.542,0.718562874251497,1007,997
15,2104,10,100,0.001,0.01,0.496,0.686787072243346,1064,1040
15,2204,10,100,0.001,0.01,0.518,0.7459165154264973,1115,1089
15,2304,10,100,0.001,0.01,0.52,0.7348090277777778,1160,1144
15,2404,10,100,0.001,0.01,0.538,0.7687188019966722,1215,1189
15,2504,10,100,0.001,0.01,0.554,0.7160543130990416,1261,1243
15,2604,10,100,0.001,0.01,0.522,0.7776497695852534,1306,1298
15,2704,10,100,0.001,0.01,0.58,0.8239644970414202,1364,1340
15,2804,10,100,0.001,0.01,0.618,0.8070613409415122,1409,1395
15,2904,10,100,0.001,0.01,0.642,0.8336776859504132,1457,1447
15,3004,10,100,0.001,0.01,0.62,0.8432090545938749,1501,1503
15,3104,10,100,0.001,0.01,0.63,0.8498711340206185,1553,1551
15,3204,10,100,0.001,0.01,0.658,0.8810861423220974,1601,1603
15,3304,10,100,0.001,0.01,0.702,0.9188861985472155,1650,1654
15,3404,10,100,0.001,0.01,0.652,0.8851351351351351,1701,1703
15,3504,10,100,0.001,0.01,0.674,0.8627283105022832,1758,1746
15,3604,10,100,0.001,0.01,0.74,0.9073251942286349,1806,1798
15,3704,10,100,0.001,0.01,0.762,0.9395248380129589,1857,1847
15,3804,10,100,0.001,0.01,0.76,0.9547844374342797,1904,1900
15,3904,10,100,0.001,0.01,0.778,0.9334016393442623,1948,1956
15,4004,10,100,0.001,0.01,0.792,0.9393106893106893,1990,2014
15,4104,10,100,0.001,0.01,0.774,0.9480994152046783,2046,2058
15,4204,10,100,0.001,0.01,0.79,0.9564700285442436,2099,2105
15,4304,10,100,0.001,0.01,0.792,0.9635223048327137,2151,2153
15,4404,10,100,0.001,0.01,0.82,0.9657129881925522,2197,2207
15,4504,10,100,0.001,0.01,0.818,0.9635879218472468,2233,2271
15,4604,10,100,0.001,0.01,0.822,0.9700260642919201,2289,2315
15,4704,10,100,0.001,0.01,0.838,0.9742772108843537,2337,2367
15,4804,10,100,0.001,0.01,0.844,0.9827227310574521,2385,2419
15,4904,10,100,0.001,0.01,0.848,0.9873572593800979,2431,2473
15,5004,10,100,0.001,0.01,0.84,0.9900079936051159,2479,2525
15,5104,10,100,0.001,0.01,0.872,0.9952978056426333,2532,2572
15,5204,10,100,0.001,0.01,0.856,0.9967332820906994,2586,2618
15,5304,10,100,0.001,0.01,0.874,0.9924585218702866,2636,2668
15,5404,10,100,0.001,0.01,0.876,0.9911176905995559,2691,2713
15,5504,10,100,0.001,0.01,0.884,0.9949127906976745,2750,2754
15,5604,10,100,0.001,0.01,0.894,0.994825124910778,2808,2796
15,5704,10,100,0.001,0.01,0.892,0.9928120617110799,2865,2839
15,5804,10,100,0.001,0.01,0.888,0.987250172294969,2915,2889
15,5904,10,100,0.001,0.01,0.898,0.9886517615176151,2964,2940
15,6004,10,100,0.001,0.01,0.892,0.9828447701532311,3010,2994
15,6104,10,100,0.001,0.01,0.878,0.9868938401048493,3054,3050
15,6204,10,100,0.001,0.01,0.898,0.9861379754996776,3101,3103
15,6304,10,100,0.001,0.01,0.9,0.9923857868020305,3158,3146
15,6404,10,100,0.001,0.01,0.9,0.9906308557151781,3208,3196
15,6504,10,100,0.001,0.01,0.91,0.9952337023370234,3266,3238
15,6604,10,100,0.001,0.01,0.92,0.9906117504542702,3315,3289
15,6704,10,100,0.001,0.01,0.926,0.994928400954654,3362,3342
15,6804,10,100,0.001,0.01,0.932,0.9983833039388595,3414,3390
15,6904,10,100,0.001,0.01,0.928,0.9985515643105446,3466,3438
15,7004,10,100,0.001,0.01,0.908,0.9845802398629354,3523,3481
15,7104,10,100,0.001,0.01,0.914,0.9874718468468469,3569,3535
15,7204,10,100,0.001,0.01,0.876,0.9572459744586341,3628,3576
15,7304,10,100,0.001,0.01,0.888,0.9450985761226726,3667,3637
15,7404,10,100,0.001,0.01,0.918,0.9683954619124797,3718,3686
15,7504,10,100,0.001,0.01,0.93,0.9880063965884861,3771,3733
15,7604,10,100,0.001,0.01,0.938,0.990136770120989,3822,3782
15,7704,10,100,0.001,0.01,0.952,0.9963655244029076,3865,3839
15,7804,10,100,0.001,0.01,0.942,0.9937211686314711,3917,3887
15,7904,10,100,0.001,0.01,0.918,0.989245951417004,3966,3938
15,8004,10,100,0.001,0.01,0.944,0.9946276861569215,4020,3984
15,8104,10,100,0.001,0.01,0.94,0.9969151036525172,4075,4029
15,8204,10,100,0.001,0.01,0.948,0.9960994636762555,4122,4082
15,8304,10,100,0.001,0.01,0.952,0.9992774566473989,4172,4132
15,8404,10,100,0.001,0.01,0.956,0.9982151356496907,4228,4176
15,8504,10,100,0.001,0.01,0.962,0.999412041392286,4273,4231
15,8604,10,100,0.001,0.01,0.964,0.9996513249651325,4320,4284
15,8704,10,100,0.001,0.01,0.966,0.9955193014705882,4370,4334
15,8804,10,100,0.001,0.01,0.958,0.997955474784189,4417,4387
15,8904,10,100,0.001,0.01,0.962,0.9992138364779874,4460,4444
15,9004,10,100,0.001,0.01,0.934,0.9835628609506886,4510,4494
15,9104,10,100,0.001,0.01,0.95,0.9915421792618629,4557,4547
15,9204,10,100,0.001,0.01,0.946,0.9938070404172099,4606,4598
15,9304,10,100,0.001,0.01,0.952,0.9970980223559759,4652,4652
15,9404,10,100,0.001,0.01,0.966,0.9885155253083794,4706,4698
15,9504,10,100,0.001,0.01,0.968,0.9957912457912458,4754,4750
15,9604,10,100,0.001,0.01,0.964,0.9975010412328197,4813,4791
15,9704,10,100,0.001,0.01,0.972,0.9980420445177246,4861,4843
15,9804,10,100,0.001,0.01,0.97,0.9994900040799674,4912,4892
15,9904,10,100,0.001,0.01,0.972,0.999394184168013,4965,4939
15,10004,10,100,0.001,0.01,0.968,0.9986005597760895,5008,4996
15,10104,10,100,0.001,0.01,0.974,0.9965360253365004,5053,5051
15,10204,10,100,0.001,0.01,0.972,0.996765974127793,5103,5101
15,10304,10,100,0.001,0.01,0.974,0.9961180124223602,5156,5148
15,10404,10,100,0.001,0.01,0.976,0.997597078046905,5197,5207
15,10504,10,100,0.001,0.01,0.98,0.9993335872048743,5251,5253
15,10604,10,100,0.001,0.01,0.976,0.9987740475292343,5296,5308
15,10704,10,100,0.001,0.01,0.972,0.9997197309417041,5345,5359
15,10804,10,100,0.001,0.01,0.978,0.998333950388745,5403,5401
15,10904,10,100,0.001,0.01,0.974,0.9974321349963317,5456,5448
15,11004,10,100,0.001,0.01,0.972,0.9961832061068703,5502,5502
15,11104,10,100,0.001,0.01,0.972,0.9892831412103746,5559,5545
15,11204,10,100,0.001,0.01,0.978,0.9978579078900393,5610,5594
15,11304,10,100,0.001,0.01,0.976,0.9973460721868365,5660,5644
15,11404,10,100,0.001,0.01,0.976,0.9989477376359173,5712,5692
15,11504,10,100,0.001,0.01,0.98,0.9975660639777468,5766,5738
15,11604,10,100,0.001,0.01,0.984,0.9990520510168908,5830,5774
15,11704,10,100,0.001,0.01,0.978,0.9970095693779905,5870,5834
15,11804,10,100,0.001,0.01,0.98,0.9970349034225686,5920,5884
15,11904,10,100,0.001,0.01,0.976,0.9949596774193549,5963,5941
15,12004,10,100,0.001,0.01,0.982,0.990753082305898,6006,5998
15,12104,10,100,0.001,0.01,0.98,0.9971083939193655,6051,6053
15,12204,10,100,0.001,0.01,0.976,0.993198951163553,6089,6115
15,12304,10,100,0.001,0.01,0.984,0.9981306892067621,6136,6168
15,12404,10,100,0.001,0.01,0.988,0.9964527571751048,6182,6222
15,12504,10,100,0.001,0.01,0.996,0.9992002559181062,6231,6273
15,12604,10,100,0.001,0.01,0.996,0.9979371628054586,6285,6319
15,12704,10,100,0.001,0.01,0.992,0.9990554156171285,6346,6358
15,12804,10,100,0.001,0.01,0.992,0.9976569821930646,6394,6410
15,12904,10,100,0.001,0.01,0.992,0.9938778673279604,6438,6466
15,13004,10,100,0.001,0.01,0.986,0.9973085204552445,6488,6516
15,13104,10,100,0.001,0.01,0.99,0.9980921855921856,6540,6564
15,13204,10,100,0.001,0.01,0.992,0.9993941229930324,6598,6606
15,13304,10,100,0.001,0.01,0.99,0.9999248346361996,6646,6658
15,13404,10,100,0.001,0.01,0.99,1.0,6690,6714
15,13504,10,100,0.001,0.01,0.994,1.0,6743,6761
15,13604,10,100,0.001,0.01,0.992,1.0,6798,6806
15,13704,10,100,0.001,0.01,0.992,1.0,6845,6859
15,13804,10,100,0.001,0.01,0.992,1.0,6886,6918
15,13904,10,100,0.001,0.01,0.992,1.0,6933,6971
15,14004,10,100,0.001,0.01,0.992,1.0,6984,7020
15,14104,10,100,0.001,0.01,0.99,1.0,7038,7066
15,14204,10,100,0.001,0.01,0.994,0.9995071810757533,7093,7111
15,14304,10,100,0.001,0.01,0.994,0.9959451901565995,7148,7156
15,14404,10,100,0.001,0.01,0.974,0.9816023326853652,7190,7214
15,14504,10,100,0.001,0.01,0.986,0.9926916712630999,7243,7261
15,14604,10,100,0.001,0.01,0.99,0.9988359353601753,7296,7308
15,14704,10,100,0.001,0.01,0.994,0.9995919477693145,7341,7363
15,14804,10,100,0.001,0.01,0.998,0.999864901378006,7387,7417
15,14904,10,100,0.001,0.01,0.998,0.9996645195920558,7441,7463
15,15004,10,100,0.001,0.01,0.996,0.999466808850973,7490,7514
16,104,10,100,0.001,0.01,0.484,0.5769230769230769,44,60
16,204,10,100,0.001,0.01,0.496,0.6617647058823529,96,108
16,304,10,100,0.001,0.01,0.49,0.555921052631579,142,162
16,404,10,100,0.001,0.01,0.52,0.6163366336633663,195,209
16,504,10,100,0.001,0.01,0.514,0.5674603174603174,238,266
16,604,10,100,0.001,0.01,0.506,0.6142384105960265,288,316
16,704,10,100,0.001,0.01,0.528,0.609375,339,365
16,804,10,100,0.001,0.01,0.48,0.6169154228855721,391,413
16,904,10,100,0.001,0.01,0.484,0.6117256637168141,437,467
16,1004,10,100,0.001,0.01,0.514,0.6782868525896414,482,522
16,1104,10,100,0.001,0.01,0.502,0.6530797101449275,530,574
16,1204,10,100,0.001,0.01,0.482,0.696843853820598,585,619
16,1304,10,100,0.001,0.01,0.482,0.683282208588957,633,671
16,1404,10,100,0.001,0.01,0.506,0.7222222222222222,688,716
16,1504,10,100,0.001,0.01,0.496,0.7087765957446809,744,760
16,1604,10,100,0.001,0.01,0.51,0.7481296758104738,795,809
16,1704,10,100,0.001,0.01,0.534,0.75,837,867
16,1804,10,100,0.001,0.01,0.524,0.7610864745011087,888,916
16,1904,10,100,0.001,0.01,0.52,0.7815126050420168,937,967
16,2004,10,100,0.001,0.01,0.544,0.782435129740519,983,1021
16,2104,10,100,0.001,0.01,0.524,0.7942015209125475,1036,1068
16,2204,10,100,0.001,0.01,0.562,0.8044464609800362,1085,1119
16,2304,10,100,0.001,0.01,0.534,0.7673611111111112,1133,1171
16,2404,10,100,0.001,0.01,0.574,0.8348585690515807,1188,1216
16,2504,10,100,0.001,0.01,0.55,0.8007188498402555,1234,1270
16,2604,10,100,0.001,0.01,0.582,0.8548387096774194,1283,1321
16,2704,10,100,0.001,0.01,0.598,0.8879437869822485,1335,1369
16,2804,10,100,0.001,0.01,0.652,0.9022824536376605,1384,1420
16,2904,10,100,0.001,0.01,0.652,0.8891184573002755,1436,1468
16,3004,10,100,0.001,0.01,0.644,0.9250998668442078,1474,1530
16,3104,10,100,0.001,0.01,0.682,0.9384664948453608,1523,1581
16,3204,10,100,0.001,0.01,0.704,0.9447565543071161,1578,1626
16,3304,10,100,0.001,0.01,0.718,0.9630750605326877,1628,1676
16,3404,10,100,0.001,0.01,0.73,0.9691539365452408,1673,1731
16,3504,10,100,0.001,0.01,0.736,0.9660388127853882,1719,1785
16,3604,10,100,0.001,0.01,0.748,0.9492230854605993,1764,1840
16,3704,10,100,0.001,0.01,0.724,0.937365010799136,1825,1879
16,3804,10,100,0.001,0.01,0.774,0.9752891692954785,1873,1931
16,3904,10,100,0.001,0.01,0.768,0.9805327868852459,1921,1983
16,4004,10,100,0.001,0.01,0.796,0.9845154845154845,1967,2037
16,4104,10,100,0.001,0.01,0.788,0.9768518518518519,2023,2081
16,4204,10,100,0.001,0.01,0.814,0.9881065651760228,2075,2129
16,4304,10,100,0.001,0.01,0.82,0.9946561338289963,2123,2181
16,4404,10,100,0.001,0.01,0.822,0.9879654859218892,2163,2241
16,4504,10,100,0.001,0.01,0.818,0.9940053285968028,2213,2291
16,4604,10,100,0.001,0.01,0.844,0.9923979148566464,2260,2344
16,4704,10,100,0.001,0.01,0.838,0.9963860544217688,2303,2401
16,4804,10,100,0.001,0.01,0.832,0.988759367194005,2355,2449
16,4904,10,100,0.001,0.01,0.828,0.9810358890701468,2403,2501
16,5004,10,100,0.001,0.01,0.852,0.9838129496402878,2462,2542
16,5104,10,100,0.001,0.01,0.874,0.9888322884012539,2509,2595
16,5204,10,100,0.001,0.01,0.872,0.995772482705611,2560,2644
16,5304,10,100,0.001,0.01,0.896,0.9964177978883861,2607,2697
16,5404,10,100,0.001,0.01,0.88,0.9951887490747594,2660,2744
16,5504,10,100,0.001,0.01,0.86,0.9805595930232558,2710,2794
16,5604,10,100,0.001,0.01,0.872,0.9732334047109208,2757,2847
16,5704,10,100,0.001,0.01,0.902,0.9903576437587658,2806,2898
16,5804,10,100,0.001,0.01,0.89,0.9922467263955892,2859,2945
16,5904,10,100,0.001,0.01,0.928,0.9922086720867209,2910,2994
16,6004,10,100,0.001,0.01,0.924,0.9963357761492339,2975,3029
16,6104,10,100,0.001,0.01,0.912,0.9972149410222805,3040,3064
16,6204,10,100,0.001,0.01,0.934,0.9995164410058027,3094,3110
16,6304,10,100,0.001,0.01,0.924,0.9990482233502538,3139,3165
16,6404,10,100,0.001,0.01,0.932,0.9992192379762649,3188,3216
16,6504,10,100,0.001,0.01,0.93,0.9995387453874539,3245,3259
16,6604,10,100,0.001,0.01,0.928,0.9993943064809206,3297,3307
16,6704,10,100,0.001,0.01,0.942,0.9977625298329356,3349,3355
16,6804,10,100,0.001,0.01,0.944,0.9980893592004703,3405,3399
16,6904,10,100,0.001,0.01,0.938,0.9979721900347625,3452,3452
16,7004,10,100,0.001,0.01,0.926,0.9937178754997145,3511,3493
16,7104,10,100,0.001,0.01,0.912,0.9839527027027027,3559,3545
16,7204,10,100,0.001,0.01,0.924,0.9852859522487507,3614,3590
16,7304,10,100,0.001,0.01,0.936,0.9869934282584885,3659,3645
16,7404,10,100,0.001,0.01,0.942,0.9902755267423015,3707,3697
16,7504,10,100,0.001,0.01,0.944,0.9834754797441365,3754,3750
16,7604,10,100,0.001,0.01,0.906,0.9462125197264598,3803,3801
16,7704,10,100,0.001,0.01,0.904,0.9545690550363447,3854,3850
16,7804,10,100,0.001,0.01,0.958,0.989364428498206,3913,3891
16,7904,10,100,0.001,0.01,0.966,0.9974696356275303,3966,3938
16,8004,10,100,0.001,0.01,0.962,0.9927536231884058,4012,3992
16,8104,10,100,0.001,0.01,0.948,0.9904985192497532,4061,4043
16,8204,10,100,0.001,0.01,0.968,0.9951243295953194,4107,4097
16,8304,10,100,0.001,0.01,0.97,0.9985549132947977,4165,4139
16,8404,10,100,0.001,0.01,0.97,0.9989290813898144,4209,4195
16,8504,10,100,0.001,0.01,0.978,0.9998824082784572,4252,4252
16,8604,10,100,0.001,0.01,0.972,0.9989539748953975,4305,4299
16,8704,10,100,0.001,0.01,0.976,0.9996553308823529,4354,4350
16,8804,10,100,0.001,0.01,0.986,1.0,4411,4393
16,8904,10,100,0.001,0.01,0.982,1.0,4463,4441
16,9004,10,100,0.001,0.01,0.976,1.0,4518,4486
16,9104,10,100,0.001,0.01,0.974,0.999670474516696,4569,4535
16,9204,10,100,0.001,0.01,0.972,0.9995654063450674,4620,4584
16,9304,10,100,0.001,0.01,0.98,0.9994625967325881,4670,4634
16,9404,10,100,0.001,0.01,0.972,0.9998936622713739,4715,4689
16,9504,10,100,0.001,0.01,0.968,0.9957912457912458,4774,4730
16,9604,10,100,0.001,0.01,0.978,0.995210329029571,4826,4778
16,9704,10,100,0.001,0.01,0.968,0.9967023907666942,4874,4830
16,9804,10,100,0.001,0.01,0.972,0.9919420644634843,4920,4884
16,9904,10,100,0.001,0.01,0.972,0.9911147011308562,4970,4934
16,10004,10,100,0.001,0.01,0.978,0.9925029988004798,5021,4983
16,10104,10,100,0.001,0.01,0.972,0.9919833729216152,5070,5034
16,10204,10,100,0.001,0.01,0.978,0.997451979615837,5112,5092
16,10304,10,100,0.001,0.01,0.984,0.9957298136645962,5166,5138
16,10404,10,100,0.001,0.01,0.966,0.9854863514033064,5223,5181
16,10504,10,100,0.001,0.01,0.958,0.9818164508758568,5271,5233
16,10604,10,100,0.001,0.01,0.974,0.9961335345152773,5315,5289
16,10704,10,100,0.001,0.01,0.976,0.9989723467862481,5362,5342
16,10804,10,100,0.001,0.01,0.978,0.9968530174009627,5417,5387
16,10904,10,100,0.001,0.01,0.982,0.9988994864269992,5470,5434
16,11004,10,100,0.001,0.01,0.988,0.9990003635041803,5527,5477
16,11104,10,100,0.001,0.01,0.984,0.9993695965417867,5586,5518
16,11204,10,100,0.001,0.01,0.986,0.9996429846483399,5632,5572
16,11304,10,100,0.001,0.01,0.984,0.9998230714791224,5670,5634
16,11404,10,100,0.001,0.01,0.986,0.9999123114696598,5725,5679
16,11504,10,100,0.001,0.01,0.986,0.999826147426982,5772,5732
16,11604,10,100,0.001,0.01,0.984,0.9999138228197173,5820,5784
16,11704,10,100,0.001,0.01,0.982,0.9990601503759399,5866,5838
16,11804,10,100,0.001,0.01,0.98,0.9973737716028465,5914,5890
16,11904,10,100,0.001,0.01,0.984,0.9995799731182796,5969,5935
16,12004,10,100,0.001,0.01,0.98,0.9985004998333888,6031,5973
16,12104,10,100,0.001,0.01,0.986,0.9946298744216788,6087,6017
16,12204,10,100,0.001,0.01,0.976,0.9948377581120944,6134,6070
16,12304,10,100,0.001,0.01,0.962,0.9858582574772432,6181,6123
16,12404,10,100,0.001,0.01,0.978,0.9896001289906482,6223,6181
16,12504,10,100,0.001,0.01,0.99,0.9984804862444018,6268,6236
16,12604,10,100,0.001,0.01,0.988,0.9989685814027293,6311,6293
16,12704,10,100,0.001,0.01,0.986,0.9983469773299748,6359,6345
16,12804,10,100,0.001,0.01,0.994,0.9994532958450484,6406,6398
16,12904,10,100,0.001,0.01,0.992,0.9996125232486051,6458,6446
16,13004,10,100,0.001,0.01,0.992,0.9993848046754845,6510,6494
16,13104,10,100,0.001,0.01,0.994,0.9999236874236874,6555,6549
16,13204,10,100,0.001,0.01,0.994,1.0,6601,6603
16,13304,10,100,0.001,0.01,0.994,1.0,6651,6653
16,13404,10,100,0.001,0.01,0.994,1.0,6703,6701
16,13504,10,100,0.001,0.01,0.994,1.0,6756,6748
16,13604,10,100,0.001,0.01,0.992,1.0,6810,6794
16,13704,10,100,0.001,0.01,0.992,1.0,6856,6848
16,13804,10,100,0.001,0.01,0.994,0.999855114459577,6903,6901
16,13904,10,100,0.001,0.01,0.984,0.997554660529344,6942,6962
16,14004,10,100,0.001,0.01,0.976,0.986361039702942,6985,7019
16,14104,10,100,0.001,0.01,0.978,0.9849688031764039,7033,7071
16,14204,10,100,0.001,0.01,0.976,0.9897916079977471,7084,7120
16,14304,10,100,0.001,0.01,0.99,0.9984619686800895,7135,7169
16,14404,10,100,0.001,0.01,0.998,0.9996528742016106,7189,7215
16,14504,10,100,0.001,0.01,0.988,0.9999310535024821,7242,7262
16,14604,10,100,0.001,0.01,0.99,0.9990413585319091,7298,7306
16,14704,10,100,0.001,0.01,0.988,0.9990478781284005,7352,7352
16,14804,10,100,0.001,0.01,0.99,0.9996622534450149,7395,7409
16,14904,10,100,0.001,0.01,0.992,0.9998658078368223,7442,7462
16,15004,10,100,0.001,0.01,0.988,0.9999333511063716,7494,7510
17,104,10,100,0.001,0.01,0.526,0.5673076923076923,43,61
17,204,10,100,0.001,0.01,0.51,0.6715686274509803,99,105
17,304,10,100,0.001,0.01,0.504,0.6842105263157895,148,156
17,404,10,100,0.001,0.01,0.532,0.6361386138613861,189,215
17,504,10,100,0.001,0.01,0.54,0.6150793650793651,246,258
17,604,10,100,0.001,0.01,0.464,0.5844370860927153,291,313
17,704,10,100,0.001,0.01,0.482,0.6349431818181818,338,366
17,804,10,100,0.001,0.01,0.498,0.6131840796019901,392,412
17,904,10,100,0.001,0.01,0.456,0.6316371681415929,448,456
17,1004,10,100,0.001,0.01,0.504,0.6354581673306773,493,511
17,1104,10,100,0.001,0.01,0.522,0.6585144927536232,539,565
17,1204,10,100,0.001,0.01,0.508,0.6868770764119602,592,612
17,1304,10,100,0.001,0.01,0.514,0.6733128834355828,642,662
17,1404,10,100,0.001,0.01,0.512,0.7101139601139601,694,710
17,1504,10,100,0.001,0.01,0.534,0.7174202127659575,742,762
17,1604,10,100,0.001,0.01,0.518,0.7194513715710723,802,802
17,1704,10,100,0.001,0.01,0.518,0.7365023474178404,851,853
17,1804,10,100,0.001,0.01,0.522,0.7560975609756098,902,902
17,1904,10,100,0.001,0.01,0.514,0.7710084033613446,953,951
17,2004,10,100,0.001,0.01,0.524,0.7839321357285429,1006,998
17,2104,10,100,0.001,0.01,0.554,0.7861216730038023,1055,1049
17,2204,10,100,0.001,0.01,0.554,0.8416515426497277,1112,1092
17,2304,10,100,0.001,0.01,0.562,0.83203125,1177,1127
17,2404,10,100,0.001,0.01,0.572,0.8252911813643927,1232,1172
17,2504,10,100,0.001,0.01,0.612,0.8789936102236422,1280,1224
17,2604,10,100,0.001,0.01,0.594,0.8798003072196621,1328,1276
17,2704,10,100,0.001,0.01,0.614,0.9138313609467456,1385,1319
17,2804,10,100,0.001,0.01,0.648,0.9247503566333809,1431,1373
17,2904,10,100,0.001,0.01,0.632,0.8997933884297521,1480,1424
17,3004,10,100,0.001,0.01,0.634,0.9247669773635153,1532,1472
17,3104,10,100,0.001,0.01,0.684,0.8991623711340206,1575,1529
17,3204,10,100,0.001,0.01,0.708,0.9291510611735331,1626,1578
17,3304,10,100,0.001,0.01,0.738,0.9588377723970944,1677,1627
17,3404,10,100,0.001,0.01,0.71,0.9424206815511164,1719,1685
17,3504,10,100,0.001,0.01,0.736,0.9626141552511416,1771,1733
17,3604,10,100,0.001,0.01,0.752,0.9705882352941176,1818,1786
17,3704,10,100,0.001,0.01,0.776,0.9802915766738661,1873,1831
17,3804,10,100,0.001,0.01,0.8,0.9855415352260778,1928,1876
17,3904,10,100,0.001,0.01,0.81,0.9900102459016393,1964,1940
17,4004,10,100,0.001,0.01,0.82,0.9917582417582418,2013,1991
17,4104,10,100,0.001,0.01,0.828,0.9917153996101364,2065,2039
17,4204,10,100,0.001,0.01,0.84,0.9954804947668887,2113,2091
17,4304,10,100,0.001,0.01,0.836,0.9904739776951673,2170,2134
17,4404,10,100,0.001,0.01,0.84,0.9915985467756585,2220,2184
17,4504,10,100,0.001,0.01,0.84,0.9726909413854352,2276,2228
17,4604,10,100,0.001,0.01,0.85,0.9787141615986099,2328,2276
17,4704,10,100,0.001,0.01,0.862,0.9804421768707483,2383,2321
17,4804,10,100,0.001,0.01,0.862,0.9914654454621149,2438,2366
17,4904,10,100,0.001,0.01,0.874,0.9936786296900489,2492,2412
17,5004,10,100,0.001,0.01,0.876,0.9954036770583533,2549,2455
17,5104,10,100,0.001,0.01,0.892,0.997257053291536,2592,2512
17,5204,10,100,0.001,0.01,0.896,0.9971176018447349,2648,2556
17,5304,10,100,0.001,0.01,0.892,0.9975490196078431,2701,2603
17,5404,10,100,0.001,0.01,0.882,0.9890821613619541,2748,2656
17,5504,10,100,0.001,0.01,0.912,0.9943677325581395,2790,2714
17,5604,10,100,0.001,0.01,0.894,0.9926837972876517,2837,2767
17,5704,10,100,0.001,0.01,0.876,0.9833450210378681,2887,2817
17,5804,10,100,0.001,0.01,0.866,0.9777739490006891,2934,2870
17,5904,10,100,0.001,0.01,0.886,0.9915311653116531,2979,2925
17,6004,10,100,0.001,0.01,0.902,0.9913391072618255,3031,2973
17,6104,10,100,0.001,0.01,0.904,0.9950851900393185,3086,3018
17,6204,10,100,0.001,0.01,0.924,0.9975822050290135,3147,3057
17,6304,10,100,0.001,0.01,0.908,0.9963515228426396,3191,3113
17,6404,10,100,0.001,0.01,0.916,0.9942223610243598,3249,3155
17,6504,10,100,0.001,0.01,0.92,0.9964637146371463,3297,3207
17,6604,10,100,0.001,0.01,0.92,0.988037552998183,3359,3245
17,6704,10,100,0.001,0.01,0.916,0.9900059665871122,3418,3286
17,6804,10,100,0.001,0.01,0.926,0.9861845972957084,3461,3343
17,6904,10,100,0.001,0.01,0.93,0.9918887601390498,3508,3396
17,7004,10,100,0.001,0.01,0.92,0.9874357509994289,3565,3439
17,7104,10,100,0.001,0.01,0.936,0.9936655405405406,3625,3479
17,7204,10,100,0.001,0.01,0.948,0.9929205996668518,3667,3537
17,7304,10,100,0.001,0.01,0.928,0.9883625410733844,3716,3588
17,7404,10,100,0.001,0.01,0.928,0.986223662884927,3765,3639
17,7504,10,100,0.001,0.01,0.936,0.992137526652452,3811,3693
17,7604,10,100,0.001,0.01,0.952,0.9926354550236718,3858,3746
17,7704,10,100,0.001,0.01,0.954,0.9977933541017653,3897,3807
17,7804,10,100,0.001,0.01,0.966,0.9992311635058944,3945,3859
17,7904,10,100,0.001,0.01,0.962,0.9996204453441295,3992,3912
17,8004,10,100,0.001,0.01,0.964,0.9958770614692654,4035,3969
17,8104,10,100,0.001,0.01,0.952,0.9914856860809477,4072,4032
17,8204,10,100,0.001,0.01,0.914,0.9499024865919063,4117,4087
17,8304,10,100,0.001,0.01,0.93,0.9642341040462428,4162,4142
17,8404,10,100,0.001,0.01,0.962,0.9896477867682056,4221,4183
17,8504,10,100,0.001,0.01,0.966,0.9950611476952023,4274,4230
17,8604,10,100,0.001,0.01,0.966,0.99907019990702,4325,4279
17,8704,10,100,0.001,0.01,0.964,0.9981617647058824,4375,4329
17,8804,10,100,0.001,0.01,0.962,0.9982962289868241,4428,4376
17,8904,10,100,0.001,0.01,0.966,0.9996630727762803,4477,4427
17,9004,10,100,0.001,0.01,0.966,0.9951132829853399,4536,4468
17,9104,10,100,0.001,0.01,0.958,0.9972539543057997,4595,4509
17,9204,10,100,0.001,0.01,0.966,0.9966318991742721,4634,4570
17,9304,10,100,0.001,0.01,0.968,0.9970980223559759,4695,4609
17,9404,10,100,0.001,0.01,0.958,0.9912803062526584,4746,4658
17,9504,10,100,0.001,0.01,0.968,0.9967382154882155,4795,4709
17,9604,10,100,0.001,0.01,0.974,0.9997917534360683,4845,4759
17,9704,10,100,0.001,0.01,0.976,1.0,4890,4814
17,9804,10,100,0.001,0.01,0.972,1.0,4933,4871
17,9904,10,100,0.001,0.01,0.978,0.9998990306946688,4984,4920
17,10004,10,100,0.001,0.01,0.972,0.9964014394242303,5031,4973
17,10104,10,100,0.001,0.01,0.96,0.9913895486935868,5084,5020
17,10204,10,100,0.001,0.01,0.952,0.9864758918071345,5131,5073
17,10304,10,100,0.001,0.01,0.982,0.9946622670807453,5182,5122
17,10404,10,100,0.001,0.01,0.97,0.9981737793156479,5228,5176
17,10504,10,100,0.001,0.01,0.978,0.9989527798933739,5277,5227
17,10604,10,100,0.001,0.01,0.984,0.9999056959637872,5323,5281
17,10704,10,100,0.001,0.01,0.978,0.999813153961136,5369,5335
17,10804,10,100,0.001,0.01,0.986,1.0,5409,5395
17,10904,10,100,0.001,0.01,0.976,0.9998165810711666,5453,5451
17,11004,10,100,0.001,0.01,0.978,0.9989094874591058,5503,5501
17,11104,10,100,0.001,0.01,0.98,0.9996397694524496,5552,5552
17,11204,10,100,0.001,0.01,0.976,0.9994644769725098,5600,5604
17,11304,10,100,0.001,0.01,0.98,1.0,5651,5653
17,11404,10,100,0.001,0.01,0.984,0.9995615573482989,5700,5704
17,11504,10,100,0.001,0.01,0.98,0.9993915159944368,5754,5750
17,11604,10,100,0.001,0.01,0.966,0.98802137194071,5801,5803
17,11704,10,100,0.001,0.01,0.974,0.99419002050581,5859,5845
17,11804,10,100,0.001,0.01,0.972,0.9944086750254151,5922,5882
17,11904,10,100,0.001,0.01,0.98,0.9975638440860215,5976,5928
17,12004,10,100,0.001,0.01,0.98,0.9990003332222592,6026,5978
17,12104,10,100,0.001,0.01,0.976,0.9966126900198281,6075,6029
17,12204,10,100,0.001,0.01,0.976,0.9928711897738446,6124,6080
17,12304,10,100,0.001,0.01,0.98,0.9978055916775033,6169,6135
17,12404,10,100,0.001,0.01,0.978,0.9975008061915511,6216,6188
17,12504,10,100,0.001,0.01,0.978,0.9988003838771593,6266,6238
17,12604,10,100,0.001,0.01,0.988,0.9984925420501428,6315,6289
17,12704,10,100,0.001,0.01,0.98,0.993860201511335,6366,6338
17,12804,10,100,0.001,0.01,0.974,0.9978131833801936,6424,6380
17,12904,10,100,0.001,0.01,0.982,0.9984500929944203,6470,6434
17,13004,10,100,0.001,0.01,0.98,0.9974623192863734,6517,6487
17,13104,10,100,0.001,0.01,0.98,0.9990842490842491,6555,6549
17,13204,10,100,0.001,0.01,0.978,0.9984095728567101,6600,6604
17,13304,10,100,0.001,0.01,0.986,0.9987973541791942,6653,6651
17,13404,10,100,0.001,0.01,0.984,0.9985825126827813,6704,6700
17,13504,10,100,0.001,0.01,0.988,0.9996297393364929,6758,6746
17,13604,10,100,0.001,0.01,0.984,0.9998529844163482,6815,6789
17,13704,10,100,0.001,0.01,0.984,0.9999270286047869,6871,6833
17,13804,10,100,0.001,0.01,0.984,1.0,6921,6883
17,13904,10,100,0.001,0.01,0.974,0.9972669735327964,6977,6927
17,14004,10,100,0.001,0.01,0.976,0.9979291630962582,7016,6988
17,14104,10,100,0.001,0.01,0.986,0.9976602382302893,7065,7039
17,14204,10,100,0.001,0.01,0.986,0.9930301323570825,7108,7096
17,14304,10,100,0.001,0.01,0.982,0.998182326621924,7152,7152
17,14404,10,100,0.001,0.01,0.986,0.9972229936128854,7201,7203
17,14504,10,100,0.001,0.01,0.978,0.9992415885273028,7254,7250
17,14604,10,100,0.001,0.01,0.984,0.9997261024376883,7302,7302
17,14704,10,100,0.001,0.01,0.982,0.9986398258977149,7350,7354
17,14804,10,100,0.001,0.01,0.982,0.9993245068900297,7399,7405
17,14904,10,100,0.001,0.01,0.988,0.9997316156736447,7438,7466
17,15004,10,100,0.001,0.01,0.988,1.0,7489,7515
18,104,10,100,0.001,0.01,0.494,0.7596153846153846,49,55
18,204,10,100,0.001,0.01,0.478,0.6568627450980392,97,107
18,304,10,100,0.001,0.01,0.48,0.694078947368421,151,153
18,404,10,100,0.001,0.01,0.462,0.6707920792079208,201,203
18,504,10,100,0.001,0.01,0.47,0.6607142857142857,248,256
18,604,10,100,0.001,0.01,0.484,0.695364238410596,295,309
18,704,10,100,0.001,0.01,0.46,0.6860795454545454,344,360
18,804,10,100,0.001,0.01,0.514,0.6703980099502488,388,416
18,904,10,100,0.001,0.01,0.5,0.6603982300884956,441,463
18,1004,10,100,0.001,0.01,0.538,0.6802788844621513,492,512
18,1104,10,100,0.001,0.01,0.532,0.6865942028985508,538,566
18,1204,10,100,0.001,0.01,0.518,0.6727574750830565,600,604
18,1304,10,100,0.001,0.01,0.522,0.6679447852760736,646,658
18,1404,10,100,0.001,0.01,0.502,0.6666666666666666,697,707
18,1504,10,100,0.001,0.01,0.5,0.694813829787234,750,754
18,1604,10,100,0.001,0.01,0.54,0.722568578553616,794,810
18,1704,10,100,0.001,0.01,0.522,0.7505868544600939,848,856
18,1804,10,100,0.001,0.01,0.51,0.7788248337028825,901,903
18,1904,10,100,0.001,0.01,0.492,0.7394957983193278,949,955
18,2004,10,100,0.001,0.01,0.54,0.7639720558882236,1000,1004
18,2104,10,100,0.001,0.01,0.51,0.7633079847908745,1054,1050
18,2204,10,100,0.001,0.01,0.536,0.7876588021778584,1105,1099
18,2304,10,100,0.001,0.01,0.568,0.7912326388888888,1159,1145
18,2404,10,100,0.001,0.01,0.55,0.8286189683860233,1196,1208
18,2504,10,100,0.001,0.01,0.56,0.8538338658146964,1233,1271
18,2604,10,100,0.001,0.01,0.552,0.8874807987711214,1287,1317
18,2704,10,100,0.001,0.01,0.568,0.8302514792899408,1335,1369
18,2804,10,100,0.001,0.01,0.56,0.8723252496433667,1380,1424
18,2904,10,100,0.001,0.01,0.598,0.8519283746556474,1435,1469
18,3004,10,100,0.001,0.01,0.606,0.8894806924101198,1482,1522
18,3104,10,100,0.001,0.01,0.662,0.9262242268041238,1522,1582
18,3204,10,100,0.001,0.01,0.65,0.9213483146067416,1567,1637
18,3304,10,100,0.001,0.01,0.662,0.9440072639225182,1612,1692
18,3404,10,100,0.001,0.01,0.682,0.954171562867215,1656,1748
18,3504,10,100,0.001,0.01,0.708,0.9646118721461188,1700,1804
18,3604,10,100,0.001,0.01,0.71,0.9639289678135405,1742,1862
18,3704,10,100,0.001,0.01,0.722,0.9370950323974082,1795,1909
18,3804,10,100,0.001,0.01,0.738,0.9560988433228181,1846,1958
18,3904,10,100,0.001,0.01,0.736,0.9508196721311475,1899,2005
18,4004,10,100,0.001,0.01,0.782,0.9725274725274725,1950,2054
18,4104,10,100,0.001,0.01,0.788,0.9734405458089669,2005,2099
18,4204,10,100,0.001,0.01,0.8,0.9809705042816366,2056,2148
18,4304,10,100,0.001,0.01,0.818,0.9848977695167286,2110,2194
18,4404,10,100,0.001,0.01,0.82,0.9811534968210718,2160,2244
18,4504,10,100,0.001,0.01,0.84,0.9793516873889876,2207,2297
18,4604,10,100,0.001,0.01,0.818,0.9680712423979149,2257,2347
18,4704,10,100,0.001,0.01,0.856,0.9776785714285714,2309,2395
18,4804,10,100,0.001,0.01,0.862,0.9746044962531224,2364,2440
18,4904,10,100,0.001,0.01,0.874,0.9728792822185971,2415,2489
18,5004,10,100,0.001,0.01,0.872,0.9820143884892086,2467,2537
18,5104,10,100,0.001,0.01,0.89,0.995101880877743,2522,2582
18,5204,10,100,0.001,0.01,0.896,0.994619523443505,2570,2634
18,5304,10,100,0.001,0.01,0.91,0.9958521870286576,2620,2684
18,5404,10,100,0.001,0.01,0.918,0.997039230199852,2672,2732
18,5504,10,100,0.001,0.01,0.914,0.9954578488372093,2721,2783
18,5604,10,100,0.001,0.01,0.912,0.9991077801570307,2765,2839
18,5704,10,100,0.001,0.01,0.93,0.9989481065918654,2810,2894
18,5804,10,100,0.001,0.01,0.91,0.9939696760854583,2867,2937
18,5904,10,100,0.001,0.01,0.92,0.994410569105691,2913,2991
18,6004,10,100,0.001,0.01,0.928,0.9948367754830113,2965,3039
18,6104,10,100,0.001,0.01,0.924,0.994429882044561,3013,3091
18,6204,10,100,0.001,0.01,0.946,0.9990328820116054,3054,3150
18,6304,10,100,0.001,0.01,0.94,0.9955583756345178,3103,3201
18,6404,10,100,0.001,0.01,0.924,0.9826670830730794,3152,3252
18,6504,10,100,0.001,0.01,0.948,0.995079950799508,3207,3297
18,6604,10,100,0.001,0.01,0.924,0.9857662023016354,3257,3347
18,6704,10,100,0.001,0.01,0.936,0.9677804295942721,3309,3395
18,6804,10,100,0.001,0.01,0.928,0.9844209288653734,3352,3452
18,6904,10,100,0.001,0.01,0.966,0.9929026651216686,3410,3494
18,7004,10,100,0.001,0.01,0.964,0.9964306110793832,3463,3541
18,7104,10,100,0.001,0.01,0.964,0.9971846846846847,3517,3587
18,7204,10,100,0.001,0.01,0.964,0.9981954469739034,3564,3640
18,7304,10,100,0.001,0.01,0.968,0.999315443592552,3613,3691
18,7404,10,100,0.001,0.01,0.972,0.9998649378714208,3669,3735
18,7504,10,100,0.001,0.01,0.98,1.0,3715,3789
18,7604,10,100,0.001,0.01,0.972,0.9997369805365597,3763,3841
18,7704,10,100,0.001,0.01,0.974,0.9997403946002077,3818,3886
18,7804,10,100,0.001,0.01,0.978,1.0,3860,3944
18,7904,10,100,0.001,0.01,0.978,0.999746963562753,3907,3997
18,8004,10,100,0.001,0.01,0.982,0.9987506246876562,3955,4049
18,8104,10,100,0.001,0.01,0.968,0.9986426456071076,3996,4108
18,8204,10,100,0.001,0.01,0.976,0.9991467576791809,4047,4157
18,8304,10,100,0.001,0.01,0.968,0.9980732177263969,4101,4203
18,8404,10,100,0.001,0.01,0.982,0.9986910994764397,4147,4257
18,8504,10,100,0.001,0.01,0.974,0.9991768579492004,4194,4310
18,8604,10,100,0.001,0.01,0.97,0.99814039981404,4246,4358
18,8704,10,100,0.001,0.01,0.98,0.9994255514705882,4307,4397
18,8804,10,100,0.001,0.01,0.97,0.997955474784189,4362,4442
18,8904,10,100,0.001,0.01,0.972,0.9946091644204852,4416,4488
18,9004,10,100,0.001,0.01,0.964,0.9858951577076854,4463,4541
18,9104,10,100,0.001,0.01,0.968,0.9881370826010545,4518,4586
18,9204,10,100,0.001,0.01,0.976,0.9929378531073446,4566,4638
18,9304,10,100,0.001,0.01,0.976,0.9965606190885641,4618,4686
18,9404,10,100,0.001,0.01,0.982,0.9967035304125904,4667,4737
18,9504,10,100,0.001,0.01,0.978,0.9997895622895623,4712,4792
18,9604,10,100,0.001,0.01,0.98,0.9998958767180341,4765,4839
18,9704,10,100,0.001,0.01,0.978,0.9996908491343776,4815,4889
18,9804,10,100,0.001,0.01,0.98,0.99265605875153,4863,4941
18,9904,10,100,0.001,0.01,0.974,0.9929321486268174,4913,4991
18,10004,10,100,0.001,0.01,0.97,0.9878048780487805,4957,5047
18,10104,10,100,0.001,0.01,0.982,0.9979216152019003,5011,5093
18,10204,10,100,0.001,0.01,0.98,0.9957859662877303,5070,5134
18,10304,10,100,0.001,0.01,0.982,0.9983501552795031,5119,5185
18,10404,10,100,0.001,0.01,0.982,0.999519415609381,5170,5234
18,10504,10,100,0.001,0.01,0.98,0.9995239908606245,5215,5289
18,10604,10,100,0.001,0.01,0.98,0.995096190116937,5261,5343
18,10704,10,100,0.001,0.01,0.986,0.9997197309417041,5309,5395
18,10804,10,100,0.001,0.01,0.986,0.9996297667530544,5367,5437
18,10904,10,100,0.001,0.01,0.99,1.0,5419,5485
18,11004,10,100,0.001,0.01,0.984,0.9992729916394039,5468,5536
18,11104,10,100,0.001,0.01,0.986,0.9993695965417867,5532,5572
18,11204,10,100,0.001,0.01,0.978,0.9972331310246341,5585,5619
18,11304,10,100,0.001,0.01,0.98,0.9996461429582448,5634,5670
18,11404,10,100,0.001,0.01,0.988,0.9995615573482989,5679,5725
18,11504,10,100,0.001,0.01,0.99,1.0,5735,5769
18,11604,10,100,0.001,0.01,0.99,1.0,5784,5820
18,11704,10,100,0.001,0.01,0.99,0.9994873547505126,5834,5870
18,11804,10,100,0.001,0.01,0.986,0.998898678414097,5885,5919
18,11904,10,100,0.001,0.01,0.984,0.9963037634408602,5930,5974
18,12004,10,100,0.001,0.01,0.974,0.990169943352216,5979,6025
18,12104,10,100,0.001,0.01,0.984,0.9952908129543953,6029,6075
18,12204,10,100,0.001,0.01,0.976,0.9916420845624385,6070,6134
18,12304,10,100,0.001,0.01,0.988,0.9982119635890767,6127,6177
18,12404,10,100,0.001,0.01,0.988,0.9994356659142212,6192,6212
18,12504,10,100,0.001,0.01,0.982,0.9982405630198337,6249,6255
18,12604,10,100,0.001,0.01,0.99,0.9978578229133609,6295,6309
18,12704,10,100,0.001,0.01,0.988,0.9985831234256927,6337,6367
18,12804,10,100,0.001,0.01,0.99,0.9989065916900969,6384,6420
18,12904,10,100,0.001,0.01,0.988,0.9997675139491631,6439,6465
18,13004,10,100,0.001,0.01,0.986,0.99930790525992,6491,6513
18,13104,10,100,0.001,0.01,0.988,0.9997710622710623,6540,6564
18,13204,10,100,0.001,0.01,0.986,0.9991669191154195,6604,6600
18,13304,10,100,0.001,0.01,0.994,0.9984966927239928,6653,6651
18,13404,10,100,0.001,0.01,0.982,0.9971650253655625,6702,6702
18,13504,10,100,0.001,0.01,0.988,0.9977784360189573,6752,6752
18,13604,10,100,0.001,0.01,0.968,0.983460746839165,6803,6801
18,13704,10,100,0.001,0.01,0.986,0.9961325160537069,6844,6860
18,13804,10,100,0.001,0.01,0.99,0.9975369458128078,6899,6905
18,13904,10,100,0.001,0.01,0.99,0.999928078250863,6943,6961
18,14004,10,100,0.001,0.01,0.992,1.0,7001,7003
18,14104,10,100,0.001,0.01,0.99,0.9999290981281905,7071,7033
18,14204,10,100,0.001,0.01,0.99,0.9994367783722895,7126,7078
18,14304,10,100,0.001,0.01,0.994,0.9997203579418344,7172,7132
18,14404,10,100,0.001,0.01,0.99,0.9981255206886975,7221,7183
18,14504,10,100,0.001,0.01,0.986,0.9977247655819085,7266,7238
18,14604,10,100,0.001,0.01,0.986,0.9965078060805259,7312,7292
18,14704,10,100,0.001,0.01,0.984,0.9925870511425462,7358,7346
18,14804,10,100,0.001,0.01,0.986,0.9992569575790327,7412,7392
18,14904,10,100,0.001,0.01,0.99,0.9993961352657005,7464,7440
18,15004,10,100,0.001,0.01,0.992,0.9996667555318581,7510,7494
19,104,10,100,0.001,0.01,0.506,0.5384615384615384,54,50
19,204,10,100,0.001,0.01,0.48,0.5833333333333334,112,92
19,304,10,100,0.001,0.01,0.498,0.6776315789473685,163,141
19,404,10,100,0.001,0.01,0.522,0.6237623762376238,211,193
19,504,10,100,0.001,0.01,0.532,0.6488095238095238,255,249
19,604,10,100,0.001,0.01,0.506,0.640728476821192,301,303
19,704,10,100,0.001,0.01,0.524,0.6377840909090909,357,347
19,804,10,100,0.001,0.01,0.538,0.6865671641791045,409,395
19,904,10,100,0.001,0.01,0.504,0.6758849557522124,458,446
19,1004,10,100,0.001,0.01,0.524,0.6912350597609562,509,495
19,1104,10,100,0.001,0.01,0.528,0.6730072463768116,554,550
19,1204,10,100,0.001,0.01,0.546,0.6926910299003323,609,595
19,1304,10,100,0.001,0.01,0.552,0.6871165644171779,665,639
19,1404,10,100,0.001,0.01,0.556,0.717948717948718,711,693
19,1504,10,100,0.001,0.01,0.556,0.7047872340425532,772,732
19,1604,10,100,0.001,0.01,0.508,0.7038653366583542,820,784
19,1704,10,100,0.001,0.01,0.552,0.6830985915492958,870,834
19,1804,10,100,0.001,0.01,0.588,0.7605321507760532,915,889
19,1904,10,100,0.001,0.01,0.592,0.773109243697479,960,944
19,2004,10,100,0.001,0.01,0.582,0.7774451097804391,1012,992
19,2104,10,100,0.001,0.01,0.554,0.7609315589353612,1060,1044
19,2204,10,100,0.001,0.01,0.582,0.8103448275862069,1116,1088
19,2304,10,100,0.001,0.01,0.604,0.8585069444444444,1170,1134
19,2404,10,100,0.001,0.01,0.602,0.848585690515807,1214,1190
19,2504,10,100,0.001,0.01,0.638,0.8242811501597445,1260,1244
19,2604,10,100,0.001,0.01,0.674,0.8671274961597543,1318,1286
19,2704,10,100,0.001,0.01,0.694,0.9045857988165681,1363,1341
19,2804,10,100,0.001,0.01,0.682,0.9104850213980028,1407,1397
19,2904,10,100,0.001,0.01,0.688,0.9259641873278237,1456,1448
19,3004,10,100,0.001,0.01,0.714,0.9114513981358189,1514,1490
19,3104,10,100,0.001,0.01,0.704,0.9010953608247423,1567,1537
19,3204,10,100,0.001,0.01,0.698,0.8985642946317104,1616,1588
19,3304,10,100,0.001,0.01,0.736,0.9412832929782082,1660,1644
19,3404,10,100,0.001,0.01,0.754,0.931551116333725,1708,1696
19,3504,10,100,0.001,0.01,0.768,0.9386415525114156,1756,1748
19,3604,10,100,0.001,0.01,0.76,0.9558823529411765,1806,1798
19,3704,10,100,0.001,0.01,0.792,0.963012958963283,1848,1856
19,3804,10,100,0.001,0.01,0.798,0.9684542586750788,1904,1900
19,3904,10,100,0.001,0.01,0.826,0.9741290983606558,1962,1942
19,4004,10,100,0.001,0.01,0.85,0.9807692307692307,2006,1998
19,4104,10,100,0.001,0.01,0.874,0.9819688109161794,2057,2047
19,4204,10,100,0.001,0.01,0.87,0.9931018078020932,2103,2101
19,4304,10,100,0.001,0.01,0.89,0.9939591078066915,2150,2154
19,4404,10,100,0.001,0.01,0.902,0.9961398728428701,2189,2215
19,4504,10,100,0.001,0.01,0.91,0.9962255772646537,2234,2270
19,4604,10,100,0.001,0.01,0.91,0.9984795829713293,2292,2312
19,4704,10,100,0.001,0.01,0.92,0.9976615646258503,2340,2364
19,4804,10,100,0.001,0.01,0.918,0.9972939217318901,2391,2413
19,4904,10,100,0.001,0.01,0.932,0.9993882544861338,2438,2466
19,5004,10,100,0.001,0.01,0.934,0.9958033573141487,2487,2517
19,5104,10,100,0.001,0.01,0.93,0.9986285266457681,2535,2569
19,5204,10,100,0.001,0.01,0.928,0.995772482705611,2584,2620
19,5304,10,100,0.001,0.01,0.936,0.9986802413273002,2638,2666
19,5404,10,100,0.001,0.01,0.942,0.9966691339748335,2694,2710
19,5504,10,100,0.001,0.01,0.936,0.9934593023255814,2745,2759
19,5604,10,100,0.001,0.01,0.93,0.9919700214132763,2800,2804
19,5704,10,100,0.001,0.01,0.94,0.9963183730715287,2855,2849
19,5804,10,100,0.001,0.01,0.948,0.9953480358373535,2904,2900
19,5904,10,100,0.001,0.01,0.954,0.997289972899729,2947,2957
19,6004,10,100,0.001,0.01,0.948,0.9973351099267155,2989,3015
19,6104,10,100,0.001,0.01,0.946,0.9949213630406291,3045,3059
19,6204,10,100,0.001,0.01,0.954,0.9962927143778207,3084,3120
19,6304,10,100,0.001,0.01,0.958,0.9946065989847716,3130,3174
19,6404,10,100,0.001,0.01,0.948,0.9929731417863835,3185,3219
19,6504,10,100,0.001,0.01,0.952,0.9961562115621156,3239,3265
19,6604,10,100,0.001,0.01,0.948,0.9906117504542702,3289,3315
19,6704,10,100,0.001,0.01,0.966,0.9947792362768496,3340,3364
19,6804,10,100,0.001,0.01,0.97,0.9972075249853027,3400,3404
19,6904,10,100,0.001,0.01,0.972,0.9978273464658169,3448,3456
19,7004,10,100,0.001,0.01,0.978,0.999143346659052,3498,3506
19,7104,10,100,0.001,0.01,0.97,0.9991554054054054,3552,3552
19,7204,10,100,0.001,0.01,0.972,0.9990283176013326,3599,3605
19,7304,10,100,0.001,0.01,0.976,0.9994523548740416,3646,3658
19,7404,10,100,0.001,0.01,0.972,0.9993246893571043,3694,3710
19,7504,10,100,0.001,0.01,0.974,0.9994669509594882,3742,3762
19,7604,10,100,0.001,0.01,0.972,0.9996054708048395,3791,3813
19,7704,10,100,0.001,0.01,0.968,0.9998701973001038,3838,3866
19,7804,10,100,0.001,0.01,0.974,0.9993593029215787,3887,3917
19,7904,10,100,0.001,0.01,0.946,0.9767206477732794,3934,3970
19,8004,10,100,0.001,0.01,0.974,0.9930034982508745,3979,4025
19,8104,10,100,0.001,0.01,0.982,0.9940769990128332,4041,4063
19,8204,10,100,0.001,0.01,0.982,0.9963432471964895,4095,4109
19,8304,10,100,0.001,0.01,0.982,0.9969894026974951,4141,4163
19,8404,10,100,0.001,0.01,0.982,0.9995240361732508,4189,4215
19,8504,10,100,0.001,0.01,0.984,1.0,4237,4267
19,8604,10,100,0.001,0.01,0.982,1.0,4293,4311
19,8704,10,100,0.001,0.01,0.986,1.0,4348,4356
19,8804,10,100,0.001,0.01,0.986,1.0,4399,4405
19,8904,10,100,0.001,0.01,0.982,1.0,4441,4463
19,9004,10,100,0.001,0.01,0.98,1.0,4494,4510
19,9104,10,100,0.001,0.01,0.98,0.9987917398945518,4539,4565
19,9204,10,100,0.001,0.01,0.98,0.9963059539330725,4585,4619
19,9304,10,100,0.001,0.01,0.98,0.9980653482373173,4639,4665
19,9404,10,100,0.001,0.01,0.984,0.9978732454274777,4691,4713
19,9504,10,100,0.001,0.01,0.978,0.9982112794612794,4747,4757
19,9604,10,100,0.001,0.01,0.976,0.9953144523115368,4790,4814
19,9704,10,100,0.001,0.01,0.974,0.995156636438582,4844,4860
19,9804,10,100,0.001,0.01,0.97,0.9953080375356997,4895,4909
19,9904,10,100,0.001,0.01,0.984,0.998889337641357,4943,4961
19,10004,10,100,0.001,0.01,0.976,0.9987005197920832,4998,5006
19,10104,10,100,0.001,0.01,0.978,0.9995051464766429,5054,5050
19,10204,10,100,0.001,0.01,0.984,0.9995099960799686,5102,5102
19,10304,10,100,0.001,0.01,0.982,0.999805900621118,5153,5151
19,10404,10,100,0.001,0.01,0.988,0.9989427143406382,5203,5201
19,10504,10,100,0.001,0.01,0.982,0.9968583396801218,5257,5247
19,10604,10,100,0.001,0.01,0.98,0.9940588457185967,5316,5288
19,10704,10,100,0.001,0.01,0.976,0.9944880418535127,5368,5336
19,10804,10,100,0.001,0.01,0.982,0.9981488337652721,5418,5386
19,10904,10,100,0.001,0.01,0.988,0.9997248716067498,5466,5438
19,11004,10,100,0.001,0.01,0.988,0.9999091239549255,5510,5494
19,11104,10,100,0.001,0.01,0.98,0.9972982708933718,5561,5543
19,11204,10,100,0.001,0.01,0.986,0.9989289539450197,5609,5595
19,11304,10,100,0.001,0.01,0.974,0.9934536447275301,5653,5651
19,11404,10,100,0.001,0.01,0.984,0.9992108032269379,5703,5701
19,11504,10,100,0.001,0.01,0.988,0.9996522948539638,5762,5742
19,11604,10,100,0.001,0.01,0.988,0.999741468459152,5817,5787
19,11704,10,100,0.001,0.01,0.984,0.9997436773752563,5866,5838
19,11804,10,100,0.001,0.01,0.986,0.9983056590986107,5910,5894
19,11904,10,100,0.001,0.01,0.988,0.9996639784946236,5963,5941
19,12004,10,100,0.001,0.01,0.99,1.0,6011,5993
19,12104,10,100,0.001,0.01,0.99,1.0,6072,6032
19,12204,10,100,0.001,0.01,0.99,1.0,6111,6093
19,12304,10,100,0.001,0.01,0.99,1.0,6158,6146
19,12404,10,100,0.001,0.01,0.986,0.9999193808448887,6195,6209
19,12504,10,100,0.001,0.01,0.988,1.0,6246,6258
19,12604,10,100,0.001,0.01,0.988,1.0,6296,6308
19,12704,10,100,0.001,0.01,0.988,1.0,6337,6367
19,12804,10,100,0.001,0.01,0.988,1.0,6386,6418
19,12904,10,100,0.001,0.01,0.988,1.0,6433,6471
19,13004,10,100,0.001,0.01,0.992,0.9988465087665334,6479,6525
19,13104,10,100,0.001,0.01,0.96,0.9748931623931624,6533,6571
19,13204,10,100,0.001,0.01,0.984,0.9915177219024538,6588,6616
19,13304,10,100,0.001,0.01,0.982,0.9987973541791942,6633,6671
19,13404,10,100,0.001,0.01,0.986,0.9995523724261415,6680,6724
19,13504,10,100,0.001,0.01,0.99,0.9997037914691943,6736,6768
19,13604,10,100,0.001,0.01,0.988,1.0,6780,6824
19,13704,10,100,0.001,0.01,0.986,0.9999270286047869,6835,6869
19,13804,10,100,0.001,0.01,0.988,1.0,6887,6917
19,13904,10,100,0.001,0.01,0.988,1.0,6935,6969
19,14004,10,100,0.001,0.01,0.988,1.0,6986,7018
19,14104,10,100,0.001,0.01,0.988,1.0,7042,7062
19,14204,10,100,0.001,0.01,0.988,1.0,7089,7115
19,14304,10,100,0.001,0.01,0.986,0.9999300894854586,7146,7158
19,14404,10,100,0.001,0.01,0.986,0.9983337961677312,7195,7209
19,14504,10,100,0.001,0.01,0.986,0.997173193601765,7243,7261
19,14604,10,100,0.001,0.01,0.98,0.9961654341276363,7289,7315
19,14704,10,100,0.001,0.01,0.982,0.9951713819368879,7340,7364
19,14804,10,100,0.001,0.01,0.988,0.9972980275601189,7394,7410
19,14904,10,100,0.001,0.01,0.99,0.9993290391841116,7447,7457
19,15004,10,100,0.001,0.01,0.986,0.9978005865102639,7494,7510
20,104,10,100,0.001,0.01,0.476,0.7596153846153846,53,51
20,204,10,100,0.001,0.01,0.5,0.7401960784313726,112,92
20,304,10,100,0.001,0.01,0.498,0.7039473684210527,168,136
20,404,10,100,0.001,0.01,0.516,0.6534653465346535,221,183
20,504,10,100,0.001,0.01,0.508,0.6527777777777778,278,226
20,604,10,100,0.001,0.01,0.496,0.6821192052980133,331,273
20,704,10,100,0.001,0.01,0.512,0.6434659090909091,379,325
20,804,10,100,0.001,0.01,0.48,0.6691542288557214,446,358
20,904,10,100,0.001,0.01,0.492,0.6869469026548672,499,405
20,1004,10,100,0.001,0.01,0.482,0.6912350597609562,548,456
20,1104,10,100,0.001,0.01,0.476,0.654891304347826,607,497
20,1204,10,100,0.001,0.01,0.504,0.6843853820598007,654,550
20,1304,10,100,0.001,0.01,0.494,0.6909509202453987,711,593
20,1404,10,100,0.001,0.01,0.486,0.7293447293447294,759,645
20,1504,10,100,0.001,0.01,0.486,0.7074468085106383,800,704
20,1604,10,100,0.001,0.01,0.494,0.7437655860349127,842,762
20,1704,10,100,0.001,0.01,0.468,0.7376760563380281,897,807
20,1804,10,100,0.001,0.01,0.488,0.7716186252771619,941,863
20,1904,10,100,0.001,0.01,0.468,0.7457983193277311,995,909
20,2004,10,100,0.001,0.01,0.506,0.7674650698602794,1041,963
20,2104,10,100,0.001,0.01,0.48,0.780893536121673,1090,1014
20,2204,10,100,0.001,0.01,0.5,0.8357531760435571,1143,1061
20,2304,10,100,0.001,0.01,0.51,0.8207465277777778,1192,1112
20,2404,10,100,0.001,0.01,0.526,0.8115640599001663,1234,1170
20,2504,10,100,0.001,0.01,0.52,0.84185303514377,1280,1224
20,2604,10,100,0.001,0.01,0.548,0.8548387096774194,1332,1272
20,2704,10,100,0.001,0.01,0.57,0.8742603550295858,1375,1329
20,2804,10,100,0.001,0.01,0.562,0.8937232524964337,1427,1377
20,2904,10,100,0.001,0.01,0.64,0.8956611570247934,1476,1428
20,3004,10,100,0.001,0.01,0.632,0.8874833555259654,1530,1474
20,3104,10,100,0.001,0.01,0.674,0.8962628865979382,1582,1522
20,3204,10,100,0.001,0.01,0.686,0.9122971285892634,1632,1572
20,3304,10,100,0.001,0.01,0.722,0.9452179176755447,1687,1617
20,3404,10,100,0.001,0.01,0.752,0.9659224441833137,1738,1666
20,3504,10,100,0.001,0.01,0.774,0.9500570776255708,1796,1708
20,3604,10,100,0.001,0.01,0.794,0.9603218645948945,1850,1754
20,3704,10,100,0.001,0.01,0.772,0.9271058315334774,1894,1810
20,3804,10,100,0.001,0.01,0.808,0.9484752891692955,1943,1861
20,3904,10,100,0.001,0.01,0.852,0.9774590163934426,1992,1912
20,4004,10,100,0.001,0.01,0.844,0.9845154845154845,2048,1956
20,4104,10,100,0.001,0.01,0.886,0.99317738791423,2100,2004
20,4204,10,100,0.001,0.01,0.85,0.9857278782112274,2150,2054
20,4304,10,100,0.001,0.01,0.852,0.9711895910780669,2195,2109
20,4404,10,100,0.001,0.01,0.878,0.9854677565849228,2242,2162
20,4504,10,100,0.001,0.01,0.89,0.9906749555950266,2297,2207
20,4604,10,100,0.001,0.01,0.892,0.9923979148566464,2349,2255
20,4704,10,100,0.001,0.01,0.9,0.9957482993197279,2405,2299
20,4804,10,100,0.001,0.01,0.904,0.9972939217318901,2459,2345
20,4904,10,100,0.001,0.01,0.912,0.9930668841761827,2503,2401
20,5004,10,100,0.001,0.01,0.914,0.9932054356514788,2554,2450
20,5104,10,100,0.001,0.01,0.918,0.9941222570532915,2599,2505
20,5204,10,100,0.001,0.01,0.924,0.9932744043043813,2652,2552
20,5304,10,100,0.001,0.01,0.93,0.998868778280543,2699,2605
20,5404,10,100,0.001,0.01,0.93,0.9985196150999259,2742,2662
20,5504,10,100,0.001,0.01,0.938,0.9998183139534884,2798,2706
20,5604,10,100,0.001,0.01,0.938,1.0,2842,2762
20,5704,10,100,0.001,0.01,0.946,0.9994740532959326,2894,2810
20,5804,10,100,0.001,0.01,0.922,0.9894900068917988,2941,2863
20,5904,10,100,0.001,0.01,0.906,0.9583333333333334,2993,2911
20,6004,10,100,0.001,0.01,0.926,0.9848434377081945,3037,2967
20,6104,10,100,0.001,0.01,0.936,0.9924639580602883,3092,3012
20,6204,10,100,0.001,0.01,0.944,0.9969374597034172,3141,3063
20,6304,10,100,0.001,0.01,0.948,0.9995241116751269,3187,3117
20,6404,10,100,0.001,0.01,0.948,0.9987507807620237,3232,3172
20,6504,10,100,0.001,0.01,0.952,0.9992312423124231,3288,3216
20,6604,10,100,0.001,0.01,0.952,0.9995457298606905,3343,3261
20,6704,10,100,0.001,0.01,0.95,1.0,3391,3313
20,6804,10,100,0.001,0.01,0.952,1.0,3440,3364
20,6904,10,100,0.001,0.01,0.956,1.0,3484,3420
20,7004,10,100,0.001,0.01,0.958,1.0,3536,3468
20,7104,10,100,0.001,0.01,0.956,0.9997184684684685,3585,3519
20,7204,10,100,0.001,0.01,0.95,0.9987506940588562,3638,3566
20,7304,10,100,0.001,0.01,0.956,0.9990416210295728,3687,3617
20,7404,10,100,0.001,0.01,0.956,0.9991896272285251,3734,3670
20,7504,10,100,0.001,0.01,0.942,0.9922707889125799,3779,3725
20,7604,10,100,0.001,0.01,0.942,0.9896107311941084,3827,3777
20,7704,10,100,0.001,0.01,0.952,0.9963655244029076,3884,3820
20,7804,10,100,0.001,0.01,0.958,0.998077908764736,3943,3861
20,7904,10,100,0.001,0.01,0.964,0.9994939271255061,3992,3912
20,8004,10,100,0.001,0.01,0.962,0.9991254372813593,4045,3959
20,8104,10,100,0.001,0.01,0.964,0.9996298124383021,4089,4015
20,8204,10,100,0.001,0.01,0.968,1.0,4132,4072
20,8304,10,100,0.001,0.01,0.964,1.0,4176,4128
20,8404,10,100,0.001,0.01,0.972,0.9994050452165636,4231,4173
20,8504,10,100,0.001,0.01,0.964,0.9967074317968015,4280,4224
20,8604,10,100,0.001,0.01,0.966,0.99767549976755,4332,4272
20,8704,10,100,0.001,0.01,0.962,0.9974724264705882,4372,4332
20,8804,10,100,0.001,0.01,0.964,0.9928441617446615,4431,4373
20,8904,10,100,0.001,0.01,0.974,0.9978661275831087,4485,4419
20,9004,10,100,0.001,0.01,0.966,0.998778320746335,4532,4472
20,9104,10,100,0.001,0.01,0.956,0.9818760984182777,4579,4525
20,9204,10,100,0.001,0.01,0.962,0.9910908300738809,4625,4579
20,9304,10,100,0.001,0.01,0.976,0.9986027515047291,4671,4633
20,9404,10,100,0.001,0.01,0.978,0.9991492981709911,4718,4686
20,9504,10,100,0.001,0.01,0.976,0.9987373737373737,4762,4742
20,9604,10,100,0.001,0.01,0.982,0.9983340274885465,4809,4795
20,9704,10,100,0.001,0.01,0.974,0.9997938994229184,4859,4845
20,9804,10,100,0.001,0.01,0.976,0.9995920032639739,4910,4894
20,9904,10,100,0.001,0.01,0.978,0.9986873990306947,4963,4941
20,10004,10,100,0.001,0.01,0.978,0.9996001599360256,5006,4998
20,10104,10,100,0.001,0.01,0.976,1.0,5049,5055
20,10204,10,100,0.001,0.01,0.978,0.9991179929439435,5096,5108
20,10304,10,100,0.001,0.01,0.976,0.9988354037267081,5150,5154
20,10404,10,100,0.001,0.01,0.978,0.9999038831218762,5192,5212
20,10504,10,100,0.001,0.01,0.98,0.9992383853769993,5238,5266
20,10604,10,100,0.001,0.01,0.978,0.995850622406639,5291,5313
20,10704,10,100,0.001,0.01,0.974,0.9957959641255605,5339,5365
20,10804,10,100,0.001,0.01,0.98,0.9944465012958164,5384,5420
20,10904,10,100,0.001,0.01,0.97,0.9952311078503302,5427,5477
20,11004,10,100,0.001,0.01,0.982,0.9978189749182116,5484,5520
20,11104,10,100,0.001,0.01,0.978,0.9966678674351584,5536,5568
20,11204,10,100,0.001,0.01,0.978,0.9950017850767583,5586,5618
20,11304,10,100,0.001,0.01,0.984,0.9964614295824487,5630,5674
20,11404,10,100,0.001,0.01,0.982,0.9991231146965976,5674,5730
20,11504,10,100,0.001,0.01,0.98,0.9984353268428373,5728,5776
20,11604,10,100,0.001,0.01,0.982,0.9993967597380213,5782,5822
20,11704,10,100,0.001,0.01,0.982,0.9996582365003418,5836,5868
20,11804,10,100,0.001,0.01,0.986,1.0,5888,5916
20,11904,10,100,0.001,0.01,0.982,0.9997479838709677,5934,5970
20,12004,10,100,0.001,0.01,0.986,0.9999166944351883,5983,6021
20,12104,10,100,0.001,0.01,0.984,1.0,6036,6068
20,12204,10,100,0.001,0.01,0.986,1.0,6079,6125
20,12304,10,100,0.001,0.01,0.986,1.0,6126,6178
20,12404,10,100,0.001,0.01,0.986,1.0,6181,6223
20,12504,10,100,0.001,0.01,0.986,1.0,6228,6276
20,12604,10,100,0.001,0.01,0.986,1.0,6269,6335
20,12704,10,100,0.001,0.01,0.986,1.0,6327,6377
20,12804,10,100,0.001,0.01,0.988,0.9987503905029679,6386,6418
20,12904,10,100,0.001,0.01,0.99,1.0,6427,6477
20,13004,10,100,0.001,0.01,0.988,1.0,6485,6519
20,13104,10,100,0.001,0.01,0.988,1.0,6536,6568
20,13204,10,100,0.001,0.01,0.984,0.9992426537412905,6578,6626
20,13304,10,100,0.001,0.01,0.98,0.991882140709561,6617,6687
20,13404,10,100,0.001,0.01,0.976,0.9863473589973142,6673,6731
20,13504,10,100,0.001,0.01,0.98,0.996297393364929,6718,6786
20,13604,10,100,0.001,0.01,0.99,0.9974272272860923,6768,6836
20,13704,10,100,0.001,0.01,0.992,0.9995621716287215,6824,6880
20,13804,10,100,0.001,0.01,0.988,0.9986960301361925,6876,6928
20,13904,10,100,0.001,0.01,0.99,0.9993527042577676,6929,6975
20,14004,10,100,0.001,0.01,0.99,0.9999285918309054,6980,7024
20,14104,10,100,0.001,0.01,0.988,1.0,7026,7078
20,14204,10,100,0.001,0.01,0.988,1.0,7070,7134
20,14304,10,100,0.001,0.01,0.992,1.0,7119,7185
20,14404,10,100,0.001,0.01,0.986,0.9995834490419327,7170,7234
20,14504,10,100,0.001,0.01,0.996,0.9997931605074463,7224,7280
20,14604,10,100,0.001,0.01,0.996,0.9986989865790195,7279,7325
20,14704,10,100,0.001,0.01,0.986,0.9976196953210011,7333,7371
20,14804,10,100,0.001,0.01,0.994,0.9959470413401783,7385,7419
20,14904,10,100,0.001,0.01,0.992,0.9985909822866345,7429,7475
20,15004,10,100,0.001,0.01,0.992,0.9994001599573447,7484,7520
