trial,train_size,embed_dim,hidden_dim,alpha,learning_rate,accuracy,train_accuracy,batch_pos,batch_neg
1,104,10,100,1e-05,0.01,0.536,0.7115384615384616,62,42
1,204,10,100,1e-05,0.01,0.518,0.7058823529411765,120,84
1,304,10,100,1e-05,0.01,0.512,0.6447368421052632,175,129
1,404,10,100,1e-05,0.01,0.514,0.7004950495049505,233,171
1,504,10,100,1e-05,0.01,0.52,0.6587301587301587,284,220
1,604,10,100,1e-05,0.01,0.488,0.652317880794702,333,271
1,704,10,100,1e-05,0.01,0.478,0.6974431818181818,383,321
1,804,10,100,1e-05,0.01,0.522,0.6902985074626866,426,378
1,904,10,100,1e-05,0.01,0.536,0.7035398230088495,475,429
1,1004,10,100,1e-05,0.01,0.54,0.6942231075697212,520,484
1,1104,10,100,1e-05,0.01,0.51,0.6648550724637681,567,537
1,1204,10,100,1e-05,0.01,0.502,0.7084717607973422,610,594
1,1304,10,100,1e-05,0.01,0.508,0.6993865030674846,666,638
1,1404,10,100,1e-05,0.01,0.524,0.7250712250712251,714,690
1,1504,10,100,1e-05,0.01,0.472,0.6788563829787234,769,735
1,1604,10,100,1e-05,0.01,0.506,0.720074812967581,811,793
1,1704,10,100,1e-05,0.01,0.494,0.7294600938967136,860,844
1,1804,10,100,1e-05,0.01,0.52,0.7682926829268293,910,894
1,1904,10,100,1e-05,0.01,0.544,0.7883403361344538,955,949
1,2004,10,100,1e-05,0.01,0.57,0.7949101796407185,1007,997
1,2104,10,100,1e-05,0.01,0.562,0.7604562737642585,1056,1048
1,2204,10,100,1e-05,0.01,0.59,0.7849364791288567,1104,1100
1,2304,10,100,1e-05,0.01,0.61,0.8585069444444444,1152,1152
1,2404,10,100,1e-05,0.01,0.58,0.7961730449251248,1202,1202
1,2504,10,100,1e-05,0.01,0.64,0.8430511182108626,1245,1259
1,2604,10,100,1e-05,0.01,0.656,0.8655913978494624,1292,1312
1,2704,10,100,1e-05,0.01,0.684,0.8579881656804734,1347,1357
1,2804,10,100,1e-05,0.01,0.698,0.8641226818830242,1403,1401
1,2904,10,100,1e-05,0.01,0.72,0.8966942148760331,1457,1447
1,3004,10,100,1e-05,0.01,0.73,0.9184420772303595,1508,1496
1,3104,10,100,1e-05,0.01,0.744,0.9085051546391752,1566,1538
1,3204,10,100,1e-05,0.01,0.746,0.9447565543071161,1620,1584
1,3304,10,100,1e-05,0.01,0.764,0.9530871670702179,1666,1638
1,3404,10,100,1e-05,0.01,0.74,0.9086368977673326,1724,1680
1,3504,10,100,1e-05,0.01,0.716,0.8433219178082192,1780,1724
1,3604,10,100,1e-05,0.01,0.758,0.8842952275249722,1826,1778
1,3704,10,100,1e-05,0.01,0.804,0.9117170626349892,1866,1838
1,3804,10,100,1e-05,0.01,0.786,0.9292849631966351,1909,1895
1,3904,10,100,1e-05,0.01,0.822,0.9533811475409836,1951,1953
1,4004,10,100,1e-05,0.01,0.818,0.9517982017982018,1996,2008
1,4104,10,100,1e-05,0.01,0.844,0.9551656920077972,2051,2053
1,4204,10,100,1e-05,0.01,0.852,0.9643196955280685,2105,2099
1,4304,10,100,1e-05,0.01,0.868,0.9767657992565055,2144,2160
1,4404,10,100,1e-05,0.01,0.866,0.9775204359673024,2184,2220
1,4504,10,100,1e-05,0.01,0.874,0.9757992895204263,2235,2269
1,4604,10,100,1e-05,0.01,0.874,0.9767593397046047,2292,2312
1,4704,10,100,1e-05,0.01,0.852,0.9844812925170068,2342,2362
1,4804,10,100,1e-05,0.01,0.856,0.9764779350541216,2396,2408
1,4904,10,100,1e-05,0.01,0.866,0.9818515497553018,2438,2466
1,5004,10,100,1e-05,0.01,0.844,0.9596322941646682,2500,2504
1,5104,10,100,1e-05,0.01,0.868,0.9706112852664577,2557,2547
1,5204,10,100,1e-05,0.01,0.872,0.9692544196771714,2613,2591
1,5304,10,100,1e-05,0.01,0.896,0.985105580693816,2660,2644
1,5404,10,100,1e-05,0.01,0.9,0.9729829755736491,2703,2701
1,5504,10,100,1e-05,0.01,0.902,0.9798328488372093,2744,2760
1,5604,10,100,1e-05,0.01,0.874,0.9486081370449678,2794,2810
1,5704,10,100,1e-05,0.01,0.866,0.9197054698457223,2845,2859
1,5804,10,100,1e-05,0.01,0.902,0.9681254307374225,2893,2911
1,5904,10,100,1e-05,0.01,0.916,0.9817073170731707,2943,2961
1,6004,10,100,1e-05,0.01,0.924,0.9848434377081945,2988,3016
1,6104,10,100,1e-05,0.01,0.93,0.984600262123198,3024,3080
1,6204,10,100,1e-05,0.01,0.92,0.9819471308833011,3072,3132
1,6304,10,100,1e-05,0.01,0.95,0.9949238578680203,3116,3188
1,6404,10,100,1e-05,0.01,0.95,0.9925046845721424,3164,3240
1,6504,10,100,1e-05,0.01,0.952,0.9904674046740467,3222,3282
1,6604,10,100,1e-05,0.01,0.942,0.9940944881889764,3269,3335
1,6704,10,100,1e-05,0.01,0.942,0.988961813842482,3318,3386
1,6804,10,100,1e-05,0.01,0.946,0.9930922986478542,3367,3437
1,6904,10,100,1e-05,0.01,0.952,0.9957995365005794,3418,3486
1,7004,10,100,1e-05,0.01,0.948,0.9951456310679612,3471,3533
1,7104,10,100,1e-05,0.01,0.948,0.9959177927927928,3524,3580
1,7204,10,100,1e-05,0.01,0.946,0.993753470294281,3569,3635
1,7304,10,100,1e-05,0.01,0.946,0.9964403066812705,3621,3683
1,7404,10,100,1e-05,0.01,0.944,0.9933819556996218,3665,3739
1,7504,10,100,1e-05,0.01,0.946,0.9930703624733476,3721,3783
1,7604,10,100,1e-05,0.01,0.948,0.9850078905839033,3768,3836
1,7704,10,100,1e-05,0.01,0.91,0.9685877466251298,3818,3886
1,7804,10,100,1e-05,0.01,0.938,0.9852639671963096,3871,3933
1,7904,10,100,1e-05,0.01,0.952,0.9944331983805668,3916,3988
1,8004,10,100,1e-05,0.01,0.952,0.9963768115942029,3972,4032
1,8104,10,100,1e-05,0.01,0.954,0.9960513326752222,4024,4080
1,8204,10,100,1e-05,0.01,0.91,0.962579229644076,4074,4130
1,8304,10,100,1e-05,0.01,0.91,0.9375,4125,4179
1,8404,10,100,1e-05,0.01,0.948,0.9740599714421704,4178,4226
1,8504,10,100,1e-05,0.01,0.952,0.9881232361241769,4233,4271
1,8604,10,100,1e-05,0.01,0.962,0.9933751743375174,4283,4321
1,8704,10,100,1e-05,0.01,0.958,0.9935661764705882,4333,4371
1,8804,10,100,1e-05,0.01,0.96,0.9960245343025897,4383,4421
1,8904,10,100,1e-05,0.01,0.97,0.9946091644204852,4430,4474
1,9004,10,100,1e-05,0.01,0.966,0.9950022212350067,4481,4523
1,9104,10,100,1e-05,0.01,0.97,0.9985720562390158,4531,4573
1,9204,10,100,1e-05,0.01,0.966,0.9967405475880052,4586,4618
1,9304,10,100,1e-05,0.01,0.964,0.9975279449699054,4638,4666
1,9404,10,100,1e-05,0.01,0.97,0.9989366227137388,4681,4723
1,9504,10,100,1e-05,0.01,0.972,0.9971590909090909,4740,4764
1,9604,10,100,1e-05,0.01,0.97,0.9961474385672636,4790,4814
1,9704,10,100,1e-05,0.01,0.964,0.9869126133553174,4836,4868
1,9804,10,100,1e-05,0.01,0.966,0.9942880456956344,4890,4914
1,9904,10,100,1e-05,0.01,0.972,0.9978796445880452,4940,4964
1,10004,10,100,1e-05,0.01,0.968,0.9981007596961216,4991,5013
1,10104,10,100,1e-05,0.01,0.974,0.9989113222486145,5044,5060
1,10204,10,100,1e-05,0.01,0.964,0.9966679733437868,5094,5110
1,10304,10,100,1e-05,0.01,0.976,0.9987383540372671,5153,5151
1,10404,10,100,1e-05,0.01,0.97,0.9918300653594772,5197,5207
1,10504,10,100,1e-05,0.01,0.932,0.9448781416603199,5244,5260
1,10604,10,100,1e-05,0.01,0.94,0.9659562429271973,5297,5307
1,10704,10,100,1e-05,0.01,0.968,0.9860799701046338,5348,5356
1,10804,10,100,1e-05,0.01,0.98,0.9947241762310255,5398,5406
1,10904,10,100,1e-05,0.01,0.972,0.9946808510638298,5451,5453
1,11004,10,100,1e-05,0.01,0.97,0.9980007270083606,5508,5496
1,11104,10,100,1e-05,0.01,0.974,0.9994596541786743,5545,5559
1,11204,10,100,1e-05,0.01,0.976,0.9994644769725098,5587,5617
1,11304,10,100,1e-05,0.01,0.968,0.9951344656758669,5645,5659
1,11404,10,100,1e-05,0.01,0.974,0.9983339179235357,5695,5709
1,11504,10,100,1e-05,0.01,0.972,0.9993045897079277,5746,5758
1,11604,10,100,1e-05,0.01,0.904,0.9341606342640468,5799,5805
1,11704,10,100,1e-05,0.01,0.94,0.9383971291866029,5856,5848
1,11804,10,100,1e-05,0.01,0.958,0.977549983056591,5904,5900
1,11904,10,100,1e-05,0.01,0.966,0.982442876344086,5962,5942
1,12004,10,100,1e-05,0.01,0.97,0.9891702765744752,6006,5998
1,12104,10,100,1e-05,0.01,0.968,0.9847157964309319,6060,6044
1,12204,10,100,1e-05,0.01,0.972,0.9914782038675845,6103,6101
1,12304,10,100,1e-05,0.01,0.976,0.9958550065019506,6142,6162
1,12404,10,100,1e-05,0.01,0.978,0.9954047081586584,6187,6217
1,12504,10,100,1e-05,0.01,0.976,0.9912028150991683,6244,6260
1,12604,10,100,1e-05,0.01,0.978,0.9984925420501428,6288,6316
1,12704,10,100,1e-05,0.01,0.982,0.9988192695214105,6332,6372
1,12804,10,100,1e-05,0.01,0.978,0.9982817869415808,6379,6425
1,12904,10,100,1e-05,0.01,0.968,0.9933353998760074,6437,6467
1,13004,10,100,1e-05,0.01,0.98,0.9933097508458936,6494,6510
1,13104,10,100,1e-05,0.01,0.976,0.9948870573870574,6548,6556
1,13204,10,100,1e-05,0.01,0.978,0.9903059678885187,6601,6603
1,13304,10,100,1e-05,0.01,0.976,0.9934606133493686,6647,6657
1,13404,10,100,1e-05,0.01,0.982,0.997538048343778,6688,6716
1,13504,10,100,1e-05,0.01,0.976,0.9960752369668247,6731,6773
1,13604,10,100,1e-05,0.01,0.98,0.9991179064980888,6786,6818
1,13704,10,100,1e-05,0.01,0.978,0.9983946293053123,6837,6867
1,13804,10,100,1e-05,0.01,0.984,0.9983338162851347,6885,6919
1,13904,10,100,1e-05,0.01,0.984,0.9969073647871116,6929,6975
1,14004,10,100,1e-05,0.01,0.984,0.9947157954870037,6979,7025
1,14104,10,100,1e-05,0.01,0.968,0.9817073170731707,7025,7079
1,14204,10,100,1e-05,0.01,0.97,0.9929597296536187,7068,7136
1,14304,10,100,1e-05,0.01,0.978,0.9965044742729307,7127,7177
1,14404,10,100,1e-05,0.01,0.976,0.9988891974451541,7182,7222
1,14504,10,100,1e-05,0.01,0.98,0.997173193601765,7236,7268
1,14604,10,100,1e-05,0.01,0.982,0.9979457682826622,7290,7314
1,14704,10,100,1e-05,0.01,0.982,0.9989798694232862,7330,7374
1,14804,10,100,1e-05,0.01,0.988,0.9987165630910565,7382,7422
1,14904,10,100,1e-05,0.01,0.984,0.9971819645732689,7428,7476
1,15004,10,100,1e-05,0.01,0.978,0.9957344708077845,7487,7517
2,104,10,100,1e-05,0.01,0.512,0.5288461538461539,55,49
2,204,10,100,1e-05,0.01,0.508,0.5833333333333334,98,106
2,304,10,100,1e-05,0.01,0.5,0.569078947368421,151,153
2,404,10,100,1e-05,0.01,0.516,0.6039603960396039,197,207
2,504,10,100,1e-05,0.01,0.51,0.5813492063492064,251,253
2,604,10,100,1e-05,0.01,0.494,0.6639072847682119,293,311
2,704,10,100,1e-05,0.01,0.476,0.6221590909090909,341,363
2,804,10,100,1e-05,0.01,0.502,0.6703980099502488,392,412
2,904,10,100,1e-05,0.01,0.508,0.6626106194690266,449,455
2,1004,10,100,1e-05,0.01,0.52,0.6802788844621513,503,501
2,1104,10,100,1e-05,0.01,0.504,0.6902173913043478,547,557
2,1204,10,100,1e-05,0.01,0.506,0.7059800664451827,589,615
2,1304,10,100,1e-05,0.01,0.49,0.6802147239263804,633,671
2,1404,10,100,1e-05,0.01,0.504,0.6901709401709402,687,717
2,1504,10,100,1e-05,0.01,0.522,0.7101063829787234,746,758
2,1604,10,100,1e-05,0.01,0.48,0.7506234413965087,804,800
2,1704,10,100,1e-05,0.01,0.518,0.7147887323943662,855,849
2,1804,10,100,1e-05,0.01,0.496,0.7494456762749445,907,897
2,1904,10,100,1e-05,0.01,0.51,0.7337184873949579,958,946
2,2004,10,100,1e-05,0.01,0.522,0.7634730538922155,1021,983
2,2104,10,100,1e-05,0.01,0.526,0.7913498098859315,1072,1032
2,2204,10,100,1e-05,0.01,0.54,0.8461887477313974,1121,1083
2,2304,10,100,1e-05,0.01,0.526,0.8285590277777778,1165,1139
2,2404,10,100,1e-05,0.01,0.544,0.8298668885191348,1209,1195
2,2504,10,100,1e-05,0.01,0.586,0.854632587859425,1257,1247
2,2604,10,100,1e-05,0.01,0.598,0.8894009216589862,1310,1294
2,2704,10,100,1e-05,0.01,0.632,0.8524408284023669,1368,1336
2,2804,10,100,1e-05,0.01,0.656,0.9104850213980028,1412,1392
2,2904,10,100,1e-05,0.01,0.692,0.9356060606060606,1469,1435
2,3004,10,100,1e-05,0.01,0.732,0.9454061251664447,1520,1484
2,3104,10,100,1e-05,0.01,0.726,0.9616623711340206,1569,1535
2,3204,10,100,1e-05,0.01,0.76,0.9653558052434457,1617,1587
2,3304,10,100,1e-05,0.01,0.768,0.9588377723970944,1673,1631
2,3404,10,100,1e-05,0.01,0.768,0.954171562867215,1729,1675
2,3504,10,100,1e-05,0.01,0.766,0.922945205479452,1775,1729
2,3604,10,100,1e-05,0.01,0.766,0.9445061043285239,1821,1783
2,3704,10,100,1e-05,0.01,0.808,0.9454643628509719,1869,1835
2,3804,10,100,1e-05,0.01,0.794,0.9660883280757098,1923,1881
2,3904,10,100,1e-05,0.01,0.812,0.9882172131147541,1972,1932
2,4004,10,100,1e-05,0.01,0.81,0.9835164835164835,2015,1989
2,4104,10,100,1e-05,0.01,0.838,0.9873294346978557,2067,2037
2,4204,10,100,1e-05,0.01,0.848,0.9847764034253093,2110,2094
2,4304,10,100,1e-05,0.01,0.86,0.9941914498141264,2159,2145
2,4404,10,100,1e-05,0.01,0.852,0.9934150772025432,2210,2194
2,4504,10,100,1e-05,0.01,0.862,0.9935612788632326,2262,2242
2,4604,10,100,1e-05,0.01,0.872,0.9950043440486533,2305,2299
2,4704,10,100,1e-05,0.01,0.888,0.9921343537414966,2347,2357
2,4804,10,100,1e-05,0.01,0.882,0.984804329725229,2402,2402
2,4904,10,100,1e-05,0.01,0.832,0.9463703099510603,2455,2449
2,5004,10,100,1e-05,0.01,0.848,0.9586330935251799,2501,2503
2,5104,10,100,1e-05,0.01,0.888,0.9870689655172413,2552,2552
2,5204,10,100,1e-05,0.01,0.88,0.9759800153727901,2603,2601
2,5304,10,100,1e-05,0.01,0.89,0.9556938159879337,2649,2655
2,5404,10,100,1e-05,0.01,0.908,0.9857512953367875,2708,2696
2,5504,10,100,1e-05,0.01,0.938,0.9923691860465116,2764,2740
2,5604,10,100,1e-05,0.01,0.94,0.9905424696645253,2819,2785
2,5704,10,100,1e-05,0.01,0.94,0.9936886395511921,2872,2832
2,5804,10,100,1e-05,0.01,0.946,0.9941419710544452,2920,2884
2,5904,10,100,1e-05,0.01,0.936,0.9977981029810298,2968,2936
2,6004,10,100,1e-05,0.01,0.934,0.9983344437041972,3026,2978
2,6104,10,100,1e-05,0.01,0.92,0.9755897771952818,3072,3032
2,6204,10,100,1e-05,0.01,0.928,0.9962927143778207,3125,3079
2,6304,10,100,1e-05,0.01,0.958,0.9973032994923858,3170,3134
2,6404,10,100,1e-05,0.01,0.966,0.9979700187382886,3219,3185
2,6504,10,100,1e-05,0.01,0.958,0.9981549815498155,3273,3231
2,6604,10,100,1e-05,0.01,0.964,0.9987886129618413,3325,3279
2,6704,10,100,1e-05,0.01,0.974,0.9995525059665871,3367,3337
2,6804,10,100,1e-05,0.01,0.972,0.9997060552616108,3418,3386
2,6904,10,100,1e-05,0.01,0.974,0.9998551564310545,3474,3430
2,7004,10,100,1e-05,0.01,0.972,1.0,3513,3491
2,7104,10,100,1e-05,0.01,0.976,0.9998592342342343,3561,3543
2,7204,10,100,1e-05,0.01,0.962,0.9952803997779012,3618,3586
2,7304,10,100,1e-05,0.01,0.974,0.9997261774370209,3677,3627
2,7404,10,100,1e-05,0.01,0.968,0.9994597514856834,3722,3682
2,7504,10,100,1e-05,0.01,0.97,0.998001066098081,3773,3731
2,7604,10,100,1e-05,0.01,0.972,0.9938190426091531,3824,3780
2,7704,10,100,1e-05,0.01,0.956,0.9936396677050883,3867,3837
2,7804,10,100,1e-05,0.01,0.962,0.9897488467452589,3917,3887
2,7904,10,100,1e-05,0.01,0.978,0.9973431174089069,3967,3937
2,8004,10,100,1e-05,0.01,0.97,0.9951274362818591,4019,3985
2,8104,10,100,1e-05,0.01,0.984,0.9981490621915103,4068,4036
2,8204,10,100,1e-05,0.01,0.98,0.999512432959532,4117,4087
2,8304,10,100,1e-05,0.01,0.972,0.9933766859344894,4158,4146
2,8404,10,100,1e-05,0.01,0.98,0.9957163255592575,4213,4191
2,8504,10,100,1e-05,0.01,0.974,0.9962370649106302,4269,4235
2,8604,10,100,1e-05,0.01,0.98,0.99860529986053,4334,4270
2,8704,10,100,1e-05,0.01,0.98,0.9993106617647058,4382,4322
2,8804,10,100,1e-05,0.01,0.982,0.9977283053157655,4431,4373
2,8904,10,100,1e-05,0.01,0.986,0.9997753818508536,4484,4420
2,9004,10,100,1e-05,0.01,0.992,0.9998889382496668,4537,4467
2,9104,10,100,1e-05,0.01,0.986,0.99945079086116,4576,4528
2,9204,10,100,1e-05,0.01,0.99,1.0,4622,4582
2,9304,10,100,1e-05,0.01,0.99,0.9986027515047291,4672,4632
2,9404,10,100,1e-05,0.01,0.988,0.9995746490854955,4726,4678
2,9504,10,100,1e-05,0.01,0.984,0.9997895622895623,4773,4731
2,9604,10,100,1e-05,0.01,0.99,0.9969804248229904,4823,4781
2,9704,10,100,1e-05,0.01,0.988,0.9976298433635614,4875,4829
2,9804,10,100,1e-05,0.01,0.98,0.9959200326397388,4924,4880
2,9904,10,100,1e-05,0.01,0.982,0.995456381260097,4977,4927
2,10004,10,100,1e-05,0.01,0.966,0.9845061975209916,5026,4978
2,10104,10,100,1e-05,0.01,0.99,0.9970308788598575,5071,5033
2,10204,10,100,1e-05,0.01,0.988,0.9992159937279498,5122,5082
2,10304,10,100,1e-05,0.01,0.992,0.999514751552795,5176,5128
2,10404,10,100,1e-05,0.01,0.986,0.9997116493656286,5221,5183
2,10504,10,100,1e-05,0.01,0.99,0.9998095963442498,5272,5232
2,10604,10,100,1e-05,0.01,0.988,0.998491135420596,5308,5296
2,10704,10,100,1e-05,0.01,0.99,0.999439461883408,5358,5346
2,10804,10,100,1e-05,0.01,0.992,0.9999074416882636,5413,5391
2,10904,10,100,1e-05,0.01,0.992,1.0,5460,5444
2,11004,10,100,1e-05,0.01,0.994,0.999818247909851,5502,5502
2,11104,10,100,1e-05,0.01,0.986,0.9977485590778098,5559,5545
2,11204,10,100,1e-05,0.01,0.982,0.9964298464833988,5610,5594
2,11304,10,100,1e-05,0.01,0.978,0.9939844302901628,5665,5639
2,11404,10,100,1e-05,0.01,0.99,0.9950894423009471,5713,5691
2,11504,10,100,1e-05,0.01,0.984,0.9939151599443672,5763,5741
2,11604,10,100,1e-05,0.01,0.982,0.9960358497069975,5822,5782
2,11704,10,100,1e-05,0.01,0.988,0.9981203007518797,5872,5832
2,11804,10,100,1e-05,0.01,0.99,0.9983903761436801,5919,5885
2,11904,10,100,1e-05,0.01,0.994,0.9963877688172043,5970,5934
2,12004,10,100,1e-05,0.01,0.99,0.9995834721759413,6013,5991
2,12104,10,100,1e-05,0.01,0.99,0.997769332452082,6069,6035
2,12204,10,100,1e-05,0.01,0.99,0.9996722386102918,6114,6090
2,12304,10,100,1e-05,0.01,0.99,0.9996749024707412,6170,6134
2,12404,10,100,1e-05,0.01,0.99,0.9987100935182199,6212,6192
2,12504,10,100,1e-05,0.01,0.992,0.9999200255918106,6263,6241
2,12604,10,100,1e-05,0.01,0.99,0.9996033005395113,6308,6296
2,12704,10,100,1e-05,0.01,0.99,0.9995277078085643,6351,6353
2,12804,10,100,1e-05,0.01,0.992,0.9992970946579194,6405,6399
2,12904,10,100,1e-05,0.01,0.99,0.9987600743955363,6461,6443
2,13004,10,100,1e-05,0.01,0.982,0.9960781298062135,6510,6494
2,13104,10,100,1e-05,0.01,0.988,0.9990079365079365,6545,6559
2,13204,10,100,1e-05,0.01,0.988,0.9976522265980006,6599,6605
2,13304,10,100,1e-05,0.01,0.988,0.9992483463619964,6651,6653
2,13404,10,100,1e-05,0.01,0.984,0.9947776783049835,6705,6699
2,13504,10,100,1e-05,0.01,0.99,0.9964454976303317,6754,6750
2,13604,10,100,1e-05,0.01,0.988,0.9974272272860923,6812,6792
2,13704,10,100,1e-05,0.01,0.99,0.9974460011675423,6858,6846
2,13804,10,100,1e-05,0.01,0.992,0.9982613735149232,6909,6895
2,13904,10,100,1e-05,0.01,0.992,0.9984177215189873,6956,6948
2,14004,10,100,1e-05,0.01,0.994,0.9987146529562982,7008,6996
2,14104,10,100,1e-05,0.01,0.984,0.9987237663074305,7053,7051
2,14204,10,100,1e-05,0.01,0.99,0.9983807378203323,7101,7103
2,14304,10,100,1e-05,0.01,0.994,0.9986717002237137,7146,7158
2,14404,10,100,1e-05,0.01,0.986,0.9961816162177173,7188,7216
2,14504,10,100,1e-05,0.01,0.984,0.9975179260893546,7234,7270
2,14604,10,100,1e-05,0.01,0.992,0.9993837304847987,7282,7322
2,14704,10,100,1e-05,0.01,0.99,0.9991158868335147,7324,7380
2,14804,10,100,1e-05,0.01,0.994,1.0,7379,7425
2,14904,10,100,1e-05,0.01,0.99,1.0,7445,7459
2,15004,10,100,1e-05,0.01,0.99,1.0,7496,7508
3,104,10,100,1e-05,0.01,0.502,0.5096153846153846,51,53
3,204,10,100,1e-05,0.01,0.512,0.6568627450980392,103,101
3,304,10,100,1e-05,0.01,0.524,0.6513157894736842,153,151
3,404,10,100,1e-05,0.01,0.498,0.6410891089108911,208,196
3,504,10,100,1e-05,0.01,0.5,0.6448412698412699,255,249
3,604,10,100,1e-05,0.01,0.516,0.6307947019867549,307,297
3,704,10,100,1e-05,0.01,0.512,0.640625,357,347
3,804,10,100,1e-05,0.01,0.518,0.654228855721393,405,399
3,904,10,100,1e-05,0.01,0.494,0.665929203539823,449,455
3,1004,10,100,1e-05,0.01,0.508,0.6962151394422311,506,498
3,1104,10,100,1e-05,0.01,0.518,0.6875,553,551
3,1204,10,100,1e-05,0.01,0.496,0.7200996677740864,609,595
3,1304,10,100,1e-05,0.01,0.496,0.6733128834355828,663,641
3,1404,10,100,1e-05,0.01,0.496,0.6866096866096866,717,687
3,1504,10,100,1e-05,0.01,0.502,0.6974734042553191,768,736
3,1604,10,100,1e-05,0.01,0.478,0.7406483790523691,818,786
3,1704,10,100,1e-05,0.01,0.518,0.727112676056338,867,837
3,1804,10,100,1e-05,0.01,0.508,0.7378048780487805,913,891
3,1904,10,100,1e-05,0.01,0.49,0.7111344537815126,972,932
3,2004,10,100,1e-05,0.01,0.514,0.7719560878243513,1017,987
3,2104,10,100,1e-05,0.01,0.502,0.7671102661596958,1058,1046
3,2204,10,100,1e-05,0.01,0.508,0.7976406533575318,1103,1101
3,2304,10,100,1e-05,0.01,0.518,0.7760416666666666,1152,1152
3,2404,10,100,1e-05,0.01,0.54,0.7707986688851913,1196,1208
3,2504,10,100,1e-05,0.01,0.508,0.7967252396166135,1241,1263
3,2604,10,100,1e-05,0.01,0.522,0.803763440860215,1292,1312
3,2704,10,100,1e-05,0.01,0.514,0.7984467455621301,1347,1357
3,2804,10,100,1e-05,0.01,0.55,0.8277460770328102,1400,1404
3,2904,10,100,1e-05,0.01,0.546,0.8164600550964187,1457,1447
3,3004,10,100,1e-05,0.01,0.522,0.8328894806924101,1504,1500
3,3104,10,100,1e-05,0.01,0.506,0.8469716494845361,1559,1545
3,3204,10,100,1e-05,0.01,0.548,0.8589263420724095,1604,1600
3,3304,10,100,1e-05,0.01,0.566,0.8398910411622276,1657,1647
3,3404,10,100,1e-05,0.01,0.556,0.8592831962397179,1709,1695
3,3504,10,100,1e-05,0.01,0.57,0.8684360730593608,1767,1737
3,3604,10,100,1e-05,0.01,0.572,0.8693118756936737,1828,1776
3,3704,10,100,1e-05,0.01,0.588,0.8839092872570194,1880,1824
3,3804,10,100,1e-05,0.01,0.59,0.8945846477392219,1937,1867
3,3904,10,100,1e-05,0.01,0.606,0.8931864754098361,1992,1912
3,4004,10,100,1e-05,0.01,0.596,0.8946053946053946,2035,1969
3,4104,10,100,1e-05,0.01,0.588,0.878167641325536,2090,2014
3,4204,10,100,1e-05,0.01,0.622,0.8648905803996194,2145,2059
3,4304,10,100,1e-05,0.01,0.646,0.8471189591078067,2180,2124
3,4404,10,100,1e-05,0.01,0.664,0.8739782016348774,2229,2175
3,4504,10,100,1e-05,0.01,0.64,0.8987566607460036,2279,2225
3,4604,10,100,1e-05,0.01,0.648,0.9176802780191138,2330,2274
3,4704,10,100,1e-05,0.01,0.668,0.9207057823129252,2379,2325
3,4804,10,100,1e-05,0.01,0.644,0.917360532889259,2432,2372
3,4904,10,100,1e-05,0.01,0.668,0.8988580750407831,2480,2424
3,5004,10,100,1e-05,0.01,0.662,0.9234612310151878,2531,2473
3,5104,10,100,1e-05,0.01,0.658,0.942398119122257,2581,2523
3,5204,10,100,1e-05,0.01,0.72,0.9327440430438124,2633,2571
3,5304,10,100,1e-05,0.01,0.65,0.9004524886877828,2680,2624
3,5404,10,100,1e-05,0.01,0.678,0.9141376757957069,2731,2673
3,5504,10,100,1e-05,0.01,0.706,0.9109738372093024,2781,2723
3,5604,10,100,1e-05,0.01,0.708,0.9170235546038544,2832,2772
3,5704,10,100,1e-05,0.01,0.7,0.9360098176718092,2878,2826
3,5804,10,100,1e-05,0.01,0.692,0.9457270847691247,2930,2874
3,5904,10,100,1e-05,0.01,0.73,0.9471544715447154,2990,2914
3,6004,10,100,1e-05,0.01,0.738,0.9420386409060626,3038,2966
3,6104,10,100,1e-05,0.01,0.744,0.9497051114023591,3085,3019
3,6204,10,100,1e-05,0.01,0.698,0.9487427466150871,3131,3073
3,6304,10,100,1e-05,0.01,0.744,0.9555837563451777,3178,3126
3,6404,10,100,1e-05,0.01,0.738,0.9564334790755777,3221,3183
3,6504,10,100,1e-05,0.01,0.714,0.9334255842558425,3271,3233
3,6604,10,100,1e-05,0.01,0.766,0.9448818897637795,3325,3279
3,6704,10,100,1e-05,0.01,0.764,0.9607696897374701,3380,3324
3,6804,10,100,1e-05,0.01,0.764,0.9598765432098766,3427,3377
3,6904,10,100,1e-05,0.01,0.726,0.9358342989571263,3484,3420
3,7004,10,100,1e-05,0.01,0.752,0.9548829240434038,3535,3469
3,7104,10,100,1e-05,0.01,0.75,0.9556587837837838,3587,3517
3,7204,10,100,1e-05,0.01,0.748,0.9680732926152138,3626,3578
3,7304,10,100,1e-05,0.01,0.78,0.9593373493975904,3675,3629
3,7404,10,100,1e-05,0.01,0.764,0.9638033495407887,3741,3663
3,7504,10,100,1e-05,0.01,0.758,0.9497601279317697,3789,3715
3,7604,10,100,1e-05,0.01,0.762,0.9685691741188848,3841,3763
3,7704,10,100,1e-05,0.01,0.76,0.9589823468328141,3887,3817
3,7804,10,100,1e-05,0.01,0.768,0.9700153767298821,3931,3873
3,7904,10,100,1e-05,0.01,0.768,0.9768471659919028,3984,3920
3,8004,10,100,1e-05,0.01,0.782,0.973263368315842,4040,3964
3,8104,10,100,1e-05,0.01,0.784,0.9682872655478776,4091,4013
3,8204,10,100,1e-05,0.01,0.78,0.9657484154071185,4144,4060
3,8304,10,100,1e-05,0.01,0.764,0.9682080924855492,4202,4102
3,8404,10,100,1e-05,0.01,0.748,0.941694431223227,4251,4153
3,8504,10,100,1e-05,0.01,0.754,0.9139228598306679,4302,4202
3,8604,10,100,1e-05,0.01,0.786,0.9547884704788471,4347,4257
3,8704,10,100,1e-05,0.01,0.78,0.9630055147058824,4402,4302
3,8804,10,100,1e-05,0.01,0.798,0.9719445706497046,4454,4350
3,8904,10,100,1e-05,0.01,0.77,0.9563117699910153,4511,4393
3,9004,10,100,1e-05,0.01,0.768,0.9666814749000444,4556,4448
3,9104,10,100,1e-05,0.01,0.774,0.976603690685413,4605,4499
3,9204,10,100,1e-05,0.01,0.79,0.9833767926988266,4654,4550
3,9304,10,100,1e-05,0.01,0.808,0.9801160791057609,4701,4603
3,9404,10,100,1e-05,0.01,0.782,0.9791578051892812,4737,4667
3,9504,10,100,1e-05,0.01,0.792,0.9863215488215489,4786,4718
3,9604,10,100,1e-05,0.01,0.792,0.9765722615576843,4834,4770
3,9704,10,100,1e-05,0.01,0.806,0.9606347897774113,4885,4819
3,9804,10,100,1e-05,0.01,0.804,0.9736842105263158,4929,4875
3,9904,10,100,1e-05,0.01,0.814,0.971829563812601,4972,4932
3,10004,10,100,1e-05,0.01,0.806,0.975109956017593,5027,4977
3,10104,10,100,1e-05,0.01,0.806,0.9742676167854315,5067,5037
3,10204,10,100,1e-05,0.01,0.818,0.9818698549588397,5118,5086
3,10304,10,100,1e-05,0.01,0.816,0.9831133540372671,5165,5139
3,10404,10,100,1e-05,0.01,0.82,0.983756247597078,5218,5186
3,10504,10,100,1e-05,0.01,0.826,0.9812452399086062,5260,5244
3,10604,10,100,1e-05,0.01,0.832,0.9827423613730668,5316,5288
3,10704,10,100,1e-05,0.01,0.838,0.9878550074738416,5371,5333
3,10804,10,100,1e-05,0.01,0.822,0.9838022954461311,5426,5378
3,10904,10,100,1e-05,0.01,0.832,0.9877109317681585,5482,5422
3,11004,10,100,1e-05,0.01,0.824,0.972828062522719,5549,5455
3,11104,10,100,1e-05,0.01,0.81,0.9727125360230547,5608,5496
3,11204,10,100,1e-05,0.01,0.836,0.9721528025705105,5666,5538
3,11304,10,100,1e-05,0.01,0.832,0.9624026893135174,5717,5587
3,11404,10,100,1e-05,0.01,0.84,0.9667660470010523,5766,5638
3,11504,10,100,1e-05,0.01,0.84,0.9753129346314325,5823,5681
3,11604,10,100,1e-05,0.01,0.844,0.9878490175801448,5876,5728
3,11704,10,100,1e-05,0.01,0.852,0.9903451811346549,5918,5786
3,11804,10,100,1e-05,0.01,0.84,0.9690782785496442,5967,5837
3,11904,10,100,1e-05,0.01,0.81,0.9311995967741935,6021,5883
3,12004,10,100,1e-05,0.01,0.824,0.9643452182605798,6065,5939
3,12104,10,100,1e-05,0.01,0.856,0.9758757435558493,6107,5997
3,12204,10,100,1e-05,0.01,0.834,0.9824647656506064,6156,6048
3,12304,10,100,1e-05,0.01,0.854,0.9800877763328999,6204,6100
3,12404,10,100,1e-05,0.01,0.864,0.9817800709448565,6254,6150
3,12504,10,100,1e-05,0.01,0.87,0.989043506078055,6302,6202
3,12604,10,100,1e-05,0.01,0.856,0.9844493811488416,6348,6256
3,12704,10,100,1e-05,0.01,0.854,0.985831234256927,6401,6303
3,12804,10,100,1e-05,0.01,0.85,0.9846922836613559,6454,6350
3,12904,10,100,1e-05,0.01,0.85,0.9853533787972721,6494,6410
3,13004,10,100,1e-05,0.01,0.854,0.9895416794832359,6546,6458
3,13104,10,100,1e-05,0.01,0.86,0.9844322344322345,6590,6514
3,13204,10,100,1e-05,0.01,0.866,0.9831111784307786,6631,6573
3,13304,10,100,1e-05,0.01,0.856,0.9857937462417318,6677,6627
3,13404,10,100,1e-05,0.01,0.868,0.9864219635929573,6730,6674
3,13504,10,100,1e-05,0.01,0.866,0.9914099526066351,6780,6724
3,13604,10,100,1e-05,0.01,0.88,0.9892678623934137,6821,6783
3,13704,10,100,1e-05,0.01,0.868,0.9915353181552832,6868,6836
3,13804,10,100,1e-05,0.01,0.882,0.9833381628513475,6912,6892
3,13904,10,100,1e-05,0.01,0.868,0.9789988492520139,6961,6943
3,14004,10,100,1e-05,0.01,0.868,0.9845758354755784,7016,6988
3,14104,10,100,1e-05,0.01,0.858,0.983125354509359,7063,7041
3,14204,10,100,1e-05,0.01,0.862,0.986834694452267,7112,7092
3,14304,10,100,1e-05,0.01,0.876,0.993148769574944,7162,7142
3,14404,10,100,1e-05,0.01,0.884,0.9897945015273535,7213,7191
3,14504,10,100,1e-05,0.01,0.86,0.9823496966354109,7258,7246
3,14604,10,100,1e-05,0.01,0.874,0.9852095316351684,7295,7309
3,14704,10,100,1e-05,0.01,0.866,0.985854189336235,7354,7350
3,14804,10,100,1e-05,0.01,0.862,0.9754120507970818,7406,7398
3,14904,10,100,1e-05,0.01,0.884,0.9842324208266238,7454,7450
3,15004,10,100,1e-05,0.01,0.894,0.9924686750199947,7503,7501
4,104,10,100,1e-05,0.01,0.528,0.5480769230769231,45,59
4,204,10,100,1e-05,0.01,0.46,0.6470588235294118,86,118
4,304,10,100,1e-05,0.01,0.486,0.631578947368421,141,163
4,404,10,100,1e-05,0.01,0.52,0.551980198019802,193,211
4,504,10,100,1e-05,0.01,0.53,0.6111111111111112,242,262
4,604,10,100,1e-05,0.01,0.466,0.5927152317880795,290,314
4,704,10,100,1e-05,0.01,0.466,0.6193181818181818,348,356
4,804,10,100,1e-05,0.01,0.53,0.6417910447761194,408,396
4,904,10,100,1e-05,0.01,0.532,0.6338495575221239,462,442
4,1004,10,100,1e-05,0.01,0.516,0.6284860557768924,510,494
4,1104,10,100,1e-05,0.01,0.548,0.6485507246376812,561,543
4,1204,10,100,1e-05,0.01,0.512,0.6686046511627907,609,595
4,1304,10,100,1e-05,0.01,0.508,0.691717791411043,661,643
4,1404,10,100,1e-05,0.01,0.528,0.7158119658119658,712,692
4,1504,10,100,1e-05,0.01,0.522,0.7134308510638298,767,737
4,1604,10,100,1e-05,0.01,0.526,0.7437655860349127,810,794
4,1704,10,100,1e-05,0.01,0.522,0.7488262910798122,855,849
4,1804,10,100,1e-05,0.01,0.532,0.7954545454545454,898,906
4,1904,10,100,1e-05,0.01,0.542,0.8019957983193278,952,952
4,2004,10,100,1e-05,0.01,0.56,0.8088822355289421,1005,999
4,2104,10,100,1e-05,0.01,0.592,0.8288973384030418,1063,1041
4,2204,10,100,1e-05,0.01,0.598,0.8198729582577132,1113,1091
4,2304,10,100,1e-05,0.01,0.632,0.828125,1158,1146
4,2404,10,100,1e-05,0.01,0.568,0.7995008319467554,1213,1191
4,2504,10,100,1e-05,0.01,0.652,0.8366613418530351,1269,1235
4,2604,10,100,1e-05,0.01,0.638,0.8559907834101382,1321,1283
4,2704,10,100,1e-05,0.01,0.648,0.8620562130177515,1368,1336
4,2804,10,100,1e-05,0.01,0.684,0.9079885877318117,1417,1387
4,2904,10,100,1e-05,0.01,0.7,0.931129476584022,1462,1442
4,3004,10,100,1e-05,0.01,0.73,0.9487350199733688,1516,1488
4,3104,10,100,1e-05,0.01,0.762,0.9539304123711341,1568,1536
4,3204,10,100,1e-05,0.01,0.742,0.9569288389513109,1607,1597
4,3304,10,100,1e-05,0.01,0.754,0.9555084745762712,1659,1645
4,3404,10,100,1e-05,0.01,0.758,0.9403642773207991,1702,1702
4,3504,10,100,1e-05,0.01,0.818,0.9666095890410958,1745,1759
4,3604,10,100,1e-05,0.01,0.806,0.970865704772475,1795,1809
4,3704,10,100,1e-05,0.01,0.82,0.9624730021598272,1847,1857
4,3804,10,100,1e-05,0.01,0.812,0.9497896950578338,1890,1914
4,3904,10,100,1e-05,0.01,0.786,0.9159836065573771,1938,1966
4,4004,10,100,1e-05,0.01,0.844,0.9532967032967034,1990,2014
4,4104,10,100,1e-05,0.01,0.82,0.9403021442495126,2048,2056
4,4204,10,100,1e-05,0.01,0.846,0.9650333016175071,2099,2105
4,4304,10,100,1e-05,0.01,0.852,0.979089219330855,2150,2154
4,4404,10,100,1e-05,0.01,0.868,0.9729791099000908,2197,2207
4,4504,10,100,1e-05,0.01,0.868,0.9886767317939609,2237,2267
4,4604,10,100,1e-05,0.01,0.882,0.9904430929626412,2290,2314
4,4704,10,100,1e-05,0.01,0.894,0.9927721088435374,2349,2355
4,4804,10,100,1e-05,0.01,0.892,0.9885512073272273,2401,2403
4,4904,10,100,1e-05,0.01,0.888,0.9936786296900489,2456,2448
4,5004,10,100,1e-05,0.01,0.894,0.9928057553956835,2508,2496
4,5104,10,100,1e-05,0.01,0.898,0.9913793103448276,2557,2547
4,5204,10,100,1e-05,0.01,0.9,0.9928900845503459,2605,2599
4,5304,10,100,1e-05,0.01,0.9,0.9917043740573153,2658,2646
4,5404,10,100,1e-05,0.01,0.892,0.9776091783863805,2707,2697
4,5504,10,100,1e-05,0.01,0.892,0.9845566860465116,2752,2752
4,5604,10,100,1e-05,0.01,0.902,0.9887580299785867,2797,2807
4,5704,10,100,1e-05,0.01,0.9,0.9789621318373072,2847,2857
4,5804,10,100,1e-05,0.01,0.894,0.9825982081323226,2896,2908
4,5904,10,100,1e-05,0.01,0.904,0.9879742547425474,2953,2951
4,6004,10,100,1e-05,0.01,0.908,0.988674217188541,2995,3009
4,6104,10,100,1e-05,0.01,0.9,0.9880406290956749,3051,3053
4,6204,10,100,1e-05,0.01,0.906,0.9811411992263056,3099,3105
4,6304,10,100,1e-05,0.01,0.906,0.9847715736040609,3156,3148
4,6404,10,100,1e-05,0.01,0.942,0.9821986258588382,3214,3190
4,6504,10,100,1e-05,0.01,0.922,0.9898523985239852,3258,3246
4,6604,10,100,1e-05,0.01,0.914,0.9692610539067232,3305,3299
4,6704,10,100,1e-05,0.01,0.91,0.9618138424821002,3354,3350
4,6804,10,100,1e-05,0.01,0.916,0.9797178130511464,3400,3404
4,6904,10,100,1e-05,0.01,0.92,0.9729142526071842,3442,3462
4,7004,10,100,1e-05,0.01,0.946,0.9881496287835523,3487,3517
4,7104,10,100,1e-05,0.01,0.95,0.9915540540540541,3542,3562
4,7204,10,100,1e-05,0.01,0.946,0.996529705719045,3597,3607
4,7304,10,100,1e-05,0.01,0.952,0.9973986856516976,3644,3660
4,7404,10,100,1e-05,0.01,0.95,0.9931118314424635,3701,3703
4,7504,10,100,1e-05,0.01,0.934,0.990405117270789,3750,3754
4,7604,10,100,1e-05,0.01,0.946,0.9909258285113098,3807,3797
4,7704,10,100,1e-05,0.01,0.95,0.995846313603323,3852,3852
4,7804,10,100,1e-05,0.01,0.946,0.9966683751922091,3904,3900
4,7904,10,100,1e-05,0.01,0.948,0.9950657894736842,3960,3944
4,8004,10,100,1e-05,0.01,0.958,0.9956271864067966,4004,4000
4,8104,10,100,1e-05,0.01,0.954,0.9933366238894373,4042,4062
4,8204,10,100,1e-05,0.01,0.952,0.9892735251097026,4084,4120
4,8304,10,100,1e-05,0.01,0.94,0.98747591522158,4130,4174
4,8404,10,100,1e-05,0.01,0.952,0.9953593526891956,4177,4227
4,8504,10,100,1e-05,0.01,0.966,0.9950611476952023,4223,4281
4,8604,10,100,1e-05,0.01,0.952,0.996048349604835,4280,4324
4,8704,10,100,1e-05,0.01,0.948,0.9844898897058824,4331,4373
4,8804,10,100,1e-05,0.01,0.946,0.9955701953657429,4386,4418
4,8904,10,100,1e-05,0.01,0.962,0.9980907457322552,4433,4471
4,9004,10,100,1e-05,0.01,0.954,0.995224344735673,4482,4522
4,9104,10,100,1e-05,0.01,0.97,0.9947275922671354,4523,4581
4,9204,10,100,1e-05,0.01,0.952,0.9942416340721425,4576,4628
4,9304,10,100,1e-05,0.01,0.964,0.9963456577815993,4633,4671
4,9404,10,100,1e-05,0.01,0.954,0.9887282007656316,4688,4716
4,9504,10,100,1e-05,0.01,0.96,0.9969486531986532,4735,4769
4,9604,10,100,1e-05,0.01,0.956,0.9933361099541858,4777,4827
4,9704,10,100,1e-05,0.01,0.952,0.9904163231657048,4820,4884
4,9804,10,100,1e-05,0.01,0.966,0.9900040799673603,4869,4935
4,9904,10,100,1e-05,0.01,0.964,0.996668012924071,4914,4990
4,10004,10,100,1e-05,0.01,0.974,0.9960015993602559,4966,5038
4,10104,10,100,1e-05,0.01,0.968,0.9930720506730008,5025,5079
4,10204,10,100,1e-05,0.01,0.962,0.9940219521756174,5075,5129
4,10304,10,100,1e-05,0.01,0.964,0.9976708074534162,5129,5175
4,10404,10,100,1e-05,0.01,0.964,0.9949058054594386,5183,5221
4,10504,10,100,1e-05,0.01,0.96,0.9953351104341204,5225,5279
4,10604,10,100,1e-05,0.01,0.97,0.996605054696341,5274,5330
4,10704,10,100,1e-05,0.01,0.976,0.9985052316890882,5323,5381
4,10804,10,100,1e-05,0.01,0.976,0.9955572010366531,5371,5433
4,10904,10,100,1e-05,0.01,0.962,0.9955979457079971,5419,5485
4,11004,10,100,1e-05,0.01,0.978,0.9959105779716467,5474,5530
4,11104,10,100,1e-05,0.01,0.974,0.9948667146974063,5528,5576
4,11204,10,100,1e-05,0.01,0.972,0.9974116387004641,5579,5625
4,11304,10,100,1e-05,0.01,0.974,0.9986730360934183,5635,5669
4,11404,10,100,1e-05,0.01,0.978,0.9993861802876184,5695,5709
4,11504,10,100,1e-05,0.01,0.978,0.9993915159944368,5748,5756
4,11604,10,100,1e-05,0.01,0.982,0.999741468459152,5798,5806
4,11704,10,100,1e-05,0.01,0.982,0.9989747095010253,5851,5853
4,11804,10,100,1e-05,0.01,0.98,0.9979667909183327,5908,5896
4,11904,10,100,1e-05,0.01,0.972,0.990255376344086,5962,5942
4,12004,10,100,1e-05,0.01,0.964,0.9906697767410862,6019,5985
4,12104,10,100,1e-05,0.01,0.96,0.9908294778585591,6073,6031
4,12204,10,100,1e-05,0.01,0.95,0.9850868567682727,6121,6083
4,12304,10,100,1e-05,0.01,0.976,0.9927665799739922,6169,6135
4,12404,10,100,1e-05,0.01,0.978,0.9958078039342148,6224,6180
4,12504,10,100,1e-05,0.01,0.98,0.996641074856046,6271,6233
4,12604,10,100,1e-05,0.01,0.97,0.9923040304665186,6323,6281
4,12704,10,100,1e-05,0.01,0.98,0.9961429471032746,6367,6337
4,12804,10,100,1e-05,0.01,0.984,0.9975788815995001,6414,6390
4,12904,10,100,1e-05,0.01,0.984,0.9990700557966522,6462,6442
4,13004,10,100,1e-05,0.01,0.984,0.9997693017533067,6512,6492
4,13104,10,100,1e-05,0.01,0.984,0.9991605616605617,6561,6543
4,13204,10,100,1e-05,0.01,0.986,0.9991669191154195,6606,6598
4,13304,10,100,1e-05,0.01,0.986,0.9998496692723993,6652,6652
4,13404,10,100,1e-05,0.01,0.976,0.9988063264697106,6701,6703
4,13504,10,100,1e-05,0.01,0.962,0.9781546208530806,6758,6746
4,13604,10,100,1e-05,0.01,0.98,0.993384298735666,6806,6798
4,13704,10,100,1e-05,0.01,0.984,0.9973730297723292,6852,6852
4,13804,10,100,1e-05,0.01,0.984,0.9994929006085193,6895,6909
4,13904,10,100,1e-05,0.01,0.98,0.9986334867663982,6942,6962
4,14004,10,100,1e-05,0.01,0.978,0.9969294487289346,6992,7012
4,14104,10,100,1e-05,0.01,0.982,0.9974475326148611,7047,7057
4,14204,10,100,1e-05,0.01,0.982,0.9991551675584343,7098,7106
4,14304,10,100,1e-05,0.01,0.988,0.999650447427293,7136,7168
4,14404,10,100,1e-05,0.01,0.99,0.9968064426548181,7187,7217
4,14504,10,100,1e-05,0.01,0.984,0.9973110865968009,7227,7277
4,14604,10,100,1e-05,0.01,0.97,0.9937688304574089,7284,7320
4,14704,10,100,1e-05,0.01,0.986,0.989322633297062,7338,7366
4,14804,10,100,1e-05,0.01,0.978,0.9944609564982437,7388,7416
4,14904,10,100,1e-05,0.01,0.982,0.9969135802469136,7438,7466
4,15004,10,100,1e-05,0.01,0.992,0.9986670221274326,7489,7515
5,104,10,100,1e-05,0.01,0.49,0.6538461538461539,66,38
5,204,10,100,1e-05,0.01,0.516,0.5098039215686274,116,88
5,304,10,100,1e-05,0.01,0.518,0.5986842105263158,169,135
5,404,10,100,1e-05,0.01,0.494,0.6163366336633663,221,183
5,504,10,100,1e-05,0.01,0.52,0.623015873015873,272,232
5,604,10,100,1e-05,0.01,0.512,0.5778145695364238,316,288
5,704,10,100,1e-05,0.01,0.502,0.6264204545454546,368,336
5,804,10,100,1e-05,0.01,0.476,0.6554726368159204,418,386
5,904,10,100,1e-05,0.01,0.47,0.6836283185840708,455,449
5,1004,10,100,1e-05,0.01,0.474,0.6782868525896414,499,505
5,1104,10,100,1e-05,0.01,0.462,0.7128623188405797,565,539
5,1204,10,100,1e-05,0.01,0.464,0.723421926910299,617,587
5,1304,10,100,1e-05,0.01,0.522,0.7147239263803681,668,636
5,1404,10,100,1e-05,0.01,0.51,0.7528490028490028,718,686
5,1504,10,100,1e-05,0.01,0.53,0.7127659574468085,762,742
5,1604,10,100,1e-05,0.01,0.504,0.773067331670823,809,795
5,1704,10,100,1e-05,0.01,0.544,0.7717136150234741,860,844
5,1804,10,100,1e-05,0.01,0.518,0.7871396895787139,904,900
5,1904,10,100,1e-05,0.01,0.544,0.8245798319327731,956,948
5,2004,10,100,1e-05,0.01,0.516,0.8023952095808383,1004,1000
5,2104,10,100,1e-05,0.01,0.536,0.7918250950570342,1050,1054
5,2204,10,100,1e-05,0.01,0.54,0.837568058076225,1096,1108
5,2304,10,100,1e-05,0.01,0.546,0.7999131944444444,1146,1158
5,2404,10,100,1e-05,0.01,0.556,0.8069883527454242,1193,1211
5,2504,10,100,1e-05,0.01,0.516,0.8442492012779552,1238,1266
5,2604,10,100,1e-05,0.01,0.58,0.8594470046082949,1284,1320
5,2704,10,100,1e-05,0.01,0.57,0.8746301775147929,1335,1369
5,2804,10,100,1e-05,0.01,0.572,0.8951497860199714,1385,1419
5,2904,10,100,1e-05,0.01,0.606,0.9214876033057852,1444,1460
5,3004,10,100,1e-05,0.01,0.624,0.9377496671105193,1501,1503
5,3104,10,100,1e-05,0.01,0.644,0.9397551546391752,1558,1546
5,3204,10,100,1e-05,0.01,0.628,0.8913857677902621,1609,1595
5,3304,10,100,1e-05,0.01,0.642,0.8834745762711864,1664,1640
5,3404,10,100,1e-05,0.01,0.672,0.9121621621621622,1713,1691
5,3504,10,100,1e-05,0.01,0.696,0.9297945205479452,1756,1748
5,3604,10,100,1e-05,0.01,0.73,0.9425638179800222,1809,1795
5,3704,10,100,1e-05,0.01,0.708,0.92170626349892,1866,1838
5,3804,10,100,1e-05,0.01,0.72,0.9321766561514195,1921,1883
5,3904,10,100,1e-05,0.01,0.732,0.9413422131147541,1959,1945
5,4004,10,100,1e-05,0.01,0.776,0.958041958041958,2013,1991
5,4104,10,100,1e-05,0.01,0.8,0.9739278752436648,2058,2046
5,4204,10,100,1e-05,0.01,0.762,0.9414843006660324,2100,2104
5,4304,10,100,1e-05,0.01,0.764,0.9393587360594795,2147,2157
5,4404,10,100,1e-05,0.01,0.792,0.9648047229791099,2193,2211
5,4504,10,100,1e-05,0.01,0.804,0.9811278863232682,2235,2269
5,4604,10,100,1e-05,0.01,0.8,0.9750217202432667,2293,2311
5,4704,10,100,1e-05,0.01,0.824,0.982780612244898,2343,2361
5,4804,10,100,1e-05,0.01,0.84,0.9883430474604497,2393,2411
5,4904,10,100,1e-05,0.01,0.846,0.992862969004894,2437,2467
5,5004,10,100,1e-05,0.01,0.822,0.9902078337330136,2489,2515
5,5104,10,100,1e-05,0.01,0.794,0.9439655172413793,2536,2568
5,5204,10,100,1e-05,0.01,0.818,0.9721368178324366,2575,2629
5,5304,10,100,1e-05,0.01,0.864,0.9941553544494721,2627,2677
5,5404,10,100,1e-05,0.01,0.858,0.9913027387120651,2673,2731
5,5504,10,100,1e-05,0.01,0.87,0.9934593023255814,2721,2783
5,5604,10,100,1e-05,0.01,0.854,0.9900071377587437,2776,2828
5,5704,10,100,1e-05,0.01,0.868,0.9947405329593267,2826,2878
5,5804,10,100,1e-05,0.01,0.866,0.9932804962095106,2867,2937
5,5904,10,100,1e-05,0.01,0.88,0.9940718157181572,2917,2987
5,6004,10,100,1e-05,0.01,0.89,0.9915056628914057,2959,3045
5,6104,10,100,1e-05,0.01,0.882,0.9875491480996068,3005,3099
5,6204,10,100,1e-05,0.01,0.886,0.9879110251450677,3053,3151
5,6304,10,100,1e-05,0.01,0.866,0.9871510152284264,3109,3195
5,6404,10,100,1e-05,0.01,0.886,0.9829793878825734,3162,3242
5,6504,10,100,1e-05,0.01,0.866,0.9786285362853628,3211,3293
5,6604,10,100,1e-05,0.01,0.862,0.9450333131435493,3255,3349
5,6704,10,100,1e-05,0.01,0.868,0.9531622911694511,3307,3397
5,6804,10,100,1e-05,0.01,0.914,0.9845679012345679,3358,3446
5,6904,10,100,1e-05,0.01,0.906,0.9863847045191193,3413,3491
5,7004,10,100,1e-05,0.01,0.912,0.9901484865790977,3460,3544
5,7104,10,100,1e-05,0.01,0.914,0.9935247747747747,3515,3589
5,7204,10,100,1e-05,0.01,0.936,0.997917823431427,3564,3640
5,7304,10,100,1e-05,0.01,0.944,0.9980832420591457,3619,3685
5,7404,10,100,1e-05,0.01,0.94,0.9948676391139925,3667,3737
5,7504,10,100,1e-05,0.01,0.942,0.997867803837953,3718,3786
5,7604,10,100,1e-05,0.01,0.95,0.9980273540241978,3769,3835
5,7704,10,100,1e-05,0.01,0.95,0.9935098650051921,3821,3883
5,7804,10,100,1e-05,0.01,0.954,0.9946181445412609,3874,3930
5,7904,10,100,1e-05,0.01,0.936,0.992661943319838,3926,3978
5,8004,10,100,1e-05,0.01,0.93,0.9877561219390305,3982,4022
5,8104,10,100,1e-05,0.01,0.94,0.9943237907206318,4033,4071
5,8204,10,100,1e-05,0.01,0.93,0.9822038030229157,4082,4122
5,8304,10,100,1e-05,0.01,0.938,0.9897639691714836,4135,4169
5,8404,10,100,1e-05,0.01,0.916,0.9834602570204665,4182,4222
5,8504,10,100,1e-05,0.01,0.924,0.9848306679209784,4235,4269
5,8604,10,100,1e-05,0.01,0.932,0.9857043235704324,4274,4330
5,8704,10,100,1e-05,0.01,0.952,0.9954044117647058,4323,4381
5,8804,10,100,1e-05,0.01,0.962,0.9960245343025897,4378,4426
5,8904,10,100,1e-05,0.01,0.944,0.9910152740341419,4426,4478
5,9004,10,100,1e-05,0.01,0.952,0.9971123944913372,4467,4537
5,9104,10,100,1e-05,0.01,0.958,0.9927504393673111,4513,4591
5,9204,10,100,1e-05,0.01,0.952,0.9982616253802694,4560,4644
5,9304,10,100,1e-05,0.01,0.94,0.9814058469475494,4607,4697
5,9404,10,100,1e-05,0.01,0.932,0.979902169289664,4652,4752
5,9504,10,100,1e-05,0.01,0.954,0.9925294612794613,4707,4797
5,9604,10,100,1e-05,0.01,0.946,0.9942732194918784,4771,4833
5,9704,10,100,1e-05,0.01,0.952,0.9952596867271228,4827,4877
5,9804,10,100,1e-05,0.01,0.95,0.9981640146878825,4884,4920
5,9904,10,100,1e-05,0.01,0.958,0.999394184168013,4924,4980
5,10004,10,100,1e-05,0.01,0.956,0.9977009196321471,4977,5027
5,10104,10,100,1e-05,0.01,0.952,0.9989113222486145,5019,5085
5,10204,10,100,1e-05,0.01,0.954,0.9981379851038809,5069,5135
5,10304,10,100,1e-05,0.01,0.956,0.9965062111801242,5120,5184
5,10404,10,100,1e-05,0.01,0.956,0.9958669742406767,5179,5225
5,10504,10,100,1e-05,0.01,0.964,0.9944782939832445,5230,5274
5,10604,10,100,1e-05,0.01,0.96,0.9932101093926821,5273,5331
5,10704,10,100,1e-05,0.01,0.952,0.9908445440956651,5317,5387
5,10804,10,100,1e-05,0.01,0.958,0.9962976675305443,5380,5424
5,10904,10,100,1e-05,0.01,0.964,0.9956896551724138,5427,5477
5,11004,10,100,1e-05,0.01,0.97,0.997546346782988,5475,5529
5,11104,10,100,1e-05,0.01,0.96,0.9953170028818443,5523,5581
5,11204,10,100,1e-05,0.01,0.944,0.9857193859335951,5567,5637
5,11304,10,100,1e-05,0.01,0.954,0.9859341825902336,5627,5677
5,11404,10,100,1e-05,0.01,0.948,0.9918449666783584,5675,5729
5,11504,10,100,1e-05,0.01,0.976,0.9973052851182197,5719,5785
5,11604,10,100,1e-05,0.01,0.972,0.9989658738366081,5779,5825
5,11704,10,100,1e-05,0.01,0.972,0.9971804511278195,5838,5866
5,11804,10,100,1e-05,0.01,0.972,0.9983056590986107,5890,5914
5,11904,10,100,1e-05,0.01,0.97,0.9995799731182796,5939,5965
5,12004,10,100,1e-05,0.01,0.98,0.999083638787071,5989,6015
5,12104,10,100,1e-05,0.01,0.978,0.9976867151354925,6036,6068
5,12204,10,100,1e-05,0.01,0.984,0.9973779088823337,6088,6116
5,12304,10,100,1e-05,0.01,0.974,0.9950422626788037,6140,6164
5,12404,10,100,1e-05,0.01,0.972,0.9931473718155434,6190,6214
5,12504,10,100,1e-05,0.01,0.974,0.9958413307741523,6247,6257
5,12604,10,100,1e-05,0.01,0.966,0.9934941288479847,6305,6299
5,12704,10,100,1e-05,0.01,0.966,0.9928369017632241,6365,6339
5,12804,10,100,1e-05,0.01,0.968,0.9967197750702905,6410,6394
5,12904,10,100,1e-05,0.01,0.978,0.9970551766893986,6456,6448
5,13004,10,100,1e-05,0.01,0.976,0.9931559520147647,6516,6488
5,13104,10,100,1e-05,0.01,0.984,0.9970238095238095,6569,6535
5,13204,10,100,1e-05,0.01,0.976,0.9983338382308391,6622,6582
5,13304,10,100,1e-05,0.01,0.99,0.9975195429945881,6679,6625
5,13404,10,100,1e-05,0.01,0.976,0.9929125634139063,6722,6682
5,13504,10,100,1e-05,0.01,0.978,0.991928317535545,6771,6733
5,13604,10,100,1e-05,0.01,0.984,0.9962511026168774,6826,6778
5,13704,10,100,1e-05,0.01,0.984,0.9976649153531816,6871,6833
5,13804,10,100,1e-05,0.01,0.988,0.9983338162851347,6922,6882
5,13904,10,100,1e-05,0.01,0.982,0.9985615650172612,6973,6931
5,14004,10,100,1e-05,0.01,0.984,0.9985718366181091,7024,6980
5,14104,10,100,1e-05,0.01,0.98,0.9972348269994328,7073,7031
5,14204,10,100,1e-05,0.01,0.972,0.9921148972120529,7105,7099
5,14304,10,100,1e-05,0.01,0.984,0.997832774049217,7161,7143
5,14404,10,100,1e-05,0.01,0.984,0.9970147181338517,7212,7192
5,14504,10,100,1e-05,0.01,0.988,0.9977247655819085,7255,7249
5,14604,10,100,1e-05,0.01,0.97,0.9841824157764996,7302,7302
5,14704,10,100,1e-05,0.01,0.982,0.9960554951033732,7349,7355
5,14804,10,100,1e-05,0.01,0.986,0.9965549851391515,7396,7408
5,14904,10,100,1e-05,0.01,0.98,0.9958400429414922,7453,7451
5,15004,10,100,1e-05,0.01,0.984,0.997267395361237,7506,7498
6,104,10,100,1e-05,0.01,0.482,0.4807692307692308,50,54
6,204,10,100,1e-05,0.01,0.52,0.5441176470588235,96,108
6,304,10,100,1e-05,0.01,0.504,0.6118421052631579,137,167
6,404,10,100,1e-05,0.01,0.49,0.6336633663366337,191,213
6,504,10,100,1e-05,0.01,0.48,0.621031746031746,253,251
6,604,10,100,1e-05,0.01,0.48,0.6158940397350994,301,303
6,704,10,100,1e-05,0.01,0.498,0.6278409090909091,352,352
6,804,10,100,1e-05,0.01,0.484,0.6480099502487562,404,400
6,904,10,100,1e-05,0.01,0.486,0.6371681415929203,457,447
6,1004,10,100,1e-05,0.01,0.504,0.6444223107569721,500,504
6,1104,10,100,1e-05,0.01,0.474,0.6748188405797102,547,557
6,1204,10,100,1e-05,0.01,0.45,0.6893687707641196,602,602
6,1304,10,100,1e-05,0.01,0.482,0.6924846625766872,652,652
6,1404,10,100,1e-05,0.01,0.49,0.6873219373219374,705,699
6,1504,10,100,1e-05,0.01,0.494,0.6954787234042553,760,744
6,1604,10,100,1e-05,0.01,0.508,0.7674563591022444,808,796
6,1704,10,100,1e-05,0.01,0.496,0.7529342723004695,851,853
6,1804,10,100,1e-05,0.01,0.516,0.7960088691796009,894,910
6,1904,10,100,1e-05,0.01,0.53,0.7673319327731093,942,962
6,2004,10,100,1e-05,0.01,0.558,0.7410179640718563,995,1009
6,2104,10,100,1e-05,0.01,0.514,0.7580798479087453,1038,1066
6,2204,10,100,1e-05,0.01,0.562,0.8239564428312159,1098,1106
6,2304,10,100,1e-05,0.01,0.554,0.8138020833333334,1151,1153
6,2404,10,100,1e-05,0.01,0.572,0.8469217970049917,1203,1201
6,2504,10,100,1e-05,0.01,0.576,0.8442492012779552,1256,1248
6,2604,10,100,1e-05,0.01,0.592,0.8748079877112135,1309,1295
6,2704,10,100,1e-05,0.01,0.596,0.882396449704142,1363,1341
6,2804,10,100,1e-05,0.01,0.632,0.8940798858773181,1414,1390
6,2904,10,100,1e-05,0.01,0.614,0.8677685950413223,1463,1441
6,3004,10,100,1e-05,0.01,0.654,0.9077896138482024,1515,1489
6,3104,10,100,1e-05,0.01,0.654,0.8914304123711341,1563,1541
6,3204,10,100,1e-05,0.01,0.662,0.9179151061173533,1606,1598
6,3304,10,100,1e-05,0.01,0.638,0.8970944309927361,1653,1651
6,3404,10,100,1e-05,0.01,0.67,0.9303760282021152,1700,1704
6,3504,10,100,1e-05,0.01,0.68,0.9489155251141552,1746,1758
6,3604,10,100,1e-05,0.01,0.736,0.9525527192008879,1791,1813
6,3704,10,100,1e-05,0.01,0.722,0.9616630669546437,1843,1861
6,3804,10,100,1e-05,0.01,0.75,0.9815983175604627,1892,1912
6,3904,10,100,1e-05,0.01,0.74,0.9736168032786885,1948,1956
6,4004,10,100,1e-05,0.01,0.74,0.9815184815184815,1998,2006
6,4104,10,100,1e-05,0.01,0.768,0.9895224171539961,2049,2055
6,4204,10,100,1e-05,0.01,0.794,0.9907231208372979,2099,2105
6,4304,10,100,1e-05,0.01,0.764,0.9909386617100372,2144,2160
6,4404,10,100,1e-05,0.01,0.798,0.9938692098092643,2194,2210
6,4504,10,100,1e-05,0.01,0.798,0.9866785079928952,2247,2257
6,4604,10,100,1e-05,0.01,0.822,0.9939183318853171,2293,2311
6,4704,10,100,1e-05,0.01,0.84,0.9961734693877551,2341,2363
6,4804,10,100,1e-05,0.01,0.84,0.9983347210657785,2390,2414
6,4904,10,100,1e-05,0.01,0.852,0.9900081566068516,2436,2468
6,5004,10,100,1e-05,0.01,0.886,0.9980015987210232,2486,2518
6,5104,10,100,1e-05,0.01,0.876,0.9935344827586207,2522,2582
6,5204,10,100,1e-05,0.01,0.88,0.990392006149116,2574,2630
6,5304,10,100,1e-05,0.01,0.894,0.994343891402715,2628,2676
6,5404,10,100,1e-05,0.01,0.904,0.9953737971872687,2670,2734
6,5504,10,100,1e-05,0.01,0.91,0.9898255813953488,2721,2783
6,5604,10,100,1e-05,0.01,0.908,0.9857244825124911,2771,2833
6,5704,10,100,1e-05,0.01,0.912,0.9836956521739131,2826,2878
6,5804,10,100,1e-05,0.01,0.916,0.9901791867677464,2880,2924
6,5904,10,100,1e-05,0.01,0.92,0.9952574525745257,2935,2969
6,6004,10,100,1e-05,0.01,0.948,0.9985009993337775,2987,3017
6,6104,10,100,1e-05,0.01,0.95,0.9985255570117956,3038,3066
6,6204,10,100,1e-05,0.01,0.958,0.9988716956802063,3090,3114
6,6304,10,100,1e-05,0.01,0.956,0.9995241116751269,3143,3161
6,6404,10,100,1e-05,0.01,0.952,0.9937539038101186,3182,3222
6,6504,10,100,1e-05,0.01,0.95,0.9960024600246002,3227,3277
6,6604,10,100,1e-05,0.01,0.942,0.9968201090248334,3283,3321
6,6704,10,100,1e-05,0.01,0.952,0.9983591885441527,3329,3375
6,6804,10,100,1e-05,0.01,0.96,0.9982363315696648,3379,3425
6,6904,10,100,1e-05,0.01,0.962,0.9992757821552724,3427,3477
6,7004,10,100,1e-05,0.01,0.952,0.9992861222158766,3482,3522
6,7104,10,100,1e-05,0.01,0.964,0.9990146396396397,3532,3572
6,7204,10,100,1e-05,0.01,0.964,0.9955580233203776,3579,3625
6,7304,10,100,1e-05,0.01,0.956,0.9957557502738226,3636,3668
6,7404,10,100,1e-05,0.01,0.926,0.9816315505132361,3692,3712
6,7504,10,100,1e-05,0.01,0.952,0.9873400852878464,3744,3760
6,7604,10,100,1e-05,0.01,0.96,0.9911888479747502,3795,3809
6,7704,10,100,1e-05,0.01,0.964,0.9894859813084113,3844,3860
6,7804,10,100,1e-05,0.01,0.968,0.996155817529472,3891,3913
6,7904,10,100,1e-05,0.01,0.972,0.9972165991902834,3943,3961
6,8004,10,100,1e-05,0.01,0.98,0.9933783108445777,4004,4000
6,8104,10,100,1e-05,0.01,0.968,0.9939536031589339,4057,4047
6,8204,10,100,1e-05,0.01,0.984,0.999390541199415,4110,4094
6,8304,10,100,1e-05,0.01,0.984,0.9978323699421965,4162,4142
6,8404,10,100,1e-05,0.01,0.974,0.9970252260828177,4210,4194
6,8504,10,100,1e-05,0.01,0.974,0.9981185324553151,4262,4242
6,8604,10,100,1e-05,0.01,0.984,0.9994188749418875,4314,4290
6,8704,10,100,1e-05,0.01,0.982,0.9994255514705882,4362,4342
6,8804,10,100,1e-05,0.01,0.978,0.998750567923671,4407,4397
6,8904,10,100,1e-05,0.01,0.986,0.9970799640610961,4455,4449
6,9004,10,100,1e-05,0.01,0.984,0.9995557529986673,4503,4501
6,9104,10,100,1e-05,0.01,0.98,0.9992311072056239,4548,4556
6,9204,10,100,1e-05,0.01,0.988,0.9991308126901347,4594,4610
6,9304,10,100,1e-05,0.01,0.978,0.9979578675838349,4639,4665
6,9404,10,100,1e-05,0.01,0.982,0.9984049340706083,4681,4723
6,9504,10,100,1e-05,0.01,0.982,0.9984217171717171,4734,4770
6,9604,10,100,1e-05,0.01,0.978,0.9960433152852978,4793,4811
6,9704,10,100,1e-05,0.01,0.99,0.9971145919208574,4845,4859
6,9804,10,100,1e-05,0.01,0.99,0.9957160342717258,4900,4904
6,9904,10,100,1e-05,0.01,0.982,0.997778675282714,4955,4949
6,10004,10,100,1e-05,0.01,0.988,0.9988004798080767,5000,5004
6,10104,10,100,1e-05,0.01,0.99,0.9995051464766429,5044,5060
6,10204,10,100,1e-05,0.01,0.994,0.9997059976479812,5097,5107
6,10304,10,100,1e-05,0.01,0.994,0.999417701863354,5143,5161
6,10404,10,100,1e-05,0.01,0.982,0.9947135717031911,5198,5206
6,10504,10,100,1e-05,0.01,0.988,0.9958111195734958,5242,5262
6,10604,10,100,1e-05,0.01,0.994,0.9900980761976612,5294,5310
6,10704,10,100,1e-05,0.01,0.98,0.9947683109118086,5345,5359
6,10804,10,100,1e-05,0.01,0.992,0.9947241762310255,5395,5409
6,10904,10,100,1e-05,0.01,0.99,0.9953228173147469,5443,5461
6,11004,10,100,1e-05,0.01,0.992,0.9982733551435842,5497,5507
6,11104,10,100,1e-05,0.01,0.996,0.9993695965417867,5548,5556
6,11204,10,100,1e-05,0.01,0.99,0.9995537308104249,5592,5612
6,11304,10,100,1e-05,0.01,0.998,0.9999115357395613,5651,5653
6,11404,10,100,1e-05,0.01,0.998,0.9995615573482989,5704,5700
6,11504,10,100,1e-05,0.01,0.998,0.9997392211404729,5750,5754
6,11604,10,100,1e-05,0.01,0.994,0.9999138228197173,5801,5803
6,11704,10,100,1e-05,0.01,0.998,0.9999145591250854,5856,5848
6,11804,10,100,1e-05,0.01,0.998,1.0,5903,5901
6,11904,10,100,1e-05,0.01,0.996,0.9995799731182796,5952,5952
6,12004,10,100,1e-05,0.01,0.976,0.9842552482505832,5996,6008
6,12104,10,100,1e-05,0.01,0.99,0.9916556510244547,6054,6050
6,12204,10,100,1e-05,0.01,0.988,0.9931170108161259,6111,6093
6,12304,10,100,1e-05,0.01,0.996,0.9983745123537061,6160,6144
6,12404,10,100,1e-05,0.01,0.998,0.9992744276039988,6212,6192
6,12504,10,100,1e-05,0.01,0.994,0.9999200255918106,6268,6236
6,12604,10,100,1e-05,0.01,0.996,0.9998413202158045,6316,6288
6,12704,10,100,1e-05,0.01,0.992,0.9992915617128464,6368,6336
6,12804,10,100,1e-05,0.01,0.996,1.0,6414,6390
6,12904,10,100,1e-05,0.01,0.996,0.9996900185988841,6464,6440
6,13004,10,100,1e-05,0.01,0.996,1.0,6516,6488
6,13104,10,100,1e-05,0.01,0.994,0.9996184371184371,6567,6537
6,13204,10,100,1e-05,0.01,0.994,0.9990911844895486,6616,6588
6,13304,10,100,1e-05,0.01,0.988,0.9957907396271798,6655,6649
6,13404,10,100,1e-05,0.01,0.998,0.9984333034914951,6709,6695
6,13504,10,100,1e-05,0.01,0.996,0.998593009478673,6758,6746
6,13604,10,100,1e-05,0.01,0.992,0.9975007350779183,6805,6799
6,13704,10,100,1e-05,0.01,0.992,0.9991973146526562,6858,6846
6,13804,10,100,1e-05,0.01,0.996,0.9992755722978847,6909,6895
6,13904,10,100,1e-05,0.01,0.994,0.9995684695051784,6951,6953
6,14004,10,100,1e-05,0.01,0.994,0.9994287346472437,6998,7006
6,14104,10,100,1e-05,0.01,0.992,0.9986528644356211,7044,7060
6,14204,10,100,1e-05,0.01,0.998,0.9987327513376514,7096,7108
6,14304,10,100,1e-05,0.01,0.992,0.9993708053691275,7148,7156
6,14404,10,100,1e-05,0.01,0.994,0.9990280477645098,7197,7207
6,14504,10,100,1e-05,0.01,0.994,0.9967595146166575,7251,7253
6,14604,10,100,1e-05,0.01,0.994,0.99637085729937,7303,7301
6,14704,10,100,1e-05,0.01,0.998,0.9966675734494015,7355,7349
6,14804,10,100,1e-05,0.01,0.994,0.9989867603350446,7404,7400
6,14904,10,100,1e-05,0.01,0.998,0.9998658078368223,7459,7445
6,15004,10,100,1e-05,0.01,0.998,0.9999333511063716,7512,7492
7,104,10,100,1e-05,0.01,0.52,0.6057692307692307,41,63
7,204,10,100,1e-05,0.01,0.522,0.6421568627450981,87,117
7,304,10,100,1e-05,0.01,0.494,0.6019736842105263,137,167
7,404,10,100,1e-05,0.01,0.474,0.5841584158415841,182,222
7,504,10,100,1e-05,0.01,0.516,0.6468253968253969,233,271
7,604,10,100,1e-05,0.01,0.476,0.6556291390728477,292,312
7,704,10,100,1e-05,0.01,0.51,0.6661931818181818,343,361
7,804,10,100,1e-05,0.01,0.512,0.6467661691542289,392,412
7,904,10,100,1e-05,0.01,0.508,0.6803097345132744,436,468
7,1004,10,100,1e-05,0.01,0.5,0.6912350597609562,484,520
7,1104,10,100,1e-05,0.01,0.51,0.7110507246376812,541,563
7,1204,10,100,1e-05,0.01,0.536,0.7093023255813954,584,620
7,1304,10,100,1e-05,0.01,0.516,0.7254601226993865,637,667
7,1404,10,100,1e-05,0.01,0.534,0.7663817663817664,685,719
7,1504,10,100,1e-05,0.01,0.57,0.7632978723404256,745,759
7,1604,10,100,1e-05,0.01,0.568,0.7967581047381546,800,804
7,1704,10,100,1e-05,0.01,0.558,0.7676056338028169,844,860
7,1804,10,100,1e-05,0.01,0.608,0.774390243902439,886,918
7,1904,10,100,1e-05,0.01,0.564,0.7956932773109243,935,969
7,2004,10,100,1e-05,0.01,0.652,0.8353293413173652,981,1023
7,2104,10,100,1e-05,0.01,0.624,0.8255703422053232,1027,1077
7,2204,10,100,1e-05,0.01,0.638,0.838475499092559,1087,1117
7,2304,10,100,1e-05,0.01,0.672,0.8628472222222222,1137,1167
7,2404,10,100,1e-05,0.01,0.662,0.8810316139767055,1187,1217
7,2504,10,100,1e-05,0.01,0.674,0.8498402555910544,1238,1266
7,2604,10,100,1e-05,0.01,0.718,0.8582949308755761,1290,1314
7,2704,10,100,1e-05,0.01,0.72,0.8820266272189349,1338,1366
7,2804,10,100,1e-05,0.01,0.73,0.8880171184022825,1380,1424
7,2904,10,100,1e-05,0.01,0.734,0.9128787878787878,1438,1466
7,3004,10,100,1e-05,0.01,0.742,0.9111185086551264,1489,1515
7,3104,10,100,1e-05,0.01,0.76,0.9378221649484536,1533,1571
7,3204,10,100,1e-05,0.01,0.766,0.954119850187266,1576,1628
7,3304,10,100,1e-05,0.01,0.782,0.9491525423728814,1627,1677
7,3404,10,100,1e-05,0.01,0.768,0.9297884841363102,1673,1731
7,3504,10,100,1e-05,0.01,0.746,0.9480593607305936,1725,1779
7,3604,10,100,1e-05,0.01,0.798,0.9605993340732519,1769,1835
7,3704,10,100,1e-05,0.01,0.778,0.9632829373650108,1826,1878
7,3804,10,100,1e-05,0.01,0.788,0.9631966351209253,1875,1929
7,3904,10,100,1e-05,0.01,0.78,0.9336577868852459,1929,1975
7,4004,10,100,1e-05,0.01,0.782,0.9507992007992008,1991,2013
7,4104,10,100,1e-05,0.01,0.774,0.9534600389863548,2043,2061
7,4204,10,100,1e-05,0.01,0.786,0.9712178877259753,2095,2109
7,4304,10,100,1e-05,0.01,0.812,0.9744423791821561,2138,2166
7,4404,10,100,1e-05,0.01,0.822,0.9736603088101726,2195,2209
7,4504,10,100,1e-05,0.01,0.814,0.9726909413854352,2239,2265
7,4604,10,100,1e-05,0.01,0.824,0.9730668983492615,2297,2307
7,4704,10,100,1e-05,0.01,0.824,0.9719387755102041,2351,2353
7,4804,10,100,1e-05,0.01,0.816,0.9648209825145712,2400,2404
7,4904,10,100,1e-05,0.01,0.812,0.9480016313213703,2450,2454
7,5004,10,100,1e-05,0.01,0.816,0.964828137490008,2503,2501
7,5104,10,100,1e-05,0.01,0.818,0.960423197492163,2561,2543
7,5204,10,100,1e-05,0.01,0.838,0.9644504227517294,2611,2593
7,5304,10,100,1e-05,0.01,0.822,0.9773755656108597,2669,2635
7,5404,10,100,1e-05,0.01,0.778,0.9393042190969653,2720,2684
7,5504,10,100,1e-05,0.01,0.78,0.9102470930232558,2771,2733
7,5604,10,100,1e-05,0.01,0.85,0.9507494646680942,2805,2799
7,5704,10,100,1e-05,0.01,0.844,0.9717741935483871,2849,2855
7,5804,10,100,1e-05,0.01,0.864,0.9822536181943488,2897,2907
7,5904,10,100,1e-05,0.01,0.868,0.9872967479674797,2956,2948
7,6004,10,100,1e-05,0.01,0.866,0.9888407728181212,3009,2995
7,6104,10,100,1e-05,0.01,0.872,0.9896788990825688,3062,3042
7,6204,10,100,1e-05,0.01,0.866,0.9851708575112831,3111,3093
7,6304,10,100,1e-05,0.01,0.856,0.9850888324873096,3170,3134
7,6404,10,100,1e-05,0.01,0.85,0.9757963772642099,3215,3189
7,6504,10,100,1e-05,0.01,0.864,0.9760147601476015,3270,3234
7,6604,10,100,1e-05,0.01,0.862,0.9798606904906118,3314,3290
7,6704,10,100,1e-05,0.01,0.82,0.9354116945107399,3357,3347
7,6804,10,100,1e-05,0.01,0.844,0.9522339800117577,3401,3403
7,6904,10,100,1e-05,0.01,0.876,0.9800115874855156,3458,3446
7,7004,10,100,1e-05,0.01,0.856,0.9811536264991434,3505,3499
7,7104,10,100,1e-05,0.01,0.884,0.9881756756756757,3549,3555
7,7204,10,100,1e-05,0.01,0.884,0.9891726818434203,3599,3605
7,7304,10,100,1e-05,0.01,0.882,0.9882256297918949,3644,3660
7,7404,10,100,1e-05,0.01,0.86,0.9759589411129119,3693,3711
7,7504,10,100,1e-05,0.01,0.858,0.9420309168443497,3743,3761
7,7604,10,100,1e-05,0.01,0.866,0.9719884271436087,3795,3809
7,7704,10,100,1e-05,0.01,0.866,0.9386033229491173,3840,3864
7,7804,10,100,1e-05,0.01,0.886,0.966555612506407,3891,3913
7,7904,10,100,1e-05,0.01,0.866,0.965334008097166,3944,3960
7,8004,10,100,1e-05,0.01,0.886,0.9705147426286856,3983,4021
7,8104,10,100,1e-05,0.01,0.904,0.983218163869694,4031,4073
7,8204,10,100,1e-05,0.01,0.874,0.9745246221355436,4075,4129
7,8304,10,100,1e-05,0.01,0.912,0.986271676300578,4123,4181
7,8404,10,100,1e-05,0.01,0.902,0.993455497382199,4168,4236
7,8504,10,100,1e-05,0.01,0.918,0.993414863593603,4215,4289
7,8604,10,100,1e-05,0.01,0.91,0.9926778242677824,4261,4343
7,8704,10,100,1e-05,0.01,0.906,0.9934512867647058,4314,4390
7,8804,10,100,1e-05,0.01,0.908,0.9823943661971831,4366,4438
7,8904,10,100,1e-05,0.01,0.912,0.988544474393531,4412,4492
7,9004,10,100,1e-05,0.01,0.92,0.9924478009773434,4463,4541
7,9104,10,100,1e-05,0.01,0.904,0.9848418277680141,4516,4588
7,9204,10,100,1e-05,0.01,0.932,0.9875054324206867,4556,4648
7,9304,10,100,1e-05,0.01,0.93,0.9892519346517626,4600,4704
7,9404,10,100,1e-05,0.01,0.918,0.9925563589961719,4659,4745
7,9504,10,100,1e-05,0.01,0.932,0.9890572390572391,4709,4795
7,9604,10,100,1e-05,0.01,0.924,0.9891711786755518,4761,4843
7,9704,10,100,1e-05,0.01,0.922,0.988767518549052,4812,4892
7,9804,10,100,1e-05,0.01,0.922,0.9847001223990208,4876,4928
7,9904,10,100,1e-05,0.01,0.938,0.9891962843295639,4921,4983
7,10004,10,100,1e-05,0.01,0.932,0.9908036785285885,4969,5035
7,10104,10,100,1e-05,0.01,0.94,0.9919833729216152,5017,5087
7,10204,10,100,1e-05,0.01,0.932,0.99421795374363,5058,5146
7,10304,10,100,1e-05,0.01,0.944,0.9935947204968945,5105,5199
7,10404,10,100,1e-05,0.01,0.908,0.9706843521722415,5158,5246
7,10504,10,100,1e-05,0.01,0.886,0.9395468392993146,5213,5291
7,10604,10,100,1e-05,0.01,0.942,0.9812334967936628,5271,5333
7,10704,10,100,1e-05,0.01,0.954,0.9907511210762332,5322,5382
7,10804,10,100,1e-05,0.01,0.946,0.9916697519437245,5369,5435
7,10904,10,100,1e-05,0.01,0.946,0.9955062362435804,5424,5480
7,11004,10,100,1e-05,0.01,0.952,0.9936386768447837,5471,5533
7,11104,10,100,1e-05,0.01,0.942,0.9888328530259366,5528,5576
7,11204,10,100,1e-05,0.01,0.958,0.9929489468047126,5573,5631
7,11304,10,100,1e-05,0.01,0.95,0.9894727530077848,5622,5682
7,11404,10,100,1e-05,0.01,0.952,0.9914065240266573,5679,5725
7,11504,10,100,1e-05,0.01,0.95,0.9908727399165508,5728,5776
7,11604,10,100,1e-05,0.01,0.944,0.9909513960703206,5784,5820
7,11704,10,100,1e-05,0.01,0.958,0.9953861927546138,5839,5865
7,11804,10,100,1e-05,0.01,0.964,0.9957641477465266,5895,5909
7,11904,10,100,1e-05,0.01,0.96,0.9962197580645161,5950,5954
7,12004,10,100,1e-05,0.01,0.964,0.9951682772409197,5993,6011
7,12104,10,100,1e-05,0.01,0.968,0.9975214805023133,6051,6053
7,12204,10,100,1e-05,0.01,0.956,0.9909046214355949,6100,6104
7,12304,10,100,1e-05,0.01,0.962,0.9939044213263979,6152,6152
7,12404,10,100,1e-05,0.01,0.956,0.9890357949048694,6208,6196
7,12504,10,100,1e-05,0.01,0.958,0.9908029430582214,6257,6247
7,12604,10,100,1e-05,0.01,0.958,0.989368454458902,6308,6296
7,12704,10,100,1e-05,0.01,0.964,0.9959068010075567,6358,6346
7,12804,10,100,1e-05,0.01,0.964,0.9971883786316776,6404,6400
7,12904,10,100,1e-05,0.01,0.964,0.9979076255424675,6452,6452
7,13004,10,100,1e-05,0.01,0.97,0.9987696093509689,6507,6497
7,13104,10,100,1e-05,0.01,0.972,0.998550061050061,6554,6550
7,13204,10,100,1e-05,0.01,0.97,0.9959103302029688,6607,6597
7,13304,10,100,1e-05,0.01,0.966,0.9951142513529766,6659,6645
7,13404,10,100,1e-05,0.01,0.972,0.9963443748134885,6708,6696
7,13504,10,100,1e-05,0.01,0.95,0.9896327014218009,6761,6743
7,13604,10,100,1e-05,0.01,0.964,0.991105557189062,6805,6799
7,13704,10,100,1e-05,0.01,0.97,0.9963514302393461,6853,6851
7,13804,10,100,1e-05,0.01,0.962,0.9966676325702695,6911,6893
7,13904,10,100,1e-05,0.01,0.972,0.9933831990794016,6956,6948
7,14004,10,100,1e-05,0.01,0.966,0.9912882033704655,7002,7002
7,14104,10,100,1e-05,0.01,0.968,0.9958167895632445,7050,7054
7,14204,10,100,1e-05,0.01,0.974,0.9990143621515066,7098,7106
7,14304,10,100,1e-05,0.01,0.974,0.9991610738255033,7144,7160
7,14404,10,100,1e-05,0.01,0.976,0.9967370174951402,7197,7207
7,14504,10,100,1e-05,0.01,0.966,0.9968974076116933,7252,7252
7,14604,10,100,1e-05,0.01,0.96,0.9931525609422076,7299,7305
7,14704,10,100,1e-05,0.01,0.974,0.9975516866158868,7352,7352
7,14804,10,100,1e-05,0.01,0.974,0.995136449608214,7399,7405
7,14904,10,100,1e-05,0.01,0.966,0.9910762211486849,7457,7447
7,15004,10,100,1e-05,0.01,0.97,0.9937350039989337,7512,7492
8,104,10,100,1e-05,0.01,0.506,0.6730769230769231,50,54
8,204,10,100,1e-05,0.01,0.508,0.5637254901960784,102,102
8,304,10,100,1e-05,0.01,0.5,0.618421052631579,152,152
8,404,10,100,1e-05,0.01,0.49,0.594059405940594,201,203
8,504,10,100,1e-05,0.01,0.492,0.6111111111111112,255,249
8,604,10,100,1e-05,0.01,0.502,0.6043046357615894,301,303
8,704,10,100,1e-05,0.01,0.494,0.6122159090909091,346,358
8,804,10,100,1e-05,0.01,0.496,0.6281094527363185,395,409
8,904,10,100,1e-05,0.01,0.492,0.6316371681415929,439,465
8,1004,10,100,1e-05,0.01,0.502,0.6643426294820717,484,520
8,1104,10,100,1e-05,0.01,0.508,0.6295289855072463,531,573
8,1204,10,100,1e-05,0.01,0.478,0.6636212624584718,571,633
8,1304,10,100,1e-05,0.01,0.5,0.6503067484662577,619,685
8,1404,10,100,1e-05,0.01,0.518,0.6766381766381766,674,730
8,1504,10,100,1e-05,0.01,0.518,0.6788563829787234,724,780
8,1604,10,100,1e-05,0.01,0.526,0.7100997506234414,778,826
8,1704,10,100,1e-05,0.01,0.482,0.664906103286385,824,880
8,1804,10,100,1e-05,0.01,0.516,0.6984478935698448,874,930
8,1904,10,100,1e-05,0.01,0.518,0.7095588235294118,923,981
8,2004,10,100,1e-05,0.01,0.526,0.7135728542914171,969,1035
8,2104,10,100,1e-05,0.01,0.55,0.7281368821292775,1015,1089
8,2204,10,100,1e-05,0.01,0.55,0.76497277676951,1071,1133
8,2304,10,100,1e-05,0.01,0.562,0.765625,1132,1172
8,2404,10,100,1e-05,0.01,0.56,0.7778702163061564,1180,1224
8,2504,10,100,1e-05,0.01,0.604,0.7907348242811502,1231,1273
8,2604,10,100,1e-05,0.01,0.588,0.7761136712749616,1287,1317
8,2704,10,100,1e-05,0.01,0.588,0.7888313609467456,1334,1370
8,2804,10,100,1e-05,0.01,0.6,0.81169757489301,1390,1414
8,2904,10,100,1e-05,0.01,0.654,0.8522727272727273,1442,1462
8,3004,10,100,1e-05,0.01,0.616,0.8102529960053262,1499,1505
8,3104,10,100,1e-05,0.01,0.638,0.8134664948453608,1546,1558
8,3204,10,100,1e-05,0.01,0.638,0.8355181023720349,1581,1623
8,3304,10,100,1e-05,0.01,0.682,0.8574455205811138,1631,1673
8,3404,10,100,1e-05,0.01,0.684,0.881903642773208,1689,1715
8,3504,10,100,1e-05,0.01,0.694,0.8901255707762558,1733,1771
8,3604,10,100,1e-05,0.01,0.696,0.8862375138734739,1785,1819
8,3704,10,100,1e-05,0.01,0.684,0.9141468682505399,1844,1860
8,3804,10,100,1e-05,0.01,0.73,0.9334910620399579,1889,1915
8,3904,10,100,1e-05,0.01,0.716,0.9392930327868853,1941,1963
8,4004,10,100,1e-05,0.01,0.726,0.9330669330669331,1994,2010
8,4104,10,100,1e-05,0.01,0.742,0.9283625730994152,2043,2061
8,4204,10,100,1e-05,0.01,0.69,0.8784490960989534,2097,2107
8,4304,10,100,1e-05,0.01,0.7,0.8921933085501859,2149,2155
8,4404,10,100,1e-05,0.01,0.71,0.9230245231607629,2187,2217
8,4504,10,100,1e-05,0.01,0.752,0.9067495559502664,2245,2259
8,4604,10,100,1e-05,0.01,0.738,0.9291920069504779,2299,2305
8,4704,10,100,1e-05,0.01,0.79,0.9508928571428571,2346,2358
8,4804,10,100,1e-05,0.01,0.774,0.9573272273105745,2395,2409
8,4904,10,100,1e-05,0.01,0.786,0.958605220228385,2447,2457
8,5004,10,100,1e-05,0.01,0.802,0.9558353317346123,2503,2501
8,5104,10,100,1e-05,0.01,0.79,0.955525078369906,2553,2551
8,5204,10,100,1e-05,0.01,0.798,0.9667563412759416,2599,2605
8,5304,10,100,1e-05,0.01,0.814,0.9585218702865762,2650,2654
8,5404,10,100,1e-05,0.01,0.784,0.9452257586972613,2707,2697
8,5504,10,100,1e-05,0.01,0.78,0.9302325581395349,2752,2752
8,5604,10,100,1e-05,0.01,0.814,0.961456102783726,2803,2801
8,5704,10,100,1e-05,0.01,0.836,0.9694950911640954,2851,2853
8,5804,10,100,1e-05,0.01,0.806,0.9732942798070296,2897,2907
8,5904,10,100,1e-05,0.01,0.826,0.9757791327913279,2945,2959
8,6004,10,100,1e-05,0.01,0.84,0.9700199866755497,2992,3012
8,6104,10,100,1e-05,0.01,0.756,0.8917103538663171,3043,3061
8,6204,10,100,1e-05,0.01,0.8,0.9350419084461637,3088,3116
8,6304,10,100,1e-05,0.01,0.822,0.9519352791878173,3140,3164
8,6404,10,100,1e-05,0.01,0.83,0.9536227357901311,3187,3217
8,6504,10,100,1e-05,0.01,0.824,0.9718634686346863,3228,3276
8,6604,10,100,1e-05,0.01,0.826,0.9650211992731678,3279,3325
8,6704,10,100,1e-05,0.01,0.842,0.9750894988066826,3325,3379
8,6804,10,100,1e-05,0.01,0.838,0.9747207524985303,3380,3424
8,6904,10,100,1e-05,0.01,0.844,0.9763904982618772,3429,3475
8,7004,10,100,1e-05,0.01,0.864,0.980868075385494,3478,3526
8,7104,10,100,1e-05,0.01,0.86,0.9840934684684685,3521,3583
8,7204,10,100,1e-05,0.01,0.82,0.9242087729039422,3576,3628
8,7304,10,100,1e-05,0.01,0.772,0.8970427163198248,3627,3677
8,7404,10,100,1e-05,0.01,0.83,0.9573203673689897,3685,3719
8,7504,10,100,1e-05,0.01,0.844,0.9577558635394456,3735,3769
8,7604,10,100,1e-05,0.01,0.852,0.9671225670699631,3786,3818
8,7704,10,100,1e-05,0.01,0.868,0.9840342679127726,3831,3873
8,7804,10,100,1e-05,0.01,0.866,0.979625832906202,3880,3924
8,7904,10,100,1e-05,0.01,0.872,0.9798836032388664,3921,3983
8,8004,10,100,1e-05,0.01,0.872,0.9800099950024987,3971,4033
8,8104,10,100,1e-05,0.01,0.888,0.9887709772951628,4021,4083
8,8204,10,100,1e-05,0.01,0.886,0.9859824475865432,4067,4137
8,8304,10,100,1e-05,0.01,0.882,0.9815751445086706,4115,4189
8,8404,10,100,1e-05,0.01,0.86,0.97144217039505,4167,4237
8,8504,10,100,1e-05,0.01,0.886,0.9875352775164629,4213,4291
8,8604,10,100,1e-05,0.01,0.884,0.9881450488145049,4266,4338
8,8704,10,100,1e-05,0.01,0.876,0.9747242647058824,4313,4391
8,8804,10,100,1e-05,0.01,0.892,0.9784189004997729,4360,4444
8,8904,10,100,1e-05,0.01,0.894,0.9895552560646901,4403,4501
8,9004,10,100,1e-05,0.01,0.898,0.9928920479786761,4456,4548
8,9104,10,100,1e-05,0.01,0.896,0.9911028119507909,4511,4593
8,9204,10,100,1e-05,0.01,0.904,0.9920686657974793,4563,4641
8,9304,10,100,1e-05,0.01,0.914,0.9911865864144453,4611,4693
8,9404,10,100,1e-05,0.01,0.904,0.9827732879625691,4668,4736
8,9504,10,100,1e-05,0.01,0.898,0.9603324915824916,4726,4778
8,9604,10,100,1e-05,0.01,0.906,0.9703248646397334,4777,4827
8,9704,10,100,1e-05,0.01,0.914,0.9879431162407255,4828,4876
8,9804,10,100,1e-05,0.01,0.862,0.9342105263157895,4875,4929
8,9904,10,100,1e-05,0.01,0.882,0.9384087237479806,4931,4973
8,10004,10,100,1e-05,0.01,0.898,0.975109956017593,4984,5020
8,10104,10,100,1e-05,0.01,0.9,0.9817893903404592,5029,5075
8,10204,10,100,1e-05,0.01,0.922,0.9893179145433163,5077,5127
8,10304,10,100,1e-05,0.01,0.924,0.9911684782608695,5137,5167
8,10404,10,100,1e-05,0.01,0.932,0.9957708573625529,5192,5212
8,10504,10,100,1e-05,0.01,0.932,0.9929550647372429,5245,5259
8,10604,10,100,1e-05,0.01,0.954,0.993587325537533,5295,5309
8,10704,10,100,1e-05,0.01,0.938,0.9950485799701047,5352,5352
8,10804,10,100,1e-05,0.01,0.948,0.9978711588300629,5400,5404
8,10904,10,100,1e-05,0.01,0.942,0.9969735876742479,5462,5442
8,11004,10,100,1e-05,0.01,0.912,0.9785532533624137,5510,5494
8,11104,10,100,1e-05,0.01,0.92,0.9822586455331412,5562,5542
8,11204,10,100,1e-05,0.01,0.924,0.9844698322027847,5608,5596
8,11304,10,100,1e-05,0.01,0.94,0.986995753715499,5657,5647
8,11404,10,100,1e-05,0.01,0.932,0.9914942125569975,5706,5698
8,11504,10,100,1e-05,0.01,0.942,0.9944367176634215,5746,5758
8,11604,10,100,1e-05,0.01,0.948,0.9977593933126508,5801,5803
8,11704,10,100,1e-05,0.01,0.96,0.9975222146274778,5854,5850
8,11804,10,100,1e-05,0.01,0.962,0.9994916977295832,5903,5901
8,11904,10,100,1e-05,0.01,0.966,0.9977318548387096,5955,5949
8,12004,10,100,1e-05,0.01,0.966,0.9982505831389537,6010,5994
8,12104,10,100,1e-05,0.01,0.968,0.9966126900198281,6061,6043
8,12204,10,100,1e-05,0.01,0.952,0.9916420845624385,6112,6092
8,12304,10,100,1e-05,0.01,0.956,0.9917912873862159,6159,6145
8,12404,10,100,1e-05,0.01,0.95,0.9884714608190907,6215,6189
8,12504,10,100,1e-05,0.01,0.946,0.9853646833013435,6261,6243
8,12604,10,100,1e-05,0.01,0.958,0.9927007299270073,6317,6287
8,12704,10,100,1e-05,0.01,0.96,0.9964578085642317,6375,6329
8,12804,10,100,1e-05,0.01,0.96,0.9878163074039362,6421,6383
8,12904,10,100,1e-05,0.01,0.958,0.990778053316801,6467,6437
8,13004,10,100,1e-05,0.01,0.97,0.9970009227929868,6517,6487
8,13104,10,100,1e-05,0.01,0.972,0.9964133089133089,6568,6536
8,13204,10,100,1e-05,0.01,0.972,0.997122084216904,6618,6586
8,13304,10,100,1e-05,0.01,0.964,0.9936861094407697,6666,6638
8,13404,10,100,1e-05,0.01,0.964,0.995150701283199,6710,6694
8,13504,10,100,1e-05,0.01,0.97,0.996149289099526,6758,6746
8,13604,10,100,1e-05,0.01,0.966,0.9975007350779183,6808,6796
8,13704,10,100,1e-05,0.01,0.964,0.9967162872154116,6869,6835
8,13804,10,100,1e-05,0.01,0.972,0.995653433787308,6919,6885
8,13904,10,100,1e-05,0.01,0.962,0.99295166858458,6966,6938
8,14004,10,100,1e-05,0.01,0.974,0.9938588974578692,7014,6990
8,14104,10,100,1e-05,0.01,0.976,0.9975184344866704,7072,7032
8,14204,10,100,1e-05,0.01,0.98,0.9976767107856942,7119,7085
8,14304,10,100,1e-05,0.01,0.97,0.9976929530201343,7175,7129
8,14404,10,100,1e-05,0.01,0.982,0.9992363232435435,7228,7176
8,14504,10,100,1e-05,0.01,0.984,0.9996552675124104,7284,7220
8,14604,10,100,1e-05,0.01,0.984,0.9998630512188441,7324,7280
8,14704,10,100,1e-05,0.01,0.98,0.9977557127312296,7370,7334
8,14804,10,100,1e-05,0.01,0.962,0.9806808970548501,7414,7390
8,14904,10,100,1e-05,0.01,0.936,0.9782608695652174,7455,7449
8,15004,10,100,1e-05,0.01,0.964,0.9950013329778725,7507,7497
9,104,10,100,1e-05,0.01,0.48,0.49038461538461536,51,53
9,204,10,100,1e-05,0.01,0.49,0.6715686274509803,110,94
9,304,10,100,1e-05,0.01,0.516,0.5328947368421053,162,142
9,404,10,100,1e-05,0.01,0.486,0.5915841584158416,201,203
9,504,10,100,1e-05,0.01,0.488,0.5912698412698413,252,252
9,604,10,100,1e-05,0.01,0.488,0.6175496688741722,302,302
9,704,10,100,1e-05,0.01,0.484,0.6036931818181818,350,354
9,804,10,100,1e-05,0.01,0.484,0.6417910447761194,402,402
9,904,10,100,1e-05,0.01,0.49,0.6415929203539823,457,447
9,1004,10,100,1e-05,0.01,0.47,0.6942231075697212,510,494
9,1104,10,100,1e-05,0.01,0.484,0.6684782608695652,558,546
9,1204,10,100,1e-05,0.01,0.49,0.6636212624584718,609,595
9,1304,10,100,1e-05,0.01,0.522,0.6625766871165644,663,641
9,1404,10,100,1e-05,0.01,0.498,0.6695156695156695,711,693
9,1504,10,100,1e-05,0.01,0.494,0.6775265957446809,756,748
9,1604,10,100,1e-05,0.01,0.484,0.71571072319202,810,794
9,1704,10,100,1e-05,0.01,0.49,0.7083333333333334,859,845
9,1804,10,100,1e-05,0.01,0.51,0.7638580931263859,921,883
9,1904,10,100,1e-05,0.01,0.538,0.7510504201680672,967,937
9,2004,10,100,1e-05,0.01,0.532,0.7829341317365269,1019,985
9,2104,10,100,1e-05,0.01,0.534,0.7732889733840305,1074,1030
9,2204,10,100,1e-05,0.01,0.542,0.7826678765880217,1129,1075
9,2304,10,100,1e-05,0.01,0.558,0.7881944444444444,1182,1122
9,2404,10,100,1e-05,0.01,0.614,0.8386023294509152,1228,1176
9,2504,10,100,1e-05,0.01,0.608,0.8210862619808307,1279,1225
9,2604,10,100,1e-05,0.01,0.62,0.8475422427035331,1330,1274
9,2704,10,100,1e-05,0.01,0.644,0.8605769230769231,1385,1319
9,2804,10,100,1e-05,0.01,0.61,0.8430813124108416,1434,1370
9,2904,10,100,1e-05,0.01,0.658,0.878099173553719,1483,1421
9,3004,10,100,1e-05,0.01,0.65,0.8521970705725699,1533,1471
9,3104,10,100,1e-05,0.01,0.666,0.8547036082474226,1583,1521
9,3204,10,100,1e-05,0.01,0.68,0.8670411985018727,1625,1579
9,3304,10,100,1e-05,0.01,0.664,0.8719733656174334,1677,1627
9,3404,10,100,1e-05,0.01,0.718,0.8910105757931844,1733,1671
9,3504,10,100,1e-05,0.01,0.684,0.8715753424657534,1788,1716
9,3604,10,100,1e-05,0.01,0.72,0.8795782463928968,1834,1770
9,3704,10,100,1e-05,0.01,0.732,0.9014578833693304,1879,1825
9,3804,10,100,1e-05,0.01,0.728,0.9263932702418507,1931,1873
9,3904,10,100,1e-05,0.01,0.716,0.8939549180327869,1981,1923
9,4004,10,100,1e-05,0.01,0.762,0.9115884115884116,2047,1957
9,4104,10,100,1e-05,0.01,0.7,0.895224171539961,2097,2007
9,4204,10,100,1e-05,0.01,0.764,0.9267364414843007,2148,2056
9,4304,10,100,1e-05,0.01,0.77,0.9172862453531598,2196,2108
9,4404,10,100,1e-05,0.01,0.76,0.9277929155313351,2240,2164
9,4504,10,100,1e-05,0.01,0.778,0.9575932504440497,2294,2210
9,4604,10,100,1e-05,0.01,0.792,0.9535186794092094,2339,2265
9,4704,10,100,1e-05,0.01,0.786,0.9623724489795918,2388,2316
9,4804,10,100,1e-05,0.01,0.744,0.9171523730224813,2440,2364
9,4904,10,100,1e-05,0.01,0.778,0.9031402936378466,2493,2411
9,5004,10,100,1e-05,0.01,0.818,0.9386490807354116,2540,2464
9,5104,10,100,1e-05,0.01,0.806,0.9396551724137931,2597,2507
9,5204,10,100,1e-05,0.01,0.826,0.9627209838585703,2647,2557
9,5304,10,100,1e-05,0.01,0.842,0.970211161387632,2695,2609
9,5404,10,100,1e-05,0.01,0.82,0.9690969652109549,2744,2660
9,5504,10,100,1e-05,0.01,0.842,0.9613008720930233,2792,2712
9,5604,10,100,1e-05,0.01,0.842,0.9689507494646681,2846,2758
9,5704,10,100,1e-05,0.01,0.858,0.9784361851332398,2886,2818
9,5804,10,100,1e-05,0.01,0.852,0.976223294279807,2939,2865
9,5904,10,100,1e-05,0.01,0.878,0.9857723577235772,2993,2911
9,6004,10,100,1e-05,0.01,0.866,0.9866755496335776,3040,2964
9,6104,10,100,1e-05,0.01,0.876,0.9886959370904325,3101,3003
9,6204,10,100,1e-05,0.01,0.89,0.9729206963249516,3152,3052
9,6304,10,100,1e-05,0.01,0.858,0.9601840101522843,3201,3103
9,6404,10,100,1e-05,0.01,0.894,0.9707995003123048,3245,3159
9,6504,10,100,1e-05,0.01,0.882,0.9761685116851169,3299,3205
9,6604,10,100,1e-05,0.01,0.922,0.9910660205935796,3343,3261
9,6704,10,100,1e-05,0.01,0.908,0.9897076372315036,3393,3311
9,6804,10,100,1e-05,0.01,0.924,0.9955908289241623,3446,3358
9,6904,10,100,1e-05,0.01,0.928,0.988702201622248,3489,3415
9,7004,10,100,1e-05,0.01,0.884,0.9640205596801827,3539,3465
9,7104,10,100,1e-05,0.01,0.83,0.9141328828828829,3587,3517
9,7204,10,100,1e-05,0.01,0.92,0.9834813992226541,3633,3571
9,7304,10,100,1e-05,0.01,0.932,0.9908269441401971,3682,3622
9,7404,10,100,1e-05,0.01,0.94,0.9968935710426796,3718,3686
9,7504,10,100,1e-05,0.01,0.934,0.9976012793176973,3764,3740
9,7604,10,100,1e-05,0.01,0.942,0.9976328248290374,3819,3785
9,7704,10,100,1e-05,0.01,0.956,0.9957165109034268,3877,3827
9,7804,10,100,1e-05,0.01,0.936,0.9967965146078934,3921,3883
9,7904,10,100,1e-05,0.01,0.932,0.9843117408906883,3970,3934
9,8004,10,100,1e-05,0.01,0.926,0.9907546226886557,4020,3984
9,8104,10,100,1e-05,0.01,0.93,0.9913622902270484,4073,4031
9,8204,10,100,1e-05,0.01,0.948,0.9902486591906388,4125,4079
9,8304,10,100,1e-05,0.01,0.934,0.9867533718689788,4170,4134
9,8404,10,100,1e-05,0.01,0.872,0.9519276534983341,4217,4187
9,8504,10,100,1e-05,0.01,0.906,0.9504938852304797,4273,4231
9,8604,10,100,1e-05,0.01,0.936,0.9837284983728498,4325,4279
9,8704,10,100,1e-05,0.01,0.948,0.9903492647058824,4373,4331
9,8804,10,100,1e-05,0.01,0.944,0.9901181281235802,4418,4386
9,8904,10,100,1e-05,0.01,0.968,0.9866352201257862,4462,4442
9,9004,10,100,1e-05,0.01,0.954,0.9920035539760107,4511,4493
9,9104,10,100,1e-05,0.01,0.96,0.9970342706502636,4560,4544
9,9204,10,100,1e-05,0.01,0.966,0.9984789222077358,4609,4595
9,9304,10,100,1e-05,0.01,0.958,0.998280309544282,4656,4648
9,9404,10,100,1e-05,0.01,0.976,0.9994683113568694,4717,4687
9,9504,10,100,1e-05,0.01,0.972,0.9998947811447811,4770,4734
9,9604,10,100,1e-05,0.01,0.974,0.9991670137442732,4819,4785
9,9704,10,100,1e-05,0.01,0.97,0.9996908491343776,4869,4835
9,9804,10,100,1e-05,0.01,0.976,0.9992860057119543,4909,4895
9,9904,10,100,1e-05,0.01,0.972,0.9998990306946688,4969,4935
9,10004,10,100,1e-05,0.01,0.968,0.9986005597760895,5028,4976
9,10104,10,100,1e-05,0.01,0.966,0.9904988123515439,5087,5017
9,10204,10,100,1e-05,0.01,0.936,0.9681497451979616,5138,5066
9,10304,10,100,1e-05,0.01,0.958,0.9854425465838509,5183,5121
9,10404,10,100,1e-05,0.01,0.964,0.9937524029219531,5233,5171
9,10504,10,100,1e-05,0.01,0.97,0.9962871287128713,5280,5224
9,10604,10,100,1e-05,0.01,0.95,0.9933987174651076,5324,5280
9,10704,10,100,1e-05,0.01,0.968,0.9971038863976084,5375,5329
9,10804,10,100,1e-05,0.01,0.968,0.996945575712699,5415,5389
9,10904,10,100,1e-05,0.01,0.96,0.9856933235509905,5464,5440
9,11004,10,100,1e-05,0.01,0.98,0.997364594692839,5516,5488
9,11104,10,100,1e-05,0.01,0.974,0.9988292507204611,5566,5538
9,11204,10,100,1e-05,0.01,0.974,0.9955373081042485,5626,5578
9,11304,10,100,1e-05,0.01,0.974,0.9952229299363057,5679,5625
9,11404,10,100,1e-05,0.01,0.96,0.98105927744651,5728,5676
9,11504,10,100,1e-05,0.01,0.972,0.9958275382475661,5771,5733
9,11604,10,100,1e-05,0.01,0.976,0.9991382281971734,5813,5791
9,11704,10,100,1e-05,0.01,0.982,0.9994019138755981,5860,5844
9,11804,10,100,1e-05,0.01,0.976,0.9990681125042359,5911,5893
9,11904,10,100,1e-05,0.01,0.978,0.9989079301075269,5961,5943
9,12004,10,100,1e-05,0.01,0.978,0.998750416527824,6013,5991
9,12104,10,100,1e-05,0.01,0.976,0.9985955056179775,6067,6037
9,12204,10,100,1e-05,0.01,0.978,0.9993444772205834,6120,6084
9,12304,10,100,1e-05,0.01,0.968,0.9942295188556567,6173,6131
9,12404,10,100,1e-05,0.01,0.95,0.9742018703643985,6226,6178
9,12504,10,100,1e-05,0.01,0.972,0.9868841970569417,6268,6236
9,12604,10,100,1e-05,0.01,0.98,0.9957949857188194,6322,6282
9,12704,10,100,1e-05,0.01,0.982,0.9977172544080605,6369,6335
9,12804,10,100,1e-05,0.01,0.982,0.9982817869415808,6415,6389
9,12904,10,100,1e-05,0.01,0.984,0.999922504649721,6471,6433
9,13004,10,100,1e-05,0.01,0.986,0.9986927099354045,6520,6484
9,13104,10,100,1e-05,0.01,0.976,0.9955738705738706,6565,6539
9,13204,10,100,1e-05,0.01,0.98,0.9967434110875493,6610,6594
9,13304,10,100,1e-05,0.01,0.982,0.9987973541791942,6654,6650
9,13404,10,100,1e-05,0.01,0.982,0.999179349447926,6699,6705
9,13504,10,100,1e-05,0.01,0.986,0.9992594786729858,6748,6756
9,13604,10,100,1e-05,0.01,0.98,0.9992649220817407,6794,6810
9,13704,10,100,1e-05,0.01,0.966,0.9867192060712201,6845,6859
9,13804,10,100,1e-05,0.01,0.954,0.9721819762387713,6898,6906
9,13904,10,100,1e-05,0.01,0.966,0.9887802071346375,6954,6950
9,14004,10,100,1e-05,0.01,0.982,0.99842902027992,7002,7002
9,14104,10,100,1e-05,0.01,0.982,0.9990782756664776,7051,7053
9,14204,10,100,1e-05,0.01,0.982,0.9994367783722895,7103,7101
9,14304,10,100,1e-05,0.01,0.982,0.9998601789709173,7157,7147
9,14404,10,100,1e-05,0.01,0.978,0.9998611496806442,7207,7197
9,14504,10,100,1e-05,0.01,0.978,0.9999310535024821,7261,7243
9,14604,10,100,1e-05,0.01,0.982,1.0,7306,7298
9,14704,10,100,1e-05,0.01,0.974,0.997075625680087,7354,7350
9,14804,10,100,1e-05,0.01,0.976,0.9963523372061605,7405,7399
9,14904,10,100,1e-05,0.01,0.978,0.9973161567364466,7462,7442
9,15004,10,100,1e-05,0.01,0.98,0.9984004265529193,7512,7492
10,104,10,100,1e-05,0.01,0.48,0.5096153846153846,51,53
10,204,10,100,1e-05,0.01,0.52,0.6029411764705882,102,102
10,304,10,100,1e-05,0.01,0.518,0.5098684210526315,153,151
10,404,10,100,1e-05,0.01,0.5,0.6089108910891089,209,195
10,504,10,100,1e-05,0.01,0.496,0.5674603174603174,257,247
10,604,10,100,1e-05,0.01,0.508,0.5993377483443708,302,302
10,704,10,100,1e-05,0.01,0.53,0.6207386363636364,358,346
10,804,10,100,1e-05,0.01,0.552,0.6305970149253731,411,393
10,904,10,100,1e-05,0.01,0.558,0.6537610619469026,455,449
10,1004,10,100,1e-05,0.01,0.544,0.6553784860557769,503,501
10,1104,10,100,1e-05,0.01,0.542,0.6385869565217391,553,551
10,1204,10,100,1e-05,0.01,0.542,0.6636212624584718,607,597
10,1304,10,100,1e-05,0.01,0.524,0.6656441717791411,657,647
10,1404,10,100,1e-05,0.01,0.514,0.7065527065527065,704,700
10,1504,10,100,1e-05,0.01,0.51,0.7054521276595744,752,752
10,1604,10,100,1e-05,0.01,0.53,0.7138403990024937,805,799
10,1704,10,100,1e-05,0.01,0.506,0.7071596244131455,855,849
10,1804,10,100,1e-05,0.01,0.526,0.7527716186252772,908,896
10,1904,10,100,1e-05,0.01,0.53,0.7195378151260504,959,945
10,2004,10,100,1e-05,0.01,0.512,0.6996007984031936,1006,998
10,2104,10,100,1e-05,0.01,0.516,0.7381178707224335,1051,1053
10,2204,10,100,1e-05,0.01,0.538,0.7803992740471869,1100,1104
10,2304,10,100,1e-05,0.01,0.556,0.7526041666666666,1144,1160
10,2404,10,100,1e-05,0.01,0.524,0.7899334442595674,1198,1206
10,2504,10,100,1e-05,0.01,0.53,0.7615814696485623,1250,1254
10,2604,10,100,1e-05,0.01,0.528,0.7734254992319508,1294,1310
10,2704,10,100,1e-05,0.01,0.558,0.7814349112426036,1351,1353
10,2804,10,100,1e-05,0.01,0.536,0.7952924393723253,1402,1402
10,2904,10,100,1e-05,0.01,0.504,0.7820247933884298,1461,1443
10,3004,10,100,1e-05,0.01,0.538,0.7936085219707057,1507,1497
10,3104,10,100,1e-05,0.01,0.538,0.8073453608247423,1568,1536
10,3204,10,100,1e-05,0.01,0.556,0.8264669163545568,1616,1588
10,3304,10,100,1e-05,0.01,0.542,0.8389830508474576,1664,1640
10,3404,10,100,1e-05,0.01,0.554,0.8396004700352526,1716,1688
10,3504,10,100,1e-05,0.01,0.538,0.8207762557077626,1770,1734
10,3604,10,100,1e-05,0.01,0.56,0.8493340732519423,1826,1778
10,3704,10,100,1e-05,0.01,0.566,0.8412526997840173,1878,1826
10,3804,10,100,1e-05,0.01,0.56,0.8519978969505784,1931,1873
10,3904,10,100,1e-05,0.01,0.578,0.8660348360655737,1982,1922
10,4004,10,100,1e-05,0.01,0.598,0.8658841158841158,2033,1971
10,4104,10,100,1e-05,0.01,0.59,0.8584307992202729,2081,2023
10,4204,10,100,1e-05,0.01,0.596,0.8720266412940058,2127,2077
10,4304,10,100,1e-05,0.01,0.554,0.8371282527881041,2168,2136
10,4404,10,100,1e-05,0.01,0.576,0.879654859218892,2208,2196
10,4504,10,100,1e-05,0.01,0.594,0.8674511545293073,2260,2244
10,4604,10,100,1e-05,0.01,0.622,0.8829278887923545,2307,2297
10,4704,10,100,1e-05,0.01,0.666,0.9032738095238095,2358,2346
10,4804,10,100,1e-05,0.01,0.636,0.9090341382181515,2410,2394
10,4904,10,100,1e-05,0.01,0.672,0.9153752039151712,2461,2443
10,5004,10,100,1e-05,0.01,0.666,0.912669864108713,2522,2482
10,5104,10,100,1e-05,0.01,0.656,0.917319749216301,2568,2536
10,5204,10,100,1e-05,0.01,0.652,0.9091083781706379,2612,2592
10,5304,10,100,1e-05,0.01,0.7,0.8953619909502263,2669,2635
10,5404,10,100,1e-05,0.01,0.71,0.9257957068837898,2721,2683
10,5504,10,100,1e-05,0.01,0.722,0.926780523255814,2768,2736
10,5604,10,100,1e-05,0.01,0.706,0.9052462526766595,2817,2787
10,5704,10,100,1e-05,0.01,0.708,0.9167251051893408,2867,2837
10,5804,10,100,1e-05,0.01,0.726,0.9350447966919366,2911,2893
10,5904,10,100,1e-05,0.01,0.752,0.9324186991869918,2952,2952
10,6004,10,100,1e-05,0.01,0.75,0.9333777481678881,2995,3009
10,6104,10,100,1e-05,0.01,0.728,0.9184141546526867,3043,3061
10,6204,10,100,1e-05,0.01,0.74,0.9314958091553837,3097,3107
10,6304,10,100,1e-05,0.01,0.74,0.9379758883248731,3144,3160
10,6404,10,100,1e-05,0.01,0.784,0.9601811367895066,3196,3208
10,6504,10,100,1e-05,0.01,0.788,0.9494157441574416,3246,3258
10,6604,10,100,1e-05,0.01,0.808,0.9591156874621442,3280,3324
10,6704,10,100,1e-05,0.01,0.79,0.9713603818615751,3322,3382
10,6804,10,100,1e-05,0.01,0.8,0.9623750734861846,3377,3427
10,6904,10,100,1e-05,0.01,0.78,0.9719003476245655,3427,3477
10,7004,10,100,1e-05,0.01,0.816,0.9670188463735009,3470,3534
10,7104,10,100,1e-05,0.01,0.794,0.9617117117117117,3521,3583
10,7204,10,100,1e-05,0.01,0.794,0.9601610216546363,3562,3642
10,7304,10,100,1e-05,0.01,0.794,0.9735761226725083,3617,3687
10,7404,10,100,1e-05,0.01,0.808,0.9594813614262561,3663,3741
10,7504,10,100,1e-05,0.01,0.754,0.9021855010660981,3714,3790
10,7604,10,100,1e-05,0.01,0.806,0.9441083640189374,3770,3834
10,7704,10,100,1e-05,0.01,0.806,0.9570353063343717,3817,3887
10,7804,10,100,1e-05,0.01,0.802,0.9601486417221937,3867,3937
10,7904,10,100,1e-05,0.01,0.796,0.9335779352226721,3922,3982
10,8004,10,100,1e-05,0.01,0.808,0.9556471764117941,3973,4031
10,8104,10,100,1e-05,0.01,0.816,0.9724827245804541,4023,4081
10,8204,10,100,1e-05,0.01,0.85,0.9791565090199903,4068,4136
10,8304,10,100,1e-05,0.01,0.842,0.9736271676300579,4124,4180
10,8404,10,100,1e-05,0.01,0.82,0.9741789623988577,4168,4236
10,8504,10,100,1e-05,0.01,0.846,0.9791862652869238,4212,4292
10,8604,10,100,1e-05,0.01,0.858,0.9850069735006973,4261,4343
10,8704,10,100,1e-05,0.01,0.868,0.9859834558823529,4302,4402
10,8804,10,100,1e-05,0.01,0.86,0.9852339845524761,4347,4457
10,8904,10,100,1e-05,0.01,0.872,0.9876460017969452,4400,4504
10,9004,10,100,1e-05,0.01,0.842,0.9582407818747224,4445,4559
10,9104,10,100,1e-05,0.01,0.85,0.9313488576449912,4497,4607
10,9204,10,100,1e-05,0.01,0.85,0.9621903520208605,4545,4659
10,9304,10,100,1e-05,0.01,0.85,0.9695829750644884,4595,4709
10,9404,10,100,1e-05,0.01,0.886,0.9843683538919609,4647,4757
10,9504,10,100,1e-05,0.01,0.896,0.9892676767676768,4705,4799
10,9604,10,100,1e-05,0.01,0.896,0.9943773427738443,4747,4857
10,9704,10,100,1e-05,0.01,0.89,0.9877370156636439,4802,4902
10,9804,10,100,1e-05,0.01,0.874,0.9777641778865769,4849,4955
10,9904,10,100,1e-05,0.01,0.884,0.9644588045234249,4900,5004
10,10004,10,100,1e-05,0.01,0.916,0.9857057177129148,4951,5053
10,10104,10,100,1e-05,0.01,0.906,0.9910926365795725,4999,5105
10,10204,10,100,1e-05,0.01,0.922,0.9925519404155233,5053,5151
10,10304,10,100,1e-05,0.01,0.912,0.9919448757763976,5108,5196
10,10404,10,100,1e-05,0.01,0.92,0.9879853902345251,5154,5250
10,10504,10,100,1e-05,0.01,0.912,0.992003046458492,5208,5296
10,10604,10,100,1e-05,0.01,0.916,0.9855714824594493,5254,5350
10,10704,10,100,1e-05,0.01,0.908,0.98402466367713,5307,5397
10,10804,10,100,1e-05,0.01,0.922,0.9925953350610884,5352,5452
10,10904,10,100,1e-05,0.01,0.932,0.9944974321349963,5415,5489
10,11004,10,100,1e-05,0.01,0.94,0.9958197019265722,5460,5544
10,11104,10,100,1e-05,0.01,0.932,0.9940561959654178,5515,5589
10,11204,10,100,1e-05,0.01,0.942,0.9935737236701179,5563,5641
10,11304,10,100,1e-05,0.01,0.914,0.9835456475583864,5617,5687
10,11404,10,100,1e-05,0.01,0.918,0.9785163100666433,5667,5737
10,11504,10,100,1e-05,0.01,0.938,0.9891342141863699,5725,5779
10,11604,10,100,1e-05,0.01,0.948,0.9916408135125818,5767,5837
10,11704,10,100,1e-05,0.01,0.934,0.9897470950102529,5822,5882
10,11804,10,100,1e-05,0.01,0.948,0.993307353439512,5870,5934
10,11904,10,100,1e-05,0.01,0.956,0.9987399193548387,5928,5976
10,12004,10,100,1e-05,0.01,0.954,0.9993335554815062,5977,6027
10,12104,10,100,1e-05,0.01,0.942,0.9905816259087905,6023,6081
10,12204,10,100,1e-05,0.01,0.95,0.9959849229760734,6074,6130
10,12304,10,100,1e-05,0.01,0.95,0.9935793237971391,6123,6181
10,12404,10,100,1e-05,0.01,0.946,0.9936310867462109,6173,6231
10,12504,10,100,1e-05,0.01,0.956,0.9955214331413947,6234,6270
10,12604,10,100,1e-05,0.01,0.956,0.9950809266899397,6281,6323
10,12704,10,100,1e-05,0.01,0.944,0.9905541561712846,6329,6375
10,12804,10,100,1e-05,0.01,0.952,0.9928147453920649,6384,6420
10,12904,10,100,1e-05,0.01,0.948,0.9818660880347179,6433,6471
10,13004,10,100,1e-05,0.01,0.956,0.9941556444171025,6483,6521
10,13104,10,100,1e-05,0.01,0.968,0.9948107448107448,6533,6571
10,13204,10,100,1e-05,0.01,0.956,0.9962890033323235,6585,6619
10,13304,10,100,1e-05,0.01,0.96,0.9947384245339748,6635,6669
10,13404,10,100,1e-05,0.01,0.964,0.997612652939421,6679,6725
10,13504,10,100,1e-05,0.01,0.964,0.9965195497630331,6729,6775
10,13604,10,100,1e-05,0.01,0.964,0.9976477506615701,6777,6827
10,13704,10,100,1e-05,0.01,0.962,0.9975919439579685,6825,6879
10,13804,10,100,1e-05,0.01,0.958,0.9904375543320777,6869,6935
10,13904,10,100,1e-05,0.01,0.972,0.9931674338319908,6919,6985
10,14004,10,100,1e-05,0.01,0.954,0.9930734075978291,6973,7031
10,14104,10,100,1e-05,0.01,0.956,0.9972348269994328,7021,7083
10,14204,10,100,1e-05,0.01,0.962,0.994719797240214,7071,7133
10,14304,10,100,1e-05,0.01,0.966,0.9964345637583892,7127,7177
10,14404,10,100,1e-05,0.01,0.958,0.9931269091918912,7185,7219
10,14504,10,100,1e-05,0.01,0.964,0.9931053502482073,7243,7261
10,14604,10,100,1e-05,0.01,0.962,0.9897973158038893,7293,7311
10,14704,10,100,1e-05,0.01,0.968,0.9981637649619152,7336,7368
10,14804,10,100,1e-05,0.01,0.97,0.9981086192920832,7387,7417
10,14904,10,100,1e-05,0.01,0.962,0.9905394524959742,7441,7463
10,15004,10,100,1e-05,0.01,0.968,0.9878699013596375,7492,7512
11,104,10,100,1e-05,0.01,0.5,0.5673076923076923,48,56
11,204,10,100,1e-05,0.01,0.498,0.6323529411764706,98,106
11,304,10,100,1e-05,0.01,0.49,0.6381578947368421,144,160
11,404,10,100,1e-05,0.01,0.51,0.6608910891089109,195,209
11,504,10,100,1e-05,0.01,0.492,0.6428571428571429,256,248
11,604,10,100,1e-05,0.01,0.512,0.6125827814569537,314,290
11,704,10,100,1e-05,0.01,0.504,0.6377840909090909,364,340
11,804,10,100,1e-05,0.01,0.492,0.6666666666666666,422,382
11,904,10,100,1e-05,0.01,0.534,0.6393805309734514,468,436
11,1004,10,100,1e-05,0.01,0.526,0.6613545816733067,516,488
11,1104,10,100,1e-05,0.01,0.508,0.6748188405797102,569,535
11,1204,10,100,1e-05,0.01,0.496,0.6976744186046512,630,574
11,1304,10,100,1e-05,0.01,0.506,0.7078220858895705,683,621
11,1404,10,100,1e-05,0.01,0.51,0.7143874643874644,727,677
11,1504,10,100,1e-05,0.01,0.5,0.7360372340425532,771,733
11,1604,10,100,1e-05,0.01,0.532,0.7387780548628429,819,785
11,1704,10,100,1e-05,0.01,0.532,0.7153755868544601,861,843
11,1804,10,100,1e-05,0.01,0.51,0.741130820399113,908,896
11,1904,10,100,1e-05,0.01,0.546,0.7668067226890757,954,950
11,2004,10,100,1e-05,0.01,0.502,0.7879241516966068,990,1014
11,2104,10,100,1e-05,0.01,0.516,0.7642585551330798,1032,1072
11,2204,10,100,1e-05,0.01,0.546,0.8003629764065335,1078,1126
11,2304,10,100,1e-05,0.01,0.558,0.7938368055555556,1130,1174
11,2404,10,100,1e-05,0.01,0.522,0.7778702163061564,1173,1231
11,2504,10,100,1e-05,0.01,0.584,0.8206869009584664,1225,1279
11,2604,10,100,1e-05,0.01,0.614,0.8467741935483871,1268,1336
11,2704,10,100,1e-05,0.01,0.626,0.8520710059171598,1324,1380
11,2804,10,100,1e-05,0.01,0.644,0.8776747503566333,1382,1422
11,2904,10,100,1e-05,0.01,0.642,0.8736225895316805,1429,1475
11,3004,10,100,1e-05,0.01,0.68,0.9144474034620506,1475,1529
11,3104,10,100,1e-05,0.01,0.732,0.9420103092783505,1525,1579
11,3204,10,100,1e-05,0.01,0.698,0.9272784019975031,1585,1619
11,3304,10,100,1e-05,0.01,0.696,0.8689467312348669,1633,1671
11,3404,10,100,1e-05,0.01,0.734,0.9253819036427732,1675,1729
11,3504,10,100,1e-05,0.01,0.75,0.9235159817351598,1722,1782
11,3604,10,100,1e-05,0.01,0.754,0.9281354051054383,1768,1836
11,3704,10,100,1e-05,0.01,0.788,0.9397948164146869,1822,1882
11,3804,10,100,1e-05,0.01,0.81,0.9584647739221872,1869,1935
11,3904,10,100,1e-05,0.01,0.828,0.9577356557377049,1917,1987
11,4004,10,100,1e-05,0.01,0.816,0.9637862137862138,1963,2041
11,4104,10,100,1e-05,0.01,0.838,0.9741715399610137,2025,2079
11,4204,10,100,1e-05,0.01,0.862,0.9826355851569933,2068,2136
11,4304,10,100,1e-05,0.01,0.866,0.9862918215613383,2109,2195
11,4404,10,100,1e-05,0.01,0.858,0.9838782924613987,2164,2240
11,4504,10,100,1e-05,0.01,0.874,0.9933392539964476,2216,2288
11,4604,10,100,1e-05,0.01,0.874,0.991094700260643,2263,2341
11,4704,10,100,1e-05,0.01,0.902,0.9927721088435374,2312,2392
11,4804,10,100,1e-05,0.01,0.898,0.9977102414654455,2363,2441
11,4904,10,100,1e-05,0.01,0.894,0.9957177814029364,2405,2499
11,5004,10,100,1e-05,0.01,0.902,0.996203037569944,2454,2550
11,5104,10,100,1e-05,0.01,0.892,0.9952978056426333,2504,2600
11,5204,10,100,1e-05,0.01,0.892,0.9746348962336664,2561,2643
11,5304,10,100,1e-05,0.01,0.892,0.9751131221719457,2612,2692
11,5404,10,100,1e-05,0.01,0.912,0.9833456698741673,2665,2739
11,5504,10,100,1e-05,0.01,0.918,0.9883720930232558,2710,2794
11,5604,10,100,1e-05,0.01,0.914,0.9921484653818701,2762,2842
11,5704,10,100,1e-05,0.01,0.9,0.9712482468443198,2810,2894
11,5804,10,100,1e-05,0.01,0.896,0.9722605099931082,2861,2943
11,5904,10,100,1e-05,0.01,0.924,0.9933943089430894,2911,2993
11,6004,10,100,1e-05,0.01,0.934,0.9851765489673551,2957,3047
11,6104,10,100,1e-05,0.01,0.936,0.992300131061599,3014,3090
11,6204,10,100,1e-05,0.01,0.944,0.9813023855577047,3061,3143
11,6304,10,100,1e-05,0.01,0.938,0.9936548223350253,3121,3183
11,6404,10,100,1e-05,0.01,0.942,0.9943785134291068,3170,3234
11,6504,10,100,1e-05,0.01,0.946,0.9923124231242313,3227,3277
11,6604,10,100,1e-05,0.01,0.946,0.9948516050878256,3282,3322
11,6704,10,100,1e-05,0.01,0.948,0.9850835322195705,3332,3372
11,6804,10,100,1e-05,0.01,0.942,0.9901528512639624,3374,3430
11,6904,10,100,1e-05,0.01,0.946,0.9913093858632677,3415,3489
11,7004,10,100,1e-05,0.01,0.94,0.9885779554540263,3462,3542
11,7104,10,100,1e-05,0.01,0.952,0.9971846846846847,3517,3587
11,7204,10,100,1e-05,0.01,0.952,0.9966685174902832,3573,3631
11,7304,10,100,1e-05,0.01,0.958,0.9960295728368017,3621,3683
11,7404,10,100,1e-05,0.01,0.956,0.9941923284710967,3672,3732
11,7504,10,100,1e-05,0.01,0.962,0.9976012793176973,3722,3782
11,7604,10,100,1e-05,0.01,0.962,0.9917148869016307,3769,3835
11,7704,10,100,1e-05,0.01,0.964,0.9931204569055037,3819,3885
11,7804,10,100,1e-05,0.01,0.95,0.990773962070733,3869,3935
11,7904,10,100,1e-05,0.01,0.952,0.9911437246963563,3918,3986
11,8004,10,100,1e-05,0.01,0.942,0.9763868065967016,3960,4044
11,8104,10,100,1e-05,0.01,0.956,0.9890177690029615,4009,4095
11,8204,10,100,1e-05,0.01,0.958,0.9953681131155534,4052,4152
11,8304,10,100,1e-05,0.01,0.972,0.9950626204238922,4109,4195
11,8404,10,100,1e-05,0.01,0.956,0.9969062351261304,4160,4244
11,8504,10,100,1e-05,0.01,0.962,0.9967074317968015,4203,4301
11,8604,10,100,1e-05,0.01,0.968,0.9945374244537425,4259,4345
11,8704,10,100,1e-05,0.01,0.972,0.9966681985294118,4320,4384
11,8804,10,100,1e-05,0.01,0.946,0.9839845524761472,4367,4437
11,8904,10,100,1e-05,0.01,0.95,0.984052111410602,4412,4492
11,9004,10,100,1e-05,0.01,0.962,0.9907818747223456,4455,4549
11,9104,10,100,1e-05,0.01,0.968,0.9947275922671354,4506,4598
11,9204,10,100,1e-05,0.01,0.964,0.9926119078661452,4551,4653
11,9304,10,100,1e-05,0.01,0.958,0.9938736027515047,4602,4702
11,9404,10,100,1e-05,0.01,0.966,0.9945767758400681,4654,4750
11,9504,10,100,1e-05,0.01,0.968,0.9955808080808081,4697,4807
11,9604,10,100,1e-05,0.01,0.972,0.9967721782590587,4746,4858
11,9704,10,100,1e-05,0.01,0.97,0.9979389942291839,4797,4907
11,9804,10,100,1e-05,0.01,0.964,0.9900040799673603,4848,4956
11,9904,10,100,1e-05,0.01,0.97,0.9978796445880452,4904,5000
11,10004,10,100,1e-05,0.01,0.974,0.9968012794882047,4954,5050
11,10104,10,100,1e-05,0.01,0.978,0.996437054631829,5013,5091
11,10204,10,100,1e-05,0.01,0.972,0.9961779694237554,5062,5142
11,10304,10,100,1e-05,0.01,0.974,0.9963121118012422,5100,5204
11,10404,10,100,1e-05,0.01,0.972,0.996635909265667,5151,5253
11,10504,10,100,1e-05,0.01,0.968,0.9963823305407464,5207,5297
11,10604,10,100,1e-05,0.01,0.968,0.9964164466239155,5252,5352
11,10704,10,100,1e-05,0.01,0.974,0.9931801195814649,5305,5399
11,10804,10,100,1e-05,0.01,0.966,0.9962051092188079,5363,5441
11,10904,10,100,1e-05,0.01,0.97,0.9977989728539985,5421,5483
11,11004,10,100,1e-05,0.01,0.978,0.9986368593238822,5480,5524
11,11104,10,100,1e-05,0.01,0.98,0.9994596541786743,5533,5571
11,11204,10,100,1e-05,0.01,0.976,0.9978579078900393,5587,5617
11,11304,10,100,1e-05,0.01,0.968,0.9902689313517339,5644,5660
11,11404,10,100,1e-05,0.01,0.97,0.9931602946334619,5698,5706
11,11504,10,100,1e-05,0.01,0.978,0.9973052851182197,5747,5757
11,11604,10,100,1e-05,0.01,0.97,0.9955187866253016,5799,5805
11,11704,10,100,1e-05,0.01,0.966,0.9916267942583732,5856,5848
11,11804,10,100,1e-05,0.01,0.976,0.9925449000338868,5902,5902
11,11904,10,100,1e-05,0.01,0.98,0.9942036290322581,5950,5954
11,12004,10,100,1e-05,0.01,0.974,0.9971676107964011,5994,6010
11,12104,10,100,1e-05,0.01,0.978,0.9989259748843358,6039,6065
11,12204,10,100,1e-05,0.01,0.98,0.9980334316617503,6096,6108
11,12304,10,100,1e-05,0.01,0.974,0.9968302990897269,6151,6153
11,12404,10,100,1e-05,0.01,0.98,0.9963721380199936,6200,6204
11,12504,10,100,1e-05,0.01,0.978,0.9962412028150992,6241,6263
11,12604,10,100,1e-05,0.01,0.978,0.9948429070136464,6292,6312
11,12704,10,100,1e-05,0.01,0.964,0.9881139798488665,6334,6370
11,12804,10,100,1e-05,0.01,0.974,0.9928928459856294,6378,6426
11,12904,10,100,1e-05,0.01,0.974,0.9973651580905145,6424,6480
11,13004,10,100,1e-05,0.01,0.98,0.9966164257151645,6479,6525
11,13104,10,100,1e-05,0.01,0.98,0.9975579975579976,6529,6575
11,13204,10,100,1e-05,0.01,0.974,0.9952287185701303,6580,6624
11,13304,10,100,1e-05,0.01,0.986,0.9976698737221888,6630,6674
11,13404,10,100,1e-05,0.01,0.98,0.9984333034914951,6680,6724
11,13504,10,100,1e-05,0.01,0.986,0.9994075829383886,6736,6768
11,13604,10,100,1e-05,0.01,0.99,0.9989708909144369,6780,6824
11,13704,10,100,1e-05,0.01,0.988,0.9996351430239346,6828,6876
11,13804,10,100,1e-05,0.01,0.992,0.9997826716893654,6878,6926
11,13904,10,100,1e-05,0.01,0.99,1.0,6923,6981
11,14004,10,100,1e-05,0.01,0.988,1.0,6976,7028
11,14104,10,100,1e-05,0.01,0.99,0.9996454906409529,7026,7078
11,14204,10,100,1e-05,0.01,0.984,0.9968318783441285,7077,7127
11,14304,10,100,1e-05,0.01,0.98,0.9911213646532439,7133,7171
11,14404,10,100,1e-05,0.01,0.986,0.9941682865870591,7181,7223
11,14504,10,100,1e-05,0.01,0.984,0.997104247104247,7239,7265
11,14604,10,100,1e-05,0.01,0.984,0.9984250890167078,7285,7319
11,14704,10,100,1e-05,0.01,0.992,0.9993199129488575,7343,7361
11,14804,10,100,1e-05,0.01,0.986,0.9996622534450149,7398,7406
11,14904,10,100,1e-05,0.01,0.99,1.0,7443,7461
11,15004,10,100,1e-05,0.01,0.986,0.9998667022127433,7499,7505
12,104,10,100,1e-05,0.01,0.518,0.5961538461538461,47,57
12,204,10,100,1e-05,0.01,0.468,0.5588235294117647,102,102
12,304,10,100,1e-05,0.01,0.45,0.5953947368421053,158,146
12,404,10,100,1e-05,0.01,0.502,0.6113861386138614,206,198
12,504,10,100,1e-05,0.01,0.532,0.5753968253968254,257,247
12,604,10,100,1e-05,0.01,0.478,0.6506622516556292,316,288
12,704,10,100,1e-05,0.01,0.452,0.6235795454545454,363,341
12,804,10,100,1e-05,0.01,0.448,0.6455223880597015,403,401
12,904,10,100,1e-05,0.01,0.468,0.6515486725663717,451,453
12,1004,10,100,1e-05,0.01,0.484,0.6683266932270916,499,505
12,1104,10,100,1e-05,0.01,0.464,0.6757246376811594,549,555
12,1204,10,100,1e-05,0.01,0.476,0.6910299003322259,600,604
12,1304,10,100,1e-05,0.01,0.456,0.7055214723926381,646,658
12,1404,10,100,1e-05,0.01,0.488,0.7200854700854701,696,708
12,1504,10,100,1e-05,0.01,0.484,0.7027925531914894,755,749
12,1604,10,100,1e-05,0.01,0.512,0.7057356608478803,806,798
12,1704,10,100,1e-05,0.01,0.48,0.7153755868544601,849,855
12,1804,10,100,1e-05,0.01,0.504,0.7272727272727273,901,903
12,1904,10,100,1e-05,0.01,0.534,0.7510504201680672,946,958
12,2004,10,100,1e-05,0.01,0.534,0.782435129740519,990,1014
12,2104,10,100,1e-05,0.01,0.552,0.7880228136882129,1038,1066
12,2204,10,100,1e-05,0.01,0.568,0.808529945553539,1081,1123
12,2304,10,100,1e-05,0.01,0.59,0.7886284722222222,1129,1175
12,2404,10,100,1e-05,0.01,0.568,0.8103161397670549,1178,1226
12,2504,10,100,1e-05,0.01,0.574,0.8174920127795527,1234,1270
12,2604,10,100,1e-05,0.01,0.642,0.8421658986175116,1291,1313
12,2704,10,100,1e-05,0.01,0.626,0.8502218934911243,1341,1363
12,2804,10,100,1e-05,0.01,0.644,0.8783880171184023,1391,1413
12,2904,10,100,1e-05,0.01,0.65,0.8863636363636364,1446,1458
12,3004,10,100,1e-05,0.01,0.65,0.9214380825565912,1501,1503
12,3104,10,100,1e-05,0.01,0.678,0.9336340206185567,1542,1562
12,3204,10,100,1e-05,0.01,0.704,0.9406991260923845,1593,1611
12,3304,10,100,1e-05,0.01,0.73,0.9491525423728814,1653,1651
12,3404,10,100,1e-05,0.01,0.7,0.9374265569917744,1710,1694
12,3504,10,100,1e-05,0.01,0.726,0.952054794520548,1765,1739
12,3604,10,100,1e-05,0.01,0.746,0.9445061043285239,1808,1796
12,3704,10,100,1e-05,0.01,0.744,0.9592332613390929,1856,1848
12,3804,10,100,1e-05,0.01,0.776,0.9461093585699264,1899,1905
12,3904,10,100,1e-05,0.01,0.798,0.9746413934426229,1939,1965
12,4004,10,100,1e-05,0.01,0.776,0.972027972027972,1990,2014
12,4104,10,100,1e-05,0.01,0.828,0.9734405458089669,2032,2072
12,4204,10,100,1e-05,0.01,0.832,0.9769267364414843,2078,2126
12,4304,10,100,1e-05,0.01,0.832,0.9725836431226765,2129,2175
12,4404,10,100,1e-05,0.01,0.81,0.9650317892824705,2179,2225
12,4504,10,100,1e-05,0.01,0.808,0.9371669626998224,2227,2277
12,4604,10,100,1e-05,0.01,0.826,0.9667680278019114,2270,2334
12,4704,10,100,1e-05,0.01,0.866,0.9804421768707483,2328,2376
12,4804,10,100,1e-05,0.01,0.862,0.9850124895920067,2374,2430
12,4904,10,100,1e-05,0.01,0.888,0.9828711256117455,2422,2482
12,5004,10,100,1e-05,0.01,0.892,0.9948041566746603,2477,2527
12,5104,10,100,1e-05,0.01,0.888,0.9943181818181818,2529,2575
12,5204,10,100,1e-05,0.01,0.902,0.9934665641813989,2589,2615
12,5304,10,100,1e-05,0.01,0.892,0.9717194570135747,2640,2664
12,5404,10,100,1e-05,0.01,0.89,0.9652109548482606,2697,2707
12,5504,10,100,1e-05,0.01,0.894,0.9620276162790697,2742,2762
12,5604,10,100,1e-05,0.01,0.936,0.9862598144182727,2797,2807
12,5704,10,100,1e-05,0.01,0.926,0.9826437587657784,2842,2862
12,5804,10,100,1e-05,0.01,0.946,0.9922467263955892,2889,2915
12,5904,10,100,1e-05,0.01,0.93,0.9962737127371274,2943,2961
12,6004,10,100,1e-05,0.01,0.954,0.9965023317788141,2998,3006
12,6104,10,100,1e-05,0.01,0.95,0.9986893840104849,3046,3058
12,6204,10,100,1e-05,0.01,0.946,0.9979045776918117,3092,3112
12,6304,10,100,1e-05,0.01,0.946,0.9973032994923858,3145,3159
12,6404,10,100,1e-05,0.01,0.944,0.9950031230480949,3193,3211
12,6504,10,100,1e-05,0.01,0.954,0.997539975399754,3239,3265
12,6604,10,100,1e-05,0.01,0.956,0.9971229557843732,3297,3307
12,6704,10,100,1e-05,0.01,0.946,0.9931384248210023,3349,3355
12,6804,10,100,1e-05,0.01,0.95,0.9938271604938271,3394,3410
12,6904,10,100,1e-05,0.01,0.954,0.9910196987253765,3451,3453
12,7004,10,100,1e-05,0.01,0.928,0.9774414620217019,3496,3508
12,7104,10,100,1e-05,0.01,0.958,0.9956362612612613,3544,3560
12,7204,10,100,1e-05,0.01,0.954,0.9959744586340922,3588,3616
12,7304,10,100,1e-05,0.01,0.954,0.9967141292442497,3644,3660
12,7404,10,100,1e-05,0.01,0.96,0.9985143165856294,3694,3710
12,7504,10,100,1e-05,0.01,0.96,0.9990671641791045,3750,3754
12,7604,10,100,1e-05,0.01,0.966,0.9986849026827985,3800,3804
12,7704,10,100,1e-05,0.01,0.962,0.9980529595015576,3850,3854
12,7804,10,100,1e-05,0.01,0.97,0.9985904664274731,3904,3900
12,7904,10,100,1e-05,0.01,0.974,0.9991143724696356,3952,3952
12,8004,10,100,1e-05,0.01,0.976,0.9992503748125937,4009,3995
12,8104,10,100,1e-05,0.01,0.964,0.9930898321816387,4067,4037
12,8204,10,100,1e-05,0.01,0.962,0.9939054119941492,4116,4088
12,8304,10,100,1e-05,0.01,0.964,0.9959055876685935,4165,4139
12,8404,10,100,1e-05,0.01,0.954,0.9864350309376487,4211,4193
12,8504,10,100,1e-05,0.01,0.962,0.9949435559736595,4256,4248
12,8604,10,100,1e-05,0.01,0.978,0.99907019990702,4303,4301
12,8704,10,100,1e-05,0.01,0.986,0.9989659926470589,4353,4351
12,8804,10,100,1e-05,0.01,0.98,1.0,4396,4408
12,8904,10,100,1e-05,0.01,0.984,1.0,4448,4456
12,9004,10,100,1e-05,0.01,0.98,0.9958907152376721,4495,4509
12,9104,10,100,1e-05,0.01,0.974,0.9978031634446397,4539,4565
12,9204,10,100,1e-05,0.01,0.982,0.9966318991742721,4586,4618
12,9304,10,100,1e-05,0.01,0.978,0.9964531384350817,4642,4662
12,9404,10,100,1e-05,0.01,0.976,0.9970225435984688,4692,4712
12,9504,10,100,1e-05,0.01,0.978,0.998526936026936,4743,4761
12,9604,10,100,1e-05,0.01,0.978,0.9948979591836735,4803,4801
12,9704,10,100,1e-05,0.01,0.976,0.9980420445177246,4853,4851
12,9804,10,100,1e-05,0.01,0.978,0.9969400244798041,4909,4895
12,9904,10,100,1e-05,0.01,0.976,0.9942447495961227,4966,4938
12,10004,10,100,1e-05,0.01,0.968,0.994202319072371,5014,4990
12,10104,10,100,1e-05,0.01,0.974,0.9974267616785432,5062,5042
12,10204,10,100,1e-05,0.01,0.98,0.9987259898079185,5120,5084
12,10304,10,100,1e-05,0.01,0.982,0.9981560559006211,5173,5131
12,10404,10,100,1e-05,0.01,0.984,0.9979815455594002,5210,5194
12,10504,10,100,1e-05,0.01,0.99,0.9967631378522468,5255,5249
12,10604,10,100,1e-05,0.01,0.976,0.9942474537910223,5306,5298
12,10704,10,100,1e-05,0.01,0.976,0.9940209267563528,5357,5347
12,10804,10,100,1e-05,0.01,0.984,0.9984265087004813,5409,5395
12,10904,10,100,1e-05,0.01,0.986,0.9990829053558328,5459,5445
12,11004,10,100,1e-05,0.01,0.984,0.9990912395492548,5507,5497
12,11104,10,100,1e-05,0.01,0.976,0.9977485590778098,5555,5549
12,11204,10,100,1e-05,0.01,0.978,0.9926811852909675,5603,5601
12,11304,10,100,1e-05,0.01,0.98,0.9985845718329794,5652,5652
12,11404,10,100,1e-05,0.01,0.982,0.9992108032269379,5700,5704
12,11504,10,100,1e-05,0.01,0.984,0.9995653685674548,5740,5764
12,11604,10,100,1e-05,0.01,0.984,0.9990520510168908,5792,5812
12,11704,10,100,1e-05,0.01,0.974,0.9950444292549556,5846,5858
12,11804,10,100,1e-05,0.01,0.986,0.9972043375127075,5901,5903
12,11904,10,100,1e-05,0.01,0.992,0.9972278225806451,5953,5951
12,12004,10,100,1e-05,0.01,0.98,0.9947517494168611,6005,5999
12,12104,10,100,1e-05,0.01,0.988,0.9995869134170522,6052,6052
12,12204,10,100,1e-05,0.01,0.984,0.998934775483448,6100,6104
12,12304,10,100,1e-05,0.01,0.986,0.996261378413524,6155,6149
12,12404,10,100,1e-05,0.01,0.988,0.999032570138665,6206,6198
12,12504,10,100,1e-05,0.01,0.986,0.9986404350607806,6260,6244
12,12604,10,100,1e-05,0.01,0.984,0.9947635671215487,6318,6286
12,12704,10,100,1e-05,0.01,0.98,0.9922858942065491,6371,6333
12,12804,10,100,1e-05,0.01,0.988,0.9957044673539519,6419,6385
12,12904,10,100,1e-05,0.01,0.986,0.9970551766893986,6467,6437
12,13004,10,100,1e-05,0.01,0.988,0.9987696093509689,6510,6494
12,13104,10,100,1e-05,0.01,0.992,0.9975579975579976,6558,6546
12,13204,10,100,1e-05,0.01,0.986,0.995607391699485,6606,6598
12,13304,10,100,1e-05,0.01,0.988,0.9964672279013831,6657,6647
12,13404,10,100,1e-05,0.01,0.988,0.9980602805132797,6717,6687
12,13504,10,100,1e-05,0.01,0.988,0.9985189573459715,6768,6736
12,13604,10,100,1e-05,0.01,0.992,0.9999264922081741,6828,6776
12,13704,10,100,1e-05,0.01,0.99,0.9993432574430823,6876,6828
12,13804,10,100,1e-05,0.01,0.99,0.999855114459577,6931,6873
12,13904,10,100,1e-05,0.01,0.99,0.999928078250863,6977,6927
12,14004,10,100,1e-05,0.01,0.99,1.0,7030,6974
12,14104,10,100,1e-05,0.01,0.99,0.9994327850255247,7075,7029
12,14204,10,100,1e-05,0.01,0.992,0.9995071810757533,7130,7074
12,14304,10,100,1e-05,0.01,0.99,0.9993008948545862,7179,7125
12,14404,10,100,1e-05,0.01,0.99,0.9963898916967509,7225,7179
12,14504,10,100,1e-05,0.01,0.978,0.9874517374517374,7278,7226
12,14604,10,100,1e-05,0.01,0.986,0.9967132292522597,7328,7276
12,14704,10,100,1e-05,0.01,0.992,0.998911860718172,7373,7331
12,14804,10,100,1e-05,0.01,0.994,0.9989192110240476,7415,7389
12,14904,10,100,1e-05,0.01,0.992,0.9998658078368223,7461,7443
12,15004,10,100,1e-05,0.01,0.994,1.0,7514,7490
13,104,10,100,1e-05,0.01,0.512,0.7019230769230769,44,60
13,204,10,100,1e-05,0.01,0.518,0.6029411764705882,92,112
13,304,10,100,1e-05,0.01,0.52,0.6217105263157895,143,161
13,404,10,100,1e-05,0.01,0.506,0.6386138613861386,199,205
13,504,10,100,1e-05,0.01,0.504,0.5714285714285714,246,258
13,604,10,100,1e-05,0.01,0.528,0.6307947019867549,305,299
13,704,10,100,1e-05,0.01,0.506,0.6321022727272727,348,356
13,804,10,100,1e-05,0.01,0.538,0.664179104477612,391,413
13,904,10,100,1e-05,0.01,0.53,0.6648230088495575,447,457
13,1004,10,100,1e-05,0.01,0.566,0.703187250996016,500,504
13,1104,10,100,1e-05,0.01,0.568,0.6702898550724637,542,562
13,1204,10,100,1e-05,0.01,0.52,0.6694352159468439,597,607
13,1304,10,100,1e-05,0.01,0.524,0.6871165644171779,638,666
13,1404,10,100,1e-05,0.01,0.544,0.698005698005698,690,714
13,1504,10,100,1e-05,0.01,0.524,0.6848404255319149,739,765
13,1604,10,100,1e-05,0.01,0.568,0.7319201995012469,794,810
13,1704,10,100,1e-05,0.01,0.548,0.7417840375586855,842,862
13,1804,10,100,1e-05,0.01,0.58,0.7738359201773836,901,903
13,1904,10,100,1e-05,0.01,0.59,0.7746848739495799,952,952
13,2004,10,100,1e-05,0.01,0.58,0.7619760479041916,996,1008
13,2104,10,100,1e-05,0.01,0.62,0.7832699619771863,1048,1056
13,2204,10,100,1e-05,0.01,0.606,0.7540834845735027,1097,1107
13,2304,10,100,1e-05,0.01,0.59,0.7825520833333334,1146,1158
13,2404,10,100,1e-05,0.01,0.626,0.8136439267886856,1191,1213
13,2504,10,100,1e-05,0.01,0.652,0.8238817891373802,1239,1265
13,2604,10,100,1e-05,0.01,0.674,0.8490783410138248,1292,1312
13,2704,10,100,1e-05,0.01,0.7,0.871301775147929,1339,1365
13,2804,10,100,1e-05,0.01,0.724,0.8744650499286734,1392,1412
13,2904,10,100,1e-05,0.01,0.72,0.8536501377410468,1437,1467
13,3004,10,100,1e-05,0.01,0.742,0.8951398135818908,1485,1519
13,3104,10,100,1e-05,0.01,0.746,0.9265463917525774,1533,1571
13,3204,10,100,1e-05,0.01,0.756,0.9447565543071161,1580,1624
13,3304,10,100,1e-05,0.01,0.78,0.9594430992736077,1631,1673
13,3404,10,100,1e-05,0.01,0.728,0.9056991774383079,1690,1714
13,3504,10,100,1e-05,0.01,0.748,0.9089611872146118,1741,1763
13,3604,10,100,1e-05,0.01,0.802,0.9461709211986682,1783,1821
13,3704,10,100,1e-05,0.01,0.798,0.9635529157667386,1841,1863
13,3804,10,100,1e-05,0.01,0.812,0.9710830704521556,1888,1916
13,3904,10,100,1e-05,0.01,0.802,0.9654200819672131,1937,1967
13,4004,10,100,1e-05,0.01,0.838,0.973026973026973,1992,2012
13,4104,10,100,1e-05,0.01,0.848,0.9848927875243665,2045,2059
13,4204,10,100,1e-05,0.01,0.872,0.9888201712654615,2095,2109
13,4304,10,100,1e-05,0.01,0.876,0.9914033457249071,2141,2163
13,4404,10,100,1e-05,0.01,0.9,0.9938692098092643,2190,2214
13,4504,10,100,1e-05,0.01,0.906,0.9937833037300178,2238,2266
13,4604,10,100,1e-05,0.01,0.91,0.9956559513466551,2287,2317
13,4704,10,100,1e-05,0.01,0.888,0.9921343537414966,2332,2372
13,4804,10,100,1e-05,0.01,0.906,0.9898001665278934,2385,2419
13,4904,10,100,1e-05,0.01,0.93,0.9969412724306689,2442,2462
13,5004,10,100,1e-05,0.01,0.926,0.9924060751398881,2491,2513
13,5104,10,100,1e-05,0.01,0.926,0.9855015673981191,2541,2563
13,5204,10,100,1e-05,0.01,0.906,0.9788624135280554,2583,2621
13,5304,10,100,1e-05,0.01,0.934,0.9856711915535445,2629,2675
13,5404,10,100,1e-05,0.01,0.938,0.9959289415247965,2671,2733
13,5504,10,100,1e-05,0.01,0.944,0.9963662790697675,2719,2785
13,5604,10,100,1e-05,0.01,0.952,0.9971448965024983,2757,2847
13,5704,10,100,1e-05,0.01,0.94,0.9945652173913043,2812,2892
13,5804,10,100,1e-05,0.01,0.95,0.9970709855272226,2861,2943
13,5904,10,100,1e-05,0.01,0.962,0.9966124661246613,2912,2992
13,6004,10,100,1e-05,0.01,0.956,0.9980013324450366,2964,3040
13,6104,10,100,1e-05,0.01,0.958,0.9959043250327654,3006,3098
13,6204,10,100,1e-05,0.01,0.956,0.998388136686009,3052,3152
13,6304,10,100,1e-05,0.01,0.966,0.996510152284264,3097,3207
13,6404,10,100,1e-05,0.01,0.938,0.9797001873828857,3146,3258
13,6504,10,100,1e-05,0.01,0.944,0.9850861008610086,3190,3314
13,6604,10,100,1e-05,0.01,0.942,0.9881889763779528,3239,3365
13,6704,10,100,1e-05,0.01,0.942,0.9688245823389021,3282,3422
13,6804,10,100,1e-05,0.01,0.954,0.986331569664903,3330,3474
13,6904,10,100,1e-05,0.01,0.968,0.994351100811124,3381,3523
13,7004,10,100,1e-05,0.01,0.972,0.9985722444317533,3431,3573
13,7104,10,100,1e-05,0.01,0.972,0.9988738738738738,3485,3619
13,7204,10,100,1e-05,0.01,0.968,0.9948639644641866,3542,3662
13,7304,10,100,1e-05,0.01,0.972,0.9994523548740416,3587,3717
13,7404,10,100,1e-05,0.01,0.976,0.9993246893571043,3642,3762
13,7504,10,100,1e-05,0.01,0.976,0.9990671641791045,3692,3812
13,7604,10,100,1e-05,0.01,0.966,0.999079431877959,3736,3868
13,7704,10,100,1e-05,0.01,0.976,1.0,3791,3913
13,7804,10,100,1e-05,0.01,0.976,1.0,3843,3961
13,7904,10,100,1e-05,0.01,0.974,1.0,3897,4007
13,8004,10,100,1e-05,0.01,0.976,0.9968765617191404,3945,4059
13,8104,10,100,1e-05,0.01,0.968,0.9904985192497532,3990,4114
13,8204,10,100,1e-05,0.01,0.958,0.9897610921501706,4052,4152
13,8304,10,100,1e-05,0.01,0.962,0.990004816955684,4098,4206
13,8404,10,100,1e-05,0.01,0.976,0.9951213707758211,4151,4253
13,8504,10,100,1e-05,0.01,0.976,0.9962370649106302,4201,4303
13,8604,10,100,1e-05,0.01,0.974,0.9982566248256625,4254,4350
13,8704,10,100,1e-05,0.01,0.976,0.9989659926470589,4303,4401
13,8804,10,100,1e-05,0.01,0.974,0.9988641526578828,4358,4446
13,8904,10,100,1e-05,0.01,0.97,0.9993261455525606,4409,4495
13,9004,10,100,1e-05,0.01,0.976,0.9978898267436694,4463,4541
13,9104,10,100,1e-05,0.01,0.972,0.9995606326889279,4509,4595
13,9204,10,100,1e-05,0.01,0.97,0.9977183833116037,4561,4643
13,9304,10,100,1e-05,0.01,0.98,0.9967755803955288,4609,4695
13,9404,10,100,1e-05,0.01,0.974,0.9955338153977031,4652,4752
13,9504,10,100,1e-05,0.01,0.974,0.9964225589225589,4701,4803
13,9604,10,100,1e-05,0.01,0.964,0.9928154935443565,4751,4853
13,9704,10,100,1e-05,0.01,0.968,0.9820692497938994,4807,4897
13,9804,10,100,1e-05,0.01,0.974,0.9961240310077519,4847,4957
13,9904,10,100,1e-05,0.01,0.972,0.9991922455573505,4899,5005
13,10004,10,100,1e-05,0.01,0.974,0.9992003198720512,4944,5060
13,10104,10,100,1e-05,0.01,0.976,0.9981195566112431,4995,5109
13,10204,10,100,1e-05,0.01,0.97,0.997451979615837,5050,5154
13,10304,10,100,1e-05,0.01,0.98,0.999417701863354,5098,5206
13,10404,10,100,1e-05,0.01,0.976,0.9978854286812764,5152,5252
13,10504,10,100,1e-05,0.01,0.976,0.9964775323686215,5207,5297
13,10604,10,100,1e-05,0.01,0.974,0.9968879668049793,5259,5345
13,10704,10,100,1e-05,0.01,0.972,0.991872197309417,5308,5396
13,10804,10,100,1e-05,0.01,0.976,0.9963902258422807,5362,5442
13,10904,10,100,1e-05,0.01,0.976,0.9964233308877476,5409,5495
13,11004,10,100,1e-05,0.01,0.976,0.9970010905125409,5472,5532
13,11104,10,100,1e-05,0.01,0.978,0.9965778097982709,5524,5580
13,11204,10,100,1e-05,0.01,0.98,0.9996429846483399,5564,5640
13,11304,10,100,1e-05,0.01,0.974,0.9933651804670913,5620,5684
13,11404,10,100,1e-05,0.01,0.98,0.9967555243774114,5679,5725
13,11504,10,100,1e-05,0.01,0.982,0.9980006954102921,5733,5771
13,11604,10,100,1e-05,0.01,0.98,0.9986211651154774,5785,5819
13,11704,10,100,1e-05,0.01,0.984,0.9997436773752563,5841,5863
13,11804,10,100,1e-05,0.01,0.982,0.9999152829549305,5885,5919
13,11904,10,100,1e-05,0.01,0.984,0.9993279569892473,5932,5972
13,12004,10,100,1e-05,0.01,0.98,0.9955014995001666,5984,6020
13,12104,10,100,1e-05,0.01,0.98,0.9945472571050892,6036,6068
13,12204,10,100,1e-05,0.01,0.972,0.9913962635201573,6085,6119
13,12304,10,100,1e-05,0.01,0.98,0.9951235370611183,6129,6175
13,12404,10,100,1e-05,0.01,0.984,0.9954047081586584,6187,6217
13,12504,10,100,1e-05,0.01,0.984,0.9981605886116443,6241,6263
13,12604,10,100,1e-05,0.01,0.976,0.9949222469057442,6285,6319
13,12704,10,100,1e-05,0.01,0.982,0.9992915617128464,6336,6368
13,12804,10,100,1e-05,0.01,0.982,0.9996094970321775,6374,6430
13,12904,10,100,1e-05,0.01,0.984,1.0,6426,6478
13,13004,10,100,1e-05,0.01,0.984,0.9989234081820978,6470,6534
13,13104,10,100,1e-05,0.01,0.984,1.0,6521,6583
13,13204,10,100,1e-05,0.01,0.986,1.0,6581,6623
13,13304,10,100,1e-05,0.01,0.986,1.0,6624,6680
13,13404,10,100,1e-05,0.01,0.984,0.999104744852283,6676,6728
13,13504,10,100,1e-05,0.01,0.978,0.9997778436018957,6732,6772
13,13604,10,100,1e-05,0.01,0.978,0.9972067039106145,6786,6818
13,13704,10,100,1e-05,0.01,0.978,0.9841652072387624,6836,6868
13,13804,10,100,1e-05,0.01,0.986,0.9936974789915967,6890,6914
13,13904,10,100,1e-05,0.01,0.982,0.9984896432681243,6945,6959
13,14004,10,100,1e-05,0.01,0.976,0.9929305912596401,6998,7006
13,14104,10,100,1e-05,0.01,0.986,0.9997872943845717,7047,7057
13,14204,10,100,1e-05,0.01,0.99,0.9998591945930724,7096,7108
13,14304,10,100,1e-05,0.01,0.986,1.0,7142,7162
13,14404,10,100,1e-05,0.01,0.986,1.0,7199,7205
13,14504,10,100,1e-05,0.01,0.986,1.0,7248,7256
13,14604,10,100,1e-05,0.01,0.988,0.9993152560942208,7302,7302
13,14704,10,100,1e-05,0.01,0.974,0.989322633297062,7342,7362
13,14804,10,100,1e-05,0.01,0.982,0.9918265333693597,7392,7412
13,14904,10,100,1e-05,0.01,0.988,0.999194847020934,7446,7458
13,15004,10,100,1e-05,0.01,0.986,0.999466808850973,7501,7503
14,104,10,100,1e-05,0.01,0.526,0.5961538461538461,55,49
14,204,10,100,1e-05,0.01,0.494,0.7058823529411765,103,101
14,304,10,100,1e-05,0.01,0.528,0.6611842105263158,151,153
14,404,10,100,1e-05,0.01,0.506,0.6410891089108911,206,198
14,504,10,100,1e-05,0.01,0.498,0.6388888888888888,251,253
14,604,10,100,1e-05,0.01,0.522,0.6341059602649006,305,299
14,704,10,100,1e-05,0.01,0.51,0.6221590909090909,362,342
14,804,10,100,1e-05,0.01,0.504,0.6082089552238806,412,392
14,904,10,100,1e-05,0.01,0.506,0.5896017699115044,460,444
14,1004,10,100,1e-05,0.01,0.528,0.6872509960159362,505,499
14,1104,10,100,1e-05,0.01,0.538,0.6730072463768116,551,553
14,1204,10,100,1e-05,0.01,0.55,0.6769102990033222,608,596
14,1304,10,100,1e-05,0.01,0.52,0.6825153374233128,658,646
14,1404,10,100,1e-05,0.01,0.52,0.7001424501424501,707,697
14,1504,10,100,1e-05,0.01,0.528,0.7400265957446809,753,751
14,1604,10,100,1e-05,0.01,0.556,0.75,806,798
14,1704,10,100,1e-05,0.01,0.572,0.732981220657277,866,838
14,1804,10,100,1e-05,0.01,0.61,0.7427937915742794,920,884
14,1904,10,100,1e-05,0.01,0.596,0.7326680672268907,970,934
14,2004,10,100,1e-05,0.01,0.6,0.8083832335329342,1026,978
14,2104,10,100,1e-05,0.01,0.608,0.8231939163498099,1075,1029
14,2204,10,100,1e-05,0.01,0.606,0.8239564428312159,1136,1068
14,2304,10,100,1e-05,0.01,0.638,0.8459201388888888,1186,1118
14,2404,10,100,1e-05,0.01,0.676,0.8652246256239601,1229,1175
14,2504,10,100,1e-05,0.01,0.648,0.8414536741214057,1272,1232
14,2604,10,100,1e-05,0.01,0.688,0.8602150537634409,1324,1280
14,2704,10,100,1e-05,0.01,0.668,0.834319526627219,1376,1328
14,2804,10,100,1e-05,0.01,0.692,0.8634094151212554,1425,1379
14,2904,10,100,1e-05,0.01,0.712,0.8818870523415978,1477,1427
14,3004,10,100,1e-05,0.01,0.686,0.8901464713715047,1531,1473
14,3104,10,100,1e-05,0.01,0.7,0.9052835051546392,1579,1525
14,3204,10,100,1e-05,0.01,0.73,0.9332084893882646,1630,1574
14,3304,10,100,1e-05,0.01,0.754,0.9394673123486683,1673,1631
14,3404,10,100,1e-05,0.01,0.768,0.9318448883666275,1728,1676
14,3504,10,100,1e-05,0.01,0.766,0.918093607305936,1776,1728
14,3604,10,100,1e-05,0.01,0.788,0.9370144284128746,1826,1778
14,3704,10,100,1e-05,0.01,0.814,0.9576133909287257,1879,1825
14,3804,10,100,1e-05,0.01,0.816,0.9574132492113565,1932,1872
14,3904,10,100,1e-05,0.01,0.794,0.9077868852459017,1982,1922
14,4004,10,100,1e-05,0.01,0.818,0.9393106893106893,2031,1973
14,4104,10,100,1e-05,0.01,0.842,0.9366471734892787,2075,2029
14,4204,10,100,1e-05,0.01,0.796,0.9386298763082779,2122,2082
14,4304,10,100,1e-05,0.01,0.844,0.9605018587360595,2172,2132
14,4404,10,100,1e-05,0.01,0.852,0.9775204359673024,2223,2181
14,4504,10,100,1e-05,0.01,0.85,0.9769094138543517,2268,2236
14,4604,10,100,1e-05,0.01,0.894,0.981537793223284,2317,2287
14,4704,10,100,1e-05,0.01,0.888,0.9844812925170068,2366,2338
14,4804,10,100,1e-05,0.01,0.898,0.9893838467943381,2420,2384
14,4904,10,100,1e-05,0.01,0.888,0.9896003262642741,2468,2436
14,5004,10,100,1e-05,0.01,0.894,0.9838129496402878,2519,2485
14,5104,10,100,1e-05,0.01,0.898,0.9827586206896551,2574,2530
14,5204,10,100,1e-05,0.01,0.894,0.9790545734050731,2624,2580
14,5304,10,100,1e-05,0.01,0.886,0.9849170437405732,2677,2627
14,5404,10,100,1e-05,0.01,0.908,0.9898223538119911,2724,2680
14,5504,10,100,1e-05,0.01,0.916,0.9947311046511628,2771,2733
14,5604,10,100,1e-05,0.01,0.918,0.9900071377587437,2826,2778
14,5704,10,100,1e-05,0.01,0.908,0.9905329593267882,2875,2829
14,5804,10,100,1e-05,0.01,0.926,0.9939696760854583,2928,2876
14,5904,10,100,1e-05,0.01,0.91,0.9901761517615176,2971,2933
14,6004,10,100,1e-05,0.01,0.908,0.9903397734843438,3011,2993
14,6104,10,100,1e-05,0.01,0.912,0.9919724770642202,3063,3041
14,6204,10,100,1e-05,0.01,0.92,0.9814635718891038,3107,3097
14,6304,10,100,1e-05,0.01,0.924,0.988261421319797,3157,3147
14,6404,10,100,1e-05,0.01,0.938,0.9895377888819488,3202,3202
14,6504,10,100,1e-05,0.01,0.93,0.993849938499385,3248,3256
14,6604,10,100,1e-05,0.01,0.912,0.9850090854027862,3305,3299
14,6704,10,100,1e-05,0.01,0.934,0.9922434367541766,3357,3347
14,6804,10,100,1e-05,0.01,0.942,0.9894179894179894,3404,3400
14,6904,10,100,1e-05,0.01,0.936,0.9920336037079953,3452,3452
14,7004,10,100,1e-05,0.01,0.95,0.9951456310679612,3502,3502
14,7104,10,100,1e-05,0.01,0.944,0.9963400900900901,3547,3557
14,7204,10,100,1e-05,0.01,0.934,0.9919489172681843,3599,3605
14,7304,10,100,1e-05,0.01,0.94,0.9880887185104053,3654,3650
14,7404,10,100,1e-05,0.01,0.93,0.9763641274986494,3707,3697
14,7504,10,100,1e-05,0.01,0.938,0.9896055437100213,3752,3752
14,7604,10,100,1e-05,0.01,0.95,0.992898474487112,3806,3798
14,7704,10,100,1e-05,0.01,0.952,0.9949376947040498,3852,3852
14,7804,10,100,1e-05,0.01,0.948,0.9933367503844183,3903,3901
14,7904,10,100,1e-05,0.01,0.942,0.9884868421052632,3945,3959
14,8004,10,100,1e-05,0.01,0.95,0.9951274362818591,3994,4010
14,8104,10,100,1e-05,0.01,0.952,0.9950641658440277,4041,4063
14,8204,10,100,1e-05,0.01,0.964,0.9963432471964895,4093,4111
14,8304,10,100,1e-05,0.01,0.962,0.9967485549132948,4137,4167
14,8404,10,100,1e-05,0.01,0.958,0.9936934792955735,4186,4218
14,8504,10,100,1e-05,0.01,0.95,0.9910630291627469,4230,4274
14,8604,10,100,1e-05,0.01,0.96,0.9841933984193398,4276,4328
14,8704,10,100,1e-05,0.01,0.946,0.9793198529411765,4327,4377
14,8804,10,100,1e-05,0.01,0.938,0.9729668332576101,4374,4430
14,8904,10,100,1e-05,0.01,0.952,0.9894429469901168,4421,4483
14,9004,10,100,1e-05,0.01,0.958,0.9932252332296757,4473,4531
14,9104,10,100,1e-05,0.01,0.966,0.9962653778558875,4527,4577
14,9204,10,100,1e-05,0.01,0.964,0.9938070404172099,4571,4633
14,9304,10,100,1e-05,0.01,0.966,0.9959157351676698,4619,4685
14,9404,10,100,1e-05,0.01,0.962,0.9975542322415993,4657,4747
14,9504,10,100,1e-05,0.01,0.966,0.9975799663299664,4705,4799
14,9604,10,100,1e-05,0.01,0.964,0.9947938359017077,4751,4853
14,9704,10,100,1e-05,0.01,0.966,0.9976298433635614,4794,4910
14,9804,10,100,1e-05,0.01,0.966,0.9960220318237454,4855,4949
14,9904,10,100,1e-05,0.01,0.974,0.9980815831987075,4912,4992
14,10004,10,100,1e-05,0.01,0.976,0.9974010395841664,4969,5035
14,10104,10,100,1e-05,0.01,0.968,0.9979216152019003,5015,5089
14,10204,10,100,1e-05,0.01,0.976,0.9983339866718933,5059,5145
14,10304,10,100,1e-05,0.01,0.972,0.9977678571428571,5109,5195
14,10404,10,100,1e-05,0.01,0.958,0.9850057670126874,5161,5243
14,10504,10,100,1e-05,0.01,0.954,0.976961157654227,5214,5290
14,10604,10,100,1e-05,0.01,0.966,0.9900037721614485,5264,5340
14,10704,10,100,1e-05,0.01,0.964,0.9905642750373692,5314,5390
14,10804,10,100,1e-05,0.01,0.97,0.9900962606442059,5365,5439
14,10904,10,100,1e-05,0.01,0.972,0.9961482024944974,5415,5489
14,11004,10,100,1e-05,0.01,0.97,0.9966375863322429,5471,5533
14,11104,10,100,1e-05,0.01,0.976,0.9957672910662824,5518,5586
14,11204,10,100,1e-05,0.01,0.978,0.996876115672974,5574,5630
14,11304,10,100,1e-05,0.01,0.976,0.9985845718329794,5624,5680
14,11404,10,100,1e-05,0.01,0.974,0.9983339179235357,5676,5728
14,11504,10,100,1e-05,0.01,0.978,0.9981745479833102,5720,5784
14,11604,10,100,1e-05,0.01,0.976,0.999224405377456,5777,5827
14,11704,10,100,1e-05,0.01,0.976,0.9981203007518797,5834,5870
14,11804,10,100,1e-05,0.01,0.978,0.9983056590986107,5888,5916
14,11904,10,100,1e-05,0.01,0.978,0.9995799731182796,5935,5969
14,12004,10,100,1e-05,0.01,0.976,0.9995834721759413,5981,6023
14,12104,10,100,1e-05,0.01,0.978,0.997769332452082,6029,6075
14,12204,10,100,1e-05,0.01,0.978,0.9983611930514585,6077,6127
14,12304,10,100,1e-05,0.01,0.976,0.9972366710013004,6129,6175
14,12404,10,100,1e-05,0.01,0.966,0.9928248951950983,6179,6225
14,12504,10,100,1e-05,0.01,0.968,0.9906429942418427,6223,6281
14,12604,10,100,1e-05,0.01,0.974,0.993414788955887,6277,6327
14,12704,10,100,1e-05,0.01,0.974,0.9949622166246851,6326,6378
14,12804,10,100,1e-05,0.01,0.97,0.9939862542955327,6379,6425
14,12904,10,100,1e-05,0.01,0.98,0.9962027278363298,6430,6474
14,13004,10,100,1e-05,0.01,0.98,0.9975392187019378,6485,6519
14,13104,10,100,1e-05,0.01,0.98,0.9964896214896215,6546,6558
14,13204,10,100,1e-05,0.01,0.97,0.9959103302029688,6593,6611
14,13304,10,100,1e-05,0.01,0.98,0.9964672279013831,6647,6657
14,13404,10,100,1e-05,0.01,0.984,0.9979110713219934,6701,6703
14,13504,10,100,1e-05,0.01,0.982,0.9983708530805687,6758,6746
14,13604,10,100,1e-05,0.01,0.98,0.9977212584533961,6805,6799
14,13704,10,100,1e-05,0.01,0.978,0.99620548744892,6858,6846
14,13804,10,100,1e-05,0.01,0.984,0.994711677774558,6912,6892
14,13904,10,100,1e-05,0.01,0.984,0.9984896432681243,6956,6948
14,14004,10,100,1e-05,0.01,0.982,0.9967866323907455,6995,7009
14,14104,10,100,1e-05,0.01,0.98,0.9971639251276234,7049,7055
14,14204,10,100,1e-05,0.01,0.984,0.9926781188397634,7090,7114
14,14304,10,100,1e-05,0.01,0.978,0.9979725950782998,7141,7163
14,14404,10,100,1e-05,0.01,0.982,0.9995834490419327,7192,7212
14,14504,10,100,1e-05,0.01,0.984,0.9996552675124104,7244,7260
14,14604,10,100,1e-05,0.01,0.982,0.9995891536565324,7296,7308
14,14704,10,100,1e-05,0.01,0.986,1.0,7344,7360
14,14804,10,100,1e-05,0.01,0.986,1.0,7399,7405
14,14904,10,100,1e-05,0.01,0.986,0.9997987117552335,7443,7461
14,15004,10,100,1e-05,0.01,0.984,0.998000533191149,7489,7515
15,104,10,100,1e-05,0.01,0.522,0.5865384615384616,49,55
15,204,10,100,1e-05,0.01,0.54,0.6323529411764706,109,95
15,304,10,100,1e-05,0.01,0.514,0.6381578947368421,166,138
15,404,10,100,1e-05,0.01,0.526,0.7054455445544554,213,191
15,504,10,100,1e-05,0.01,0.524,0.6309523809523809,255,249
15,604,10,100,1e-05,0.01,0.53,0.6622516556291391,303,301
15,704,10,100,1e-05,0.01,0.512,0.6676136363636364,349,355
15,804,10,100,1e-05,0.01,0.508,0.6865671641791045,394,410
15,904,10,100,1e-05,0.01,0.492,0.6581858407079646,442,462
15,1004,10,100,1e-05,0.01,0.536,0.649402390438247,489,515
15,1104,10,100,1e-05,0.01,0.526,0.6567028985507246,538,566
15,1204,10,100,1e-05,0.01,0.502,0.6611295681063123,584,620
15,1304,10,100,1e-05,0.01,0.558,0.6932515337423313,629,675
15,1404,10,100,1e-05,0.01,0.522,0.6787749287749287,685,719
15,1504,10,100,1e-05,0.01,0.534,0.6808510638297872,737,767
15,1604,10,100,1e-05,0.01,0.516,0.6845386533665836,781,823
15,1704,10,100,1e-05,0.01,0.506,0.7153755868544601,832,872
15,1804,10,100,1e-05,0.01,0.508,0.7516629711751663,881,923
15,1904,10,100,1e-05,0.01,0.536,0.7557773109243697,938,966
15,2004,10,100,1e-05,0.01,0.53,0.7564870259481038,985,1019
15,2104,10,100,1e-05,0.01,0.57,0.7661596958174905,1032,1072
15,2204,10,100,1e-05,0.01,0.554,0.7722323049001815,1079,1125
15,2304,10,100,1e-05,0.01,0.554,0.7634548611111112,1138,1166
15,2404,10,100,1e-05,0.01,0.574,0.8082362728785357,1194,1210
15,2504,10,100,1e-05,0.01,0.562,0.7947284345047924,1238,1266
15,2604,10,100,1e-05,0.01,0.566,0.82642089093702,1282,1322
15,2704,10,100,1e-05,0.01,0.576,0.8387573964497042,1328,1376
15,2804,10,100,1e-05,0.01,0.554,0.8059914407988588,1387,1417
15,2904,10,100,1e-05,0.01,0.578,0.8316115702479339,1445,1459
15,3004,10,100,1e-05,0.01,0.6,0.8472037283621837,1489,1515
15,3104,10,100,1e-05,0.01,0.606,0.875,1539,1565
15,3204,10,100,1e-05,0.01,0.62,0.8604868913857678,1589,1615
15,3304,10,100,1e-05,0.01,0.636,0.885593220338983,1645,1659
15,3404,10,100,1e-05,0.01,0.65,0.9086368977673326,1694,1710
15,3504,10,100,1e-05,0.01,0.686,0.9083904109589042,1741,1763
15,3604,10,100,1e-05,0.01,0.67,0.8937291897891232,1797,1807
15,3704,10,100,1e-05,0.01,0.684,0.875,1842,1862
15,3804,10,100,1e-05,0.01,0.658,0.8696109358569927,1895,1909
15,3904,10,100,1e-05,0.01,0.712,0.9026639344262295,1945,1959
15,4004,10,100,1e-05,0.01,0.712,0.9205794205794205,1988,2016
15,4104,10,100,1e-05,0.01,0.696,0.9152046783625731,2035,2069
15,4204,10,100,1e-05,0.01,0.72,0.9253092293054234,2080,2124
15,4304,10,100,1e-05,0.01,0.682,0.8763940520446096,2131,2173
15,4404,10,100,1e-05,0.01,0.734,0.9064486830154405,2177,2227
15,4504,10,100,1e-05,0.01,0.734,0.9085257548845471,2223,2281
15,4604,10,100,1e-05,0.01,0.752,0.9074717636837533,2266,2338
15,4704,10,100,1e-05,0.01,0.742,0.8917942176870748,2312,2392
15,4804,10,100,1e-05,0.01,0.76,0.9217318900915903,2363,2441
15,4904,10,100,1e-05,0.01,0.752,0.908442088091354,2411,2493
15,5004,10,100,1e-05,0.01,0.784,0.9414468425259792,2459,2545
15,5104,10,100,1e-05,0.01,0.806,0.9518025078369906,2514,2590
15,5204,10,100,1e-05,0.01,0.816,0.9460030745580322,2566,2638
15,5304,10,100,1e-05,0.01,0.788,0.9547511312217195,2616,2688
15,5404,10,100,1e-05,0.01,0.798,0.9568837897853442,2664,2740
15,5504,10,100,1e-05,0.01,0.754,0.9313226744186046,2702,2802
15,5604,10,100,1e-05,0.01,0.8,0.960028551034975,2760,2844
15,5704,10,100,1e-05,0.01,0.79,0.916374474053296,2814,2890
15,5804,10,100,1e-05,0.01,0.8,0.9502067539627843,2863,2941
15,5904,10,100,1e-05,0.01,0.798,0.945630081300813,2914,2990
15,6004,10,100,1e-05,0.01,0.822,0.959526982011992,2967,3037
15,6104,10,100,1e-05,0.01,0.81,0.9696920052424639,3018,3086
15,6204,10,100,1e-05,0.01,0.832,0.9679239200515797,3067,3137
15,6304,10,100,1e-05,0.01,0.792,0.9281408629441624,3113,3191
15,6404,10,100,1e-05,0.01,0.818,0.9634603372891942,3159,3245
15,6504,10,100,1e-05,0.01,0.846,0.9670971709717097,3204,3300
15,6604,10,100,1e-05,0.01,0.838,0.9697153240460327,3252,3352
15,6704,10,100,1e-05,0.01,0.838,0.9749403341288783,3304,3400
15,6804,10,100,1e-05,0.01,0.858,0.9828042328042328,3354,3450
15,6904,10,100,1e-05,0.01,0.842,0.9742178447276941,3409,3495
15,7004,10,100,1e-05,0.01,0.854,0.9784408909194746,3457,3547
15,7104,10,100,1e-05,0.01,0.844,0.9809966216216216,3510,3594
15,7204,10,100,1e-05,0.01,0.822,0.9659911160466408,3565,3639
15,7304,10,100,1e-05,0.01,0.866,0.9830230010952903,3609,3695
15,7404,10,100,1e-05,0.01,0.868,0.9598865478119936,3661,3743
15,7504,10,100,1e-05,0.01,0.858,0.9760127931769723,3710,3794
15,7604,10,100,1e-05,0.01,0.87,0.9693582325092057,3762,3842
15,7704,10,100,1e-05,0.01,0.858,0.9746884735202492,3805,3899
15,7804,10,100,1e-05,0.01,0.868,0.9825730394669401,3855,3949
15,7904,10,100,1e-05,0.01,0.872,0.9831730769230769,3908,3996
15,8004,10,100,1e-05,0.01,0.878,0.9860069965017492,3955,4049
15,8104,10,100,1e-05,0.01,0.884,0.9843287265547878,4008,4096
15,8204,10,100,1e-05,0.01,0.896,0.9859824475865432,4060,4144
15,8304,10,100,1e-05,0.01,0.896,0.9844653179190751,4114,4190
15,8404,10,100,1e-05,0.01,0.902,0.9840552118039029,4162,4242
15,8504,10,100,1e-05,0.01,0.896,0.9941204139228599,4214,4290
15,8604,10,100,1e-05,0.01,0.906,0.9864016736401674,4268,4336
15,8704,10,100,1e-05,0.01,0.882,0.9770220588235294,4323,4381
15,8804,10,100,1e-05,0.01,0.86,0.9259427532939573,4378,4426
15,8904,10,100,1e-05,0.01,0.786,0.8263701707097934,4422,4482
15,9004,10,100,1e-05,0.01,0.836,0.9074855619724567,4476,4528
15,9104,10,100,1e-05,0.01,0.854,0.9365114235500879,4525,4579
15,9204,10,100,1e-05,0.01,0.874,0.9555627987831378,4569,4635
15,9304,10,100,1e-05,0.01,0.876,0.954213241616509,4612,4692
15,9404,10,100,1e-05,0.01,0.892,0.96714164185453,4665,4739
15,9504,10,100,1e-05,0.01,0.892,0.9829545454545454,4713,4791
15,9604,10,100,1e-05,0.01,0.904,0.9784464806330696,4759,4845
15,9704,10,100,1e-05,0.01,0.912,0.9836150041220115,4810,4894
15,9804,10,100,1e-05,0.01,0.93,0.9879640962872297,4866,4938
15,9904,10,100,1e-05,0.01,0.924,0.9923263327948304,4922,4982
15,10004,10,100,1e-05,0.01,0.938,0.994202319072371,4976,5028
15,10104,10,100,1e-05,0.01,0.932,0.9878266033254157,5022,5082
15,10204,10,100,1e-05,0.01,0.91,0.9822618580948648,5075,5129
15,10304,10,100,1e-05,0.01,0.936,0.9909743788819876,5117,5187
15,10404,10,100,1e-05,0.01,0.944,0.9922145328719724,5162,5242
15,10504,10,100,1e-05,0.01,0.95,0.9871477532368621,5210,5294
15,10604,10,100,1e-05,0.01,0.946,0.9895322519803847,5255,5349
15,10704,10,100,1e-05,0.01,0.932,0.9699177877428998,5309,5395
15,10804,10,100,1e-05,0.01,0.932,0.9817660125879304,5358,5446
15,10904,10,100,1e-05,0.01,0.944,0.9886280264123257,5412,5492
15,11004,10,100,1e-05,0.01,0.942,0.9876408578698656,5472,5532
15,11104,10,100,1e-05,0.01,0.954,0.9876621037463977,5526,5578
15,11204,10,100,1e-05,0.01,0.956,0.9964298464833988,5582,5622
15,11304,10,100,1e-05,0.01,0.96,0.9981422505307855,5627,5677
15,11404,10,100,1e-05,0.01,0.964,0.993949491406524,5672,5732
15,11504,10,100,1e-05,0.01,0.974,0.9972183588317107,5715,5789
15,11604,10,100,1e-05,0.01,0.976,0.9972423302309549,5761,5843
15,11704,10,100,1e-05,0.01,0.962,0.9985475051264525,5815,5889
15,11804,10,100,1e-05,0.01,0.972,0.9994069806845137,5873,5931
15,11904,10,100,1e-05,0.01,0.97,0.9992439516129032,5919,5985
15,12004,10,100,1e-05,0.01,0.968,0.998750416527824,5981,6023
15,12104,10,100,1e-05,0.01,0.97,0.9976867151354925,6031,6073
15,12204,10,100,1e-05,0.01,0.958,0.988692232055064,6079,6125
15,12304,10,100,1e-05,0.01,0.956,0.9817945383615084,6123,6181
15,12404,10,100,1e-05,0.01,0.944,0.9787165430506288,6172,6232
15,12504,10,100,1e-05,0.01,0.97,0.9939219449776072,6224,6280
15,12604,10,100,1e-05,0.01,0.97,0.9938114884163758,6279,6325
15,12704,10,100,1e-05,0.01,0.97,0.9957493702770781,6340,6364
15,12804,10,100,1e-05,0.01,0.976,0.996485473289597,6392,6412
15,12904,10,100,1e-05,0.01,0.976,0.9979076255424675,6442,6462
15,13004,10,100,1e-05,0.01,0.986,0.9978468163641956,6490,6514
15,13104,10,100,1e-05,0.01,0.98,0.9974053724053724,6539,6565
15,13204,10,100,1e-05,0.01,0.974,0.9930324144198728,6594,6610
15,13304,10,100,1e-05,0.01,0.976,0.9969182200841852,6647,6657
15,13404,10,100,1e-05,0.01,0.984,0.9923903312444047,6695,6709
15,13504,10,100,1e-05,0.01,0.98,0.998074644549763,6749,6755
15,13604,10,100,1e-05,0.01,0.978,0.9996324610408703,6792,6812
15,13704,10,100,1e-05,0.01,0.988,0.9991973146526562,6841,6863
15,13804,10,100,1e-05,0.01,0.992,0.9995653433787308,6893,6911
15,13904,10,100,1e-05,0.01,0.99,0.9993527042577676,6947,6957
15,14004,10,100,1e-05,0.01,0.988,0.9992859183090546,6996,7008
15,14104,10,100,1e-05,0.01,0.992,0.9997163925127623,7044,7060
15,14204,10,100,1e-05,0.01,0.976,0.9957054350887075,7099,7105
15,14304,10,100,1e-05,0.01,0.976,0.9954558165548099,7147,7157
15,14404,10,100,1e-05,0.01,0.972,0.9870869202999167,7199,7205
15,14504,10,100,1e-05,0.01,0.974,0.9877964699393271,7260,7244
15,14604,10,100,1e-05,0.01,0.978,0.9980142426732402,7310,7294
15,14704,10,100,1e-05,0.01,0.978,0.9974156692056583,7355,7349
15,14804,10,100,1e-05,0.01,0.98,0.9989867603350446,7398,7406
15,14904,10,100,1e-05,0.01,0.986,0.9993961352657005,7447,7457
15,15004,10,100,1e-05,0.01,0.986,0.9998000533191149,7503,7501
16,104,10,100,1e-05,0.01,0.532,0.5192307692307693,54,50
16,204,10,100,1e-05,0.01,0.492,0.6127450980392157,106,98
16,304,10,100,1e-05,0.01,0.468,0.618421052631579,158,146
16,404,10,100,1e-05,0.01,0.492,0.6460396039603961,205,199
16,504,10,100,1e-05,0.01,0.482,0.6527777777777778,261,243
16,604,10,100,1e-05,0.01,0.482,0.6771523178807947,308,296
16,704,10,100,1e-05,0.01,0.462,0.6803977272727273,365,339
16,804,10,100,1e-05,0.01,0.482,0.6554726368159204,414,390
16,904,10,100,1e-05,0.01,0.484,0.6449115044247787,462,442
16,1004,10,100,1e-05,0.01,0.484,0.6892430278884463,510,494
16,1104,10,100,1e-05,0.01,0.5,0.6893115942028986,557,547
16,1204,10,100,1e-05,0.01,0.46,0.7259136212624585,608,596
16,1304,10,100,1e-05,0.01,0.494,0.7193251533742331,660,644
16,1404,10,100,1e-05,0.01,0.482,0.7272079772079773,716,688
16,1504,10,100,1e-05,0.01,0.458,0.7513297872340425,768,736
16,1604,10,100,1e-05,0.01,0.464,0.777431421446384,818,786
16,1704,10,100,1e-05,0.01,0.514,0.7523474178403756,863,841
16,1804,10,100,1e-05,0.01,0.492,0.7682926829268293,911,893
16,1904,10,100,1e-05,0.01,0.532,0.7589285714285714,952,952
16,2004,10,100,1e-05,0.01,0.496,0.7470059880239521,997,1007
16,2104,10,100,1e-05,0.01,0.464,0.723384030418251,1043,1061
16,2204,10,100,1e-05,0.01,0.504,0.7912885662431942,1095,1109
16,2304,10,100,1e-05,0.01,0.516,0.8055555555555556,1145,1159
16,2404,10,100,1e-05,0.01,0.506,0.8178036605657238,1196,1208
16,2504,10,100,1e-05,0.01,0.484,0.7448083067092651,1250,1254
16,2604,10,100,1e-05,0.01,0.512,0.8245007680491552,1294,1310
16,2704,10,100,1e-05,0.01,0.518,0.8132396449704142,1327,1377
16,2804,10,100,1e-05,0.01,0.526,0.8388017118402282,1374,1430
16,2904,10,100,1e-05,0.01,0.536,0.8384986225895317,1424,1480
16,3004,10,100,1e-05,0.01,0.55,0.8382157123834887,1484,1520
16,3104,10,100,1e-05,0.01,0.514,0.8308634020618557,1532,1572
16,3204,10,100,1e-05,0.01,0.534,0.8626716604244694,1580,1624
16,3304,10,100,1e-05,0.01,0.514,0.8326271186440678,1630,1674
16,3404,10,100,1e-05,0.01,0.544,0.8443008225616921,1676,1728
16,3504,10,100,1e-05,0.01,0.59,0.8538812785388128,1719,1785
16,3604,10,100,1e-05,0.01,0.61,0.8820754716981132,1769,1835
16,3704,10,100,1e-05,0.01,0.6,0.8874190064794817,1824,1880
16,3804,10,100,1e-05,0.01,0.6,0.8966876971608833,1873,1931
16,3904,10,100,1e-05,0.01,0.588,0.9042008196721312,1925,1979
16,4004,10,100,1e-05,0.01,0.624,0.9068431568431569,1976,2028
16,4104,10,100,1e-05,0.01,0.63,0.9159356725146199,2024,2080
16,4204,10,100,1e-05,0.01,0.624,0.9257849666983825,2076,2128
16,4304,10,100,1e-05,0.01,0.636,0.9142657992565055,2131,2173
16,4404,10,100,1e-05,0.01,0.668,0.9198455949137148,2181,2223
16,4504,10,100,1e-05,0.01,0.628,0.9302841918294849,2228,2276
16,4604,10,100,1e-05,0.01,0.674,0.930278019113814,2281,2323
16,4704,10,100,1e-05,0.01,0.644,0.935374149659864,2326,2378
16,4804,10,100,1e-05,0.01,0.674,0.9171523730224813,2369,2435
16,4904,10,100,1e-05,0.01,0.658,0.8994698205546493,2418,2486
16,5004,10,100,1e-05,0.01,0.684,0.9372501998401279,2467,2537
16,5104,10,100,1e-05,0.01,0.672,0.9388714733542319,2525,2579
16,5204,10,100,1e-05,0.01,0.698,0.9546502690238279,2573,2631
16,5304,10,100,1e-05,0.01,0.704,0.9434389140271493,2627,2677
16,5404,10,100,1e-05,0.01,0.696,0.9430051813471503,2672,2732
16,5504,10,100,1e-05,0.01,0.718,0.9107921511627907,2721,2783
16,5604,10,100,1e-05,0.01,0.71,0.9443254817987152,2763,2841
16,5704,10,100,1e-05,0.01,0.73,0.9535413744740533,2817,2887
16,5804,10,100,1e-05,0.01,0.736,0.9610613370089593,2872,2932
16,5904,10,100,1e-05,0.01,0.734,0.9415650406504065,2928,2976
16,6004,10,100,1e-05,0.01,0.764,0.9472018654230513,2979,3025
16,6104,10,100,1e-05,0.01,0.762,0.9572411533420708,3032,3072
16,6204,10,100,1e-05,0.01,0.78,0.9679239200515797,3079,3125
16,6304,10,100,1e-05,0.01,0.786,0.963991116751269,3119,3185
16,6404,10,100,1e-05,0.01,0.766,0.9556527170518426,3176,3228
16,6504,10,100,1e-05,0.01,0.802,0.9764760147601476,3232,3272
16,6604,10,100,1e-05,0.01,0.802,0.9680496668685645,3284,3320
16,6704,10,100,1e-05,0.01,0.776,0.9419749403341289,3341,3363
16,6804,10,100,1e-05,0.01,0.798,0.9482657260435038,3389,3415
16,6904,10,100,1e-05,0.01,0.812,0.9690034762456546,3441,3463
16,7004,10,100,1e-05,0.01,0.826,0.98043974871502,3490,3514
16,7104,10,100,1e-05,0.01,0.802,0.9812781531531531,3532,3572
16,7204,10,100,1e-05,0.01,0.81,0.9650194336479734,3574,3630
16,7304,10,100,1e-05,0.01,0.822,0.9412650602409639,3629,3675
16,7404,10,100,1e-05,0.01,0.834,0.9515126958400865,3678,3726
16,7504,10,100,1e-05,0.01,0.85,0.9568230277185501,3734,3770
16,7604,10,100,1e-05,0.01,0.856,0.9679116254602841,3788,3816
16,7704,10,100,1e-05,0.01,0.85,0.9823468328141225,3848,3856
16,7804,10,100,1e-05,0.01,0.836,0.9683495643259866,3898,3906
16,7904,10,100,1e-05,0.01,0.804,0.9161184210526315,3946,3958
16,8004,10,100,1e-05,0.01,0.83,0.9676411794102948,3996,4008
16,8104,10,100,1e-05,0.01,0.848,0.9797630799605134,4044,4060
16,8204,10,100,1e-05,0.01,0.848,0.9862262311067772,4102,4102
16,8304,10,100,1e-05,0.01,0.884,0.9914499036608864,4155,4149
16,8404,10,100,1e-05,0.01,0.878,0.991432651118515,4206,4198
16,8504,10,100,1e-05,0.01,0.876,0.9887111947318908,4252,4252
16,8604,10,100,1e-05,0.01,0.89,0.9902370990237099,4297,4307
16,8704,10,100,1e-05,0.01,0.89,0.9949448529411765,4346,4358
16,8804,10,100,1e-05,0.01,0.884,0.9920490686051795,4394,4410
16,8904,10,100,1e-05,0.01,0.91,0.993486073674753,4438,4466
16,9004,10,100,1e-05,0.01,0.896,0.994002665482008,4487,4517
16,9104,10,100,1e-05,0.01,0.906,0.9959358523725835,4543,4561
16,9204,10,100,1e-05,0.01,0.922,0.991851368970013,4602,4602
16,9304,10,100,1e-05,0.01,0.916,0.9860275150472915,4659,4645
16,9404,10,100,1e-05,0.01,0.904,0.9883028498511272,4717,4687
16,9504,10,100,1e-05,0.01,0.918,0.9916877104377104,4768,4736
16,9604,10,100,1e-05,0.01,0.912,0.9858392336526447,4821,4783
16,9704,10,100,1e-05,0.01,0.92,0.9830997526793075,4859,4845
16,9804,10,100,1e-05,0.01,0.92,0.9841901264789882,4904,4900
16,9904,10,100,1e-05,0.01,0.92,0.9798061389337641,4944,4960
16,10004,10,100,1e-05,0.01,0.918,0.9869052379048381,4999,5005
16,10104,10,100,1e-05,0.01,0.944,0.9918844022169437,5047,5057
16,10204,10,100,1e-05,0.01,0.922,0.9856918855350842,5093,5111
16,10304,10,100,1e-05,0.01,0.908,0.9800077639751553,5143,5161
16,10404,10,100,1e-05,0.01,0.952,0.9920222991157247,5192,5212
16,10504,10,100,1e-05,0.01,0.934,0.9851485148514851,5233,5271
16,10604,10,100,1e-05,0.01,0.95,0.9895322519803847,5283,5321
16,10704,10,100,1e-05,0.01,0.946,0.9902840059790733,5336,5368
16,10804,10,100,1e-05,0.01,0.948,0.9942613846723436,5387,5417
16,10904,10,100,1e-05,0.01,0.97,0.9987160674981658,5432,5472
16,11004,10,100,1e-05,0.01,0.962,0.9983642311886587,5478,5526
16,11104,10,100,1e-05,0.01,0.96,0.9959474063400576,5528,5576
16,11204,10,100,1e-05,0.01,0.966,0.9977686540521242,5578,5626
16,11304,10,100,1e-05,0.01,0.96,0.9963729653220099,5627,5677
16,11404,10,100,1e-05,0.01,0.952,0.9863205892669239,5667,5737
16,11504,10,100,1e-05,0.01,0.954,0.9911335187760779,5716,5788
16,11604,10,100,1e-05,0.01,0.944,0.989055498104102,5765,5839
16,11704,10,100,1e-05,0.01,0.944,0.9923103212576897,5812,5892
16,11804,10,100,1e-05,0.01,0.958,0.9838190443917316,5861,5943
16,11904,10,100,1e-05,0.01,0.952,0.9909274193548387,5924,5980
16,12004,10,100,1e-05,0.01,0.958,0.9940019993335555,5975,6029
16,12104,10,100,1e-05,0.01,0.97,0.9934732319894249,6025,6079
16,12204,10,100,1e-05,0.01,0.966,0.995575221238938,6069,6135
16,12304,10,100,1e-05,0.01,0.968,0.9974804941482445,6126,6178
16,12404,10,100,1e-05,0.01,0.972,0.999032570138665,6174,6230
16,12504,10,100,1e-05,0.01,0.972,0.9994401791426744,6219,6285
16,12604,10,100,1e-05,0.01,0.962,0.9968264043160902,6265,6339
16,12704,10,100,1e-05,0.01,0.97,0.9988979848866498,6324,6380
16,12804,10,100,1e-05,0.01,0.97,0.9982817869415808,6373,6431
16,12904,10,100,1e-05,0.01,0.974,0.9985275883446993,6419,6485
16,13004,10,100,1e-05,0.01,0.97,0.9971547216241157,6477,6527
16,13104,10,100,1e-05,0.01,0.984,0.9993131868131868,6530,6574
16,13204,10,100,1e-05,0.01,0.97,0.9965919418358073,6585,6619
16,13304,10,100,1e-05,0.01,0.97,0.9898526758869512,6637,6667
16,13404,10,100,1e-05,0.01,0.956,0.9819456878543719,6696,6708
16,13504,10,100,1e-05,0.01,0.976,0.9948904028436019,6742,6762
16,13604,10,100,1e-05,0.01,0.978,0.9957365480740958,6795,6809
16,13704,10,100,1e-05,0.01,0.982,0.9979568009340338,6844,6860
16,13804,10,100,1e-05,0.01,0.984,0.9966676325702695,6893,6911
16,13904,10,100,1e-05,0.01,0.972,0.9967635212888377,6941,6963
16,14004,10,100,1e-05,0.01,0.98,0.9988574692944873,6993,7011
16,14104,10,100,1e-05,0.01,0.986,0.9987237663074305,7046,7058
16,14204,10,100,1e-05,0.01,0.99,0.998873556744579,7105,7099
16,14304,10,100,1e-05,0.01,0.992,0.9986717002237137,7146,7158
16,14404,10,100,1e-05,0.01,0.986,0.9963898916967509,7195,7209
16,14504,10,100,1e-05,0.01,0.984,0.9968974076116933,7240,7264
16,14604,10,100,1e-05,0.01,0.94,0.9619282388386743,7290,7314
16,14704,10,100,1e-05,0.01,0.958,0.9845620239390642,7342,7362
16,14804,10,100,1e-05,0.01,0.978,0.9970953796271278,7386,7418
16,14904,10,100,1e-05,0.01,0.986,0.9988593666129898,7444,7460
16,15004,10,100,1e-05,0.01,0.994,0.9990669154892029,7487,7517
17,104,10,100,1e-05,0.01,0.49,0.7884615384615384,53,51
17,204,10,100,1e-05,0.01,0.496,0.6666666666666666,102,102
17,304,10,100,1e-05,0.01,0.5,0.6052631578947368,142,162
17,404,10,100,1e-05,0.01,0.524,0.6485148514851485,193,211
17,504,10,100,1e-05,0.01,0.546,0.5992063492063492,244,260
17,604,10,100,1e-05,0.01,0.51,0.6572847682119205,301,303
17,704,10,100,1e-05,0.01,0.508,0.6349431818181818,357,347
17,804,10,100,1e-05,0.01,0.492,0.6753731343283582,398,406
17,904,10,100,1e-05,0.01,0.498,0.6703539823008849,441,463
17,1004,10,100,1e-05,0.01,0.482,0.6832669322709163,480,524
17,1104,10,100,1e-05,0.01,0.498,0.697463768115942,524,580
17,1204,10,100,1e-05,0.01,0.526,0.7259136212624585,579,625
17,1304,10,100,1e-05,0.01,0.506,0.723159509202454,629,675
17,1404,10,100,1e-05,0.01,0.538,0.7492877492877493,687,717
17,1504,10,100,1e-05,0.01,0.502,0.7413563829787234,737,767
17,1604,10,100,1e-05,0.01,0.502,0.7418952618453866,790,814
17,1704,10,100,1e-05,0.01,0.532,0.7036384976525821,837,867
17,1804,10,100,1e-05,0.01,0.504,0.7472283813747228,888,916
17,1904,10,100,1e-05,0.01,0.558,0.7253151260504201,941,963
17,2004,10,100,1e-05,0.01,0.548,0.7949101796407185,989,1015
17,2104,10,100,1e-05,0.01,0.562,0.8079847908745247,1043,1061
17,2204,10,100,1e-05,0.01,0.6,0.8348457350272233,1092,1112
17,2304,10,100,1e-05,0.01,0.55,0.7864583333333334,1138,1166
17,2404,10,100,1e-05,0.01,0.578,0.8069883527454242,1192,1212
17,2504,10,100,1e-05,0.01,0.588,0.8262779552715654,1245,1259
17,2604,10,100,1e-05,0.01,0.602,0.7980030721966206,1291,1313
17,2704,10,100,1e-05,0.01,0.604,0.8579881656804734,1346,1358
17,2804,10,100,1e-05,0.01,0.622,0.8281027104136948,1397,1407
17,2904,10,100,1e-05,0.01,0.636,0.8471074380165289,1450,1454
17,3004,10,100,1e-05,0.01,0.644,0.8655126498002663,1488,1516
17,3104,10,100,1e-05,0.01,0.662,0.8843427835051546,1536,1568
17,3204,10,100,1e-05,0.01,0.674,0.8686017478152309,1586,1618
17,3304,10,100,1e-05,0.01,0.682,0.8704600484261501,1621,1683
17,3404,10,100,1e-05,0.01,0.696,0.9018801410105758,1677,1727
17,3504,10,100,1e-05,0.01,0.694,0.9257990867579908,1727,1777
17,3604,10,100,1e-05,0.01,0.726,0.9286903440621531,1779,1825
17,3704,10,100,1e-05,0.01,0.754,0.9430345572354212,1828,1876
17,3804,10,100,1e-05,0.01,0.738,0.9555730809674028,1875,1929
17,3904,10,100,1e-05,0.01,0.788,0.9636270491803278,1932,1972
17,4004,10,100,1e-05,0.01,0.768,0.9652847152847153,1981,2023
17,4104,10,100,1e-05,0.01,0.768,0.9473684210526315,2037,2067
17,4204,10,100,1e-05,0.01,0.806,0.9624167459562322,2088,2116
17,4304,10,100,1e-05,0.01,0.818,0.9704925650557621,2147,2157
17,4404,10,100,1e-05,0.01,0.842,0.9793369663941871,2200,2204
17,4504,10,100,1e-05,0.01,0.84,0.9895648312611013,2256,2248
17,4604,10,100,1e-05,0.01,0.83,0.9889226759339704,2306,2298
17,4704,10,100,1e-05,0.01,0.858,0.9904336734693877,2351,2353
17,4804,10,100,1e-05,0.01,0.844,0.9922980849292257,2402,2402
17,4904,10,100,1e-05,0.01,0.86,0.9936786296900489,2442,2462
17,5004,10,100,1e-05,0.01,0.876,0.9952038369304557,2490,2514
17,5104,10,100,1e-05,0.01,0.864,0.9962774294670846,2537,2567
17,5204,10,100,1e-05,0.01,0.868,0.9942352036894696,2587,2617
17,5304,10,100,1e-05,0.01,0.862,0.9932126696832579,2636,2668
17,5404,10,100,1e-05,0.01,0.874,0.9913027387120651,2680,2724
17,5504,10,100,1e-05,0.01,0.882,0.9796511627906976,2723,2781
17,5604,10,100,1e-05,0.01,0.86,0.9841184867951464,2770,2834
17,5704,10,100,1e-05,0.01,0.874,0.9865007012622721,2817,2887
17,5804,10,100,1e-05,0.01,0.888,0.9903514817367333,2866,2938
17,5904,10,100,1e-05,0.01,0.886,0.9879742547425474,2921,2983
17,6004,10,100,1e-05,0.01,0.89,0.9908394403730846,2974,3030
17,6104,10,100,1e-05,0.01,0.906,0.9927916120576671,3021,3083
17,6204,10,100,1e-05,0.01,0.896,0.9906511927788524,3064,3140
17,6304,10,100,1e-05,0.01,0.892,0.9928616751269036,3112,3192
17,6404,10,100,1e-05,0.01,0.898,0.9845409119300437,3159,3245
17,6504,10,100,1e-05,0.01,0.908,0.9843173431734318,3201,3303
17,6604,10,100,1e-05,0.01,0.886,0.9834948516050879,3249,3355
17,6704,10,100,1e-05,0.01,0.874,0.9713603818615751,3299,3405
17,6804,10,100,1e-05,0.01,0.894,0.9766313932980599,3353,3451
17,6904,10,100,1e-05,0.01,0.908,0.9934820393974507,3406,3498
17,7004,10,100,1e-05,0.01,0.922,0.9957167332952599,3459,3545
17,7104,10,100,1e-05,0.01,0.924,0.9983108108108109,3509,3595
17,7204,10,100,1e-05,0.01,0.924,0.9969461410327596,3553,3651
17,7304,10,100,1e-05,0.01,0.938,0.9990416210295728,3612,3692
17,7404,10,100,1e-05,0.01,0.932,0.9993246893571043,3663,3741
17,7504,10,100,1e-05,0.01,0.932,0.9972014925373134,3706,3798
17,7604,10,100,1e-05,0.01,0.922,0.9948711204629143,3755,3849
17,7704,10,100,1e-05,0.01,0.926,0.991822429906542,3806,3898
17,7804,10,100,1e-05,0.01,0.922,0.9924397744746284,3858,3946
17,7904,10,100,1e-05,0.01,0.938,0.9951923076923077,3914,3990
17,8004,10,100,1e-05,0.01,0.932,0.9938780609695153,3959,4045
17,8104,10,100,1e-05,0.01,0.93,0.9945705824284304,4012,4092
17,8204,10,100,1e-05,0.01,0.924,0.9925646026328621,4059,4145
17,8304,10,100,1e-05,0.01,0.926,0.9926541425818882,4107,4197
17,8404,10,100,1e-05,0.01,0.938,0.9973821989528796,4150,4254
17,8504,10,100,1e-05,0.01,0.944,0.9989416745061148,4200,4304
17,8604,10,100,1e-05,0.01,0.944,0.9959321245932125,4250,4354
17,8704,10,100,1e-05,0.01,0.938,0.9947150735294118,4306,4398
17,8804,10,100,1e-05,0.01,0.948,0.9952294411631076,4357,4447
17,8904,10,100,1e-05,0.01,0.924,0.9810197663971248,4410,4494
17,9004,10,100,1e-05,0.01,0.948,0.9925588627276766,4458,4546
17,9104,10,100,1e-05,0.01,0.944,0.9880272407732865,4502,4602
17,9204,10,100,1e-05,0.01,0.946,0.9905475880052151,4544,4660
17,9304,10,100,1e-05,0.01,0.95,0.9980653482373173,4595,4709
17,9404,10,100,1e-05,0.01,0.95,0.997235219055721,4651,4753
17,9504,10,100,1e-05,0.01,0.958,0.998526936026936,4690,4814
17,9604,10,100,1e-05,0.01,0.95,0.9975010412328197,4743,4861
17,9704,10,100,1e-05,0.01,0.952,0.9949505358615004,4795,4909
17,9804,10,100,1e-05,0.01,0.952,0.9962260301917585,4847,4957
17,9904,10,100,1e-05,0.01,0.954,0.9952544426494345,4898,5006
17,10004,10,100,1e-05,0.01,0.958,0.9982007197121151,4943,5061
17,10104,10,100,1e-05,0.01,0.954,0.9969319081551861,5004,5100
17,10204,10,100,1e-05,0.01,0.96,0.9992159937279498,5052,5152
17,10304,10,100,1e-05,0.01,0.962,0.999611801242236,5102,5202
17,10404,10,100,1e-05,0.01,0.956,0.9982698961937716,5157,5247
17,10504,10,100,1e-05,0.01,0.958,0.9956207159177456,5208,5296
17,10604,10,100,1e-05,0.01,0.962,0.9923613730667673,5261,5343
17,10704,10,100,1e-05,0.01,0.964,0.9953288490284006,5309,5395
17,10804,10,100,1e-05,0.01,0.956,0.9909292854498334,5357,5447
17,10904,10,100,1e-05,0.01,0.968,0.995964783565664,5409,5495
17,11004,10,100,1e-05,0.01,0.97,0.9985459832788077,5455,5549
17,11104,10,100,1e-05,0.01,0.97,0.9972082132564841,5504,5600
17,11204,10,100,1e-05,0.01,0.974,0.9945555158871832,5554,5650
17,11304,10,100,1e-05,0.01,0.976,0.9984961075725407,5599,5705
17,11404,10,100,1e-05,0.01,0.972,0.9974570326201333,5647,5757
17,11504,10,100,1e-05,0.01,0.974,0.9986091794158554,5700,5804
17,11604,10,100,1e-05,0.01,0.976,0.9955187866253016,5754,5850
17,11704,10,100,1e-05,0.01,0.962,0.9968386876281613,5808,5896
17,11804,10,100,1e-05,0.01,0.964,0.9905964079972891,5856,5948
17,11904,10,100,1e-05,0.01,0.978,0.9944556451612904,5907,5997
17,12004,10,100,1e-05,0.01,0.976,0.9991669443518827,5953,6051
17,12104,10,100,1e-05,0.01,0.982,0.9990912095175148,5998,6106
17,12204,10,100,1e-05,0.01,0.98,0.9994264175680105,6050,6154
17,12304,10,100,1e-05,0.01,0.978,0.9992685305591678,6099,6205
17,12404,10,100,1e-05,0.01,0.98,0.9971783295711061,6149,6255
17,12504,10,100,1e-05,0.01,0.984,0.997680742162508,6191,6313
17,12604,10,100,1e-05,0.01,0.982,0.997778483021263,6246,6358
17,12704,10,100,1e-05,0.01,0.984,0.9988192695214105,6300,6404
17,12804,10,100,1e-05,0.01,0.98,0.9989846922836614,6360,6444
17,12904,10,100,1e-05,0.01,0.98,0.9991475511469312,6413,6491
17,13004,10,100,1e-05,0.01,0.986,0.9997693017533067,6465,6539
17,13104,10,100,1e-05,0.01,0.986,0.9998473748473748,6507,6597
17,13204,10,100,1e-05,0.01,0.986,0.9993941229930324,6563,6641
17,13304,10,100,1e-05,0.01,0.976,0.995414912808178,6616,6688
17,13404,10,100,1e-05,0.01,0.964,0.9878394509101761,6663,6741
17,13504,10,100,1e-05,0.01,0.98,0.9960752369668247,6713,6791
17,13604,10,100,1e-05,0.01,0.986,0.9982358129961776,6758,6846
17,13704,10,100,1e-05,0.01,0.982,0.9994162288382954,6810,6894
17,13804,10,100,1e-05,0.01,0.982,0.9999275572297884,6861,6943
17,13904,10,100,1e-05,0.01,0.98,0.9998561565017261,6913,6991
17,14004,10,100,1e-05,0.01,0.982,0.9997857754927164,6972,7032
17,14104,10,100,1e-05,0.01,0.988,1.0,7031,7073
17,14204,10,100,1e-05,0.01,0.984,0.9999295972965362,7077,7127
17,14304,10,100,1e-05,0.01,0.986,1.0,7132,7172
17,14404,10,100,1e-05,0.01,0.978,0.997917245209664,7184,7220
17,14504,10,100,1e-05,0.01,0.976,0.9940706012134584,7236,7268
17,14604,10,100,1e-05,0.01,0.986,0.9954122158312791,7287,7317
17,14704,10,100,1e-05,0.01,0.98,0.9972796517954298,7337,7367
17,14804,10,100,1e-05,0.01,0.988,0.9989867603350446,7388,7416
17,14904,10,100,1e-05,0.01,0.984,0.9992619431025228,7447,7457
17,15004,10,100,1e-05,0.01,0.982,0.9993335110637164,7494,7510
18,104,10,100,1e-05,0.01,0.538,0.5192307692307693,50,54
18,204,10,100,1e-05,0.01,0.482,0.6813725490196079,100,104
18,304,10,100,1e-05,0.01,0.492,0.6118421052631579,160,144
18,404,10,100,1e-05,0.01,0.518,0.5816831683168316,204,200
18,504,10,100,1e-05,0.01,0.534,0.5853174603174603,255,249
18,604,10,100,1e-05,0.01,0.462,0.6539735099337748,307,297
18,704,10,100,1e-05,0.01,0.498,0.6306818181818182,349,355
18,804,10,100,1e-05,0.01,0.494,0.6380597014925373,400,404
18,904,10,100,1e-05,0.01,0.494,0.6349557522123894,449,455
18,1004,10,100,1e-05,0.01,0.516,0.6922310756972112,498,506
18,1104,10,100,1e-05,0.01,0.522,0.707427536231884,548,556
18,1204,10,100,1e-05,0.01,0.53,0.6885382059800664,600,604
18,1304,10,100,1e-05,0.01,0.488,0.674079754601227,651,653
18,1404,10,100,1e-05,0.01,0.528,0.6752136752136753,699,705
18,1504,10,100,1e-05,0.01,0.514,0.7253989361702128,746,758
18,1604,10,100,1e-05,0.01,0.534,0.7680798004987531,802,802
18,1704,10,100,1e-05,0.01,0.56,0.7969483568075117,841,863
18,1804,10,100,1e-05,0.01,0.558,0.7621951219512195,898,906
18,1904,10,100,1e-05,0.01,0.556,0.7846638655462185,940,964
18,2004,10,100,1e-05,0.01,0.584,0.7619760479041916,994,1010
18,2104,10,100,1e-05,0.01,0.536,0.7699619771863118,1045,1059
18,2204,10,100,1e-05,0.01,0.578,0.7908348457350273,1103,1101
18,2304,10,100,1e-05,0.01,0.578,0.82421875,1150,1154
18,2404,10,100,1e-05,0.01,0.632,0.8306988352745425,1201,1203
18,2504,10,100,1e-05,0.01,0.642,0.8718051118210862,1253,1251
18,2604,10,100,1e-05,0.01,0.652,0.8460061443932412,1302,1302
18,2704,10,100,1e-05,0.01,0.654,0.8624260355029586,1356,1348
18,2804,10,100,1e-05,0.01,0.624,0.8234664764621968,1400,1404
18,2904,10,100,1e-05,0.01,0.648,0.8250688705234159,1444,1460
18,3004,10,100,1e-05,0.01,0.696,0.8435419440745673,1495,1509
18,3104,10,100,1e-05,0.01,0.656,0.8224871134020618,1545,1559
18,3204,10,100,1e-05,0.01,0.702,0.8789013732833958,1594,1610
18,3304,10,100,1e-05,0.01,0.728,0.9079903147699758,1644,1660
18,3404,10,100,1e-05,0.01,0.722,0.9109870740305523,1696,1708
18,3504,10,100,1e-05,0.01,0.738,0.9238013698630136,1751,1753
18,3604,10,100,1e-05,0.01,0.788,0.945338512763596,1800,1804
18,3704,10,100,1e-05,0.01,0.778,0.9481641468682506,1852,1852
18,3804,10,100,1e-05,0.01,0.804,0.964248159831756,1905,1899
18,3904,10,100,1e-05,0.01,0.808,0.9707991803278688,1946,1958
18,4004,10,100,1e-05,0.01,0.81,0.9767732267732268,1992,2012
18,4104,10,100,1e-05,0.01,0.812,0.9834307992202729,2043,2061
18,4204,10,100,1e-05,0.01,0.83,0.9809705042816366,2089,2115
18,4304,10,100,1e-05,0.01,0.826,0.9807156133828996,2144,2160
18,4404,10,100,1e-05,0.01,0.84,0.9772933696639419,2201,2203
18,4504,10,100,1e-05,0.01,0.806,0.9540408525754884,2251,2253
18,4604,10,100,1e-05,0.01,0.824,0.9774109470026064,2298,2306
18,4704,10,100,1e-05,0.01,0.83,0.9800170068027211,2353,2351
18,4804,10,100,1e-05,0.01,0.856,0.988759367194005,2395,2409
18,4904,10,100,1e-05,0.01,0.838,0.9820554649265906,2442,2462
18,5004,10,100,1e-05,0.01,0.854,0.9964028776978417,2494,2510
18,5104,10,100,1e-05,0.01,0.85,0.9947100313479624,2537,2567
18,5204,10,100,1e-05,0.01,0.874,0.9934665641813989,2592,2612
18,5304,10,100,1e-05,0.01,0.866,0.985105580693816,2634,2670
18,5404,10,100,1e-05,0.01,0.872,0.9935233160621761,2685,2719
18,5504,10,100,1e-05,0.01,0.88,0.9918241279069767,2740,2764
18,5604,10,100,1e-05,0.01,0.88,0.9925053533190579,2789,2815
18,5704,10,100,1e-05,0.01,0.87,0.9928120617110799,2833,2871
18,5804,10,100,1e-05,0.01,0.894,0.987250172294969,2885,2919
18,5904,10,100,1e-05,0.01,0.888,0.9954268292682927,2935,2969
18,6004,10,100,1e-05,0.01,0.884,0.9948367754830113,2996,3008
18,6104,10,100,1e-05,0.01,0.882,0.994429882044561,3053,3051
18,6204,10,100,1e-05,0.01,0.91,0.9921018697614442,3103,3101
18,6304,10,100,1e-05,0.01,0.91,0.9927030456852792,3149,3155
18,6404,10,100,1e-05,0.01,0.908,0.9942223610243598,3199,3205
18,6504,10,100,1e-05,0.01,0.888,0.9880073800738007,3247,3257
18,6604,10,100,1e-05,0.01,0.918,0.985160508782556,3289,3315
18,6704,10,100,1e-05,0.01,0.928,0.9928400954653938,3340,3364
18,6804,10,100,1e-05,0.01,0.924,0.9922104644326867,3392,3412
18,6904,10,100,1e-05,0.01,0.932,0.9836326767091541,3449,3455
18,7004,10,100,1e-05,0.01,0.916,0.9848657909765848,3496,3508
18,7104,10,100,1e-05,0.01,0.916,0.9676238738738738,3543,3561
18,7204,10,100,1e-05,0.01,0.93,0.9873681288173237,3598,3606
18,7304,10,100,1e-05,0.01,0.954,0.9917853231106243,3647,3657
18,7404,10,100,1e-05,0.01,0.94,0.9943273905996759,3692,3712
18,7504,10,100,1e-05,0.01,0.96,0.9977345415778252,3742,3762
18,7604,10,100,1e-05,0.01,0.962,0.9980273540241978,3788,3816
18,7704,10,100,1e-05,0.01,0.962,0.9989615784008308,3837,3867
18,7804,10,100,1e-05,0.01,0.96,0.9985904664274731,3884,3920
18,7904,10,100,1e-05,0.01,0.958,0.9993674089068826,3932,3972
18,8004,10,100,1e-05,0.01,0.954,0.9991254372813593,3979,4025
18,8104,10,100,1e-05,0.01,0.966,0.998395853899309,4038,4066
18,8204,10,100,1e-05,0.01,0.958,0.9963432471964895,4101,4103
18,8304,10,100,1e-05,0.01,0.968,0.997471098265896,4153,4151
18,8404,10,100,1e-05,0.01,0.956,0.9967872441694431,4208,4196
18,8504,10,100,1e-05,0.01,0.96,0.9978833490122295,4263,4241
18,8604,10,100,1e-05,0.01,0.958,0.9924453742445374,4307,4297
18,8704,10,100,1e-05,0.01,0.93,0.9892003676470589,4353,4351
18,8804,10,100,1e-05,0.01,0.954,0.993866424352567,4402,4402
18,8904,10,100,1e-05,0.01,0.944,0.9940476190476191,4452,4452
18,9004,10,100,1e-05,0.01,0.97,0.9932252332296757,4514,4490
18,9104,10,100,1e-05,0.01,0.968,0.9971441124780316,4553,4551
18,9204,10,100,1e-05,0.01,0.964,0.9973924380704041,4607,4597
18,9304,10,100,1e-05,0.01,0.96,0.9972055030094583,4652,4652
18,9404,10,100,1e-05,0.01,0.964,0.9957464908549554,4694,4710
18,9504,10,100,1e-05,0.01,0.97,0.9960016835016835,4745,4759
18,9604,10,100,1e-05,0.01,0.96,0.9968763015410246,4804,4800
18,9704,10,100,1e-05,0.01,0.97,0.9955688375927453,4852,4852
18,9804,10,100,1e-05,0.01,0.972,0.9925540595675234,4908,4896
18,9904,10,100,1e-05,0.01,0.968,0.9961631663974152,4954,4950
18,10004,10,100,1e-05,0.01,0.958,0.9828068772491003,5000,5004
18,10104,10,100,1e-05,0.01,0.976,0.993368962787015,5048,5056
18,10204,10,100,1e-05,0.01,0.968,0.9956879655037241,5096,5108
18,10304,10,100,1e-05,0.01,0.976,0.9981560559006211,5141,5163
18,10404,10,100,1e-05,0.01,0.976,0.9954825067281815,5200,5204
18,10504,10,100,1e-05,0.01,0.98,0.9978103579588729,5253,5251
18,10604,10,100,1e-05,0.01,0.972,0.9968879668049793,5302,5302
18,10704,10,100,1e-05,0.01,0.974,0.9940209267563528,5357,5347
18,10804,10,100,1e-05,0.01,0.972,0.9946316179192891,5399,5405
18,10904,10,100,1e-05,0.01,0.978,0.9978906823184153,5453,5451
18,11004,10,100,1e-05,0.01,0.972,0.9960923300617958,5502,5502
18,11104,10,100,1e-05,0.01,0.972,0.9936059077809798,5554,5550
18,11204,10,100,1e-05,0.01,0.976,0.9957158157800785,5604,5600
18,11304,10,100,1e-05,0.01,0.972,0.9930997876857749,5658,5646
18,11404,10,100,1e-05,0.01,0.974,0.9964924587863907,5710,5694
18,11504,10,100,1e-05,0.01,0.982,0.9969575799721836,5758,5746
18,11604,10,100,1e-05,0.01,0.974,0.9985349879351948,5819,5785
18,11704,10,100,1e-05,0.01,0.982,0.9991455912508544,5868,5836
18,11804,10,100,1e-05,0.01,0.982,0.9990681125042359,5912,5892
18,11904,10,100,1e-05,0.01,0.984,0.9986559139784946,5958,5946
18,12004,10,100,1e-05,0.01,0.98,0.9920026657780739,6006,5998
18,12104,10,100,1e-05,0.01,0.982,0.9976040978189028,6046,6058
18,12204,10,100,1e-05,0.01,0.978,0.9971320878400525,6092,6112
18,12304,10,100,1e-05,0.01,0.988,0.9973179453836151,6152,6152
18,12404,10,100,1e-05,0.01,0.984,0.9954853273137697,6197,6207
18,12504,10,100,1e-05,0.01,0.978,0.9980806142034548,6244,6260
18,12604,10,100,1e-05,0.01,0.976,0.9965883846397969,6295,6309
18,12704,10,100,1e-05,0.01,0.974,0.9943324937027708,6349,6355
18,12804,10,100,1e-05,0.01,0.982,0.9964073726960325,6399,6405
18,12904,10,100,1e-05,0.01,0.982,0.9986050836949782,6450,6454
18,13004,10,100,1e-05,0.01,0.988,0.9985389111042756,6497,6507
18,13104,10,100,1e-05,0.01,0.986,0.9981684981684982,6543,6561
18,13204,10,100,1e-05,0.01,0.988,0.997122084216904,6592,6612
18,13304,10,100,1e-05,0.01,0.99,0.9993235117257967,6653,6651
18,13404,10,100,1e-05,0.01,0.988,0.9997761862130707,6703,6701
18,13504,10,100,1e-05,0.01,0.988,0.9991113744075829,6760,6744
18,13604,10,100,1e-05,0.01,0.984,0.9985298441634813,6808,6796
18,13704,10,100,1e-05,0.01,0.986,0.998029772329247,6861,6843
18,13804,10,100,1e-05,0.01,0.978,0.9972471747319618,6913,6891
18,13904,10,100,1e-05,0.01,0.982,0.9966196777905638,6962,6942
18,14004,10,100,1e-05,0.01,0.976,0.9925021422450728,7017,6987
18,14104,10,100,1e-05,0.01,0.982,0.9964549064095292,7069,7035
18,14204,10,100,1e-05,0.01,0.982,0.996268656716418,7113,7091
18,14304,10,100,1e-05,0.01,0.992,0.9964345637583892,7168,7136
18,14404,10,100,1e-05,0.01,0.986,0.9904193279644543,7214,7190
18,14504,10,100,1e-05,0.01,0.988,0.9967595146166575,7262,7242
18,14604,10,100,1e-05,0.01,0.988,0.9984250890167078,7310,7294
18,14704,10,100,1e-05,0.01,0.994,0.9983677910772579,7364,7340
18,14804,10,100,1e-05,0.01,0.992,0.99750067549311,7418,7386
18,14904,10,100,1e-05,0.01,0.99,0.9995303274288782,7468,7436
18,15004,10,100,1e-05,0.01,0.992,0.9998667022127433,7521,7483
19,104,10,100,1e-05,0.01,0.478,0.5096153846153846,52,52
19,204,10,100,1e-05,0.01,0.484,0.6519607843137255,106,98
19,304,10,100,1e-05,0.01,0.458,0.6513157894736842,153,151
19,404,10,100,1e-05,0.01,0.454,0.6212871287128713,212,192
19,504,10,100,1e-05,0.01,0.456,0.6329365079365079,266,238
19,604,10,100,1e-05,0.01,0.468,0.6655629139072847,317,287
19,704,10,100,1e-05,0.01,0.492,0.6605113636363636,360,344
19,804,10,100,1e-05,0.01,0.472,0.667910447761194,410,394
19,904,10,100,1e-05,0.01,0.5,0.6747787610619469,454,450
19,1004,10,100,1e-05,0.01,0.484,0.7151394422310757,503,501
19,1104,10,100,1e-05,0.01,0.484,0.6757246376811594,550,554
19,1204,10,100,1e-05,0.01,0.544,0.6794019933554817,597,607
19,1304,10,100,1e-05,0.01,0.486,0.6710122699386503,644,660
19,1404,10,100,1e-05,0.01,0.53,0.6830484330484331,701,703
19,1504,10,100,1e-05,0.01,0.496,0.694813829787234,748,756
19,1604,10,100,1e-05,0.01,0.51,0.7418952618453866,795,809
19,1704,10,100,1e-05,0.01,0.512,0.767018779342723,849,855
19,1804,10,100,1e-05,0.01,0.504,0.8021064301552107,899,905
19,1904,10,100,1e-05,0.01,0.502,0.7993697478991597,956,948
19,2004,10,100,1e-05,0.01,0.562,0.7924151696606786,1008,996
19,2104,10,100,1e-05,0.01,0.532,0.7633079847908745,1059,1045
19,2204,10,100,1e-05,0.01,0.528,0.7767695099818511,1115,1089
19,2304,10,100,1e-05,0.01,0.532,0.7877604166666666,1168,1136
19,2404,10,100,1e-05,0.01,0.54,0.8086522462562395,1216,1188
19,2504,10,100,1e-05,0.01,0.58,0.8015175718849841,1259,1245
19,2604,10,100,1e-05,0.01,0.572,0.8110599078341014,1308,1296
19,2704,10,100,1e-05,0.01,0.572,0.8620562130177515,1365,1339
19,2804,10,100,1e-05,0.01,0.586,0.854493580599144,1410,1394
19,2904,10,100,1e-05,0.01,0.578,0.8505509641873278,1460,1444
19,3004,10,100,1e-05,0.01,0.586,0.8651797603195739,1514,1490
19,3104,10,100,1e-05,0.01,0.6,0.8563144329896907,1567,1537
19,3204,10,100,1e-05,0.01,0.596,0.8929463171036205,1611,1593
19,3304,10,100,1e-05,0.01,0.592,0.8571428571428571,1663,1641
19,3404,10,100,1e-05,0.01,0.626,0.913337250293772,1712,1692
19,3504,10,100,1e-05,0.01,0.646,0.9186643835616438,1763,1741
19,3604,10,100,1e-05,0.01,0.64,0.9275804661487237,1812,1792
19,3704,10,100,1e-05,0.01,0.64,0.9384449244060475,1859,1845
19,3804,10,100,1e-05,0.01,0.676,0.9411146161934806,1909,1895
19,3904,10,100,1e-05,0.01,0.664,0.9377561475409836,1964,1940
19,4004,10,100,1e-05,0.01,0.626,0.9270729270729271,2009,1995
19,4104,10,100,1e-05,0.01,0.674,0.9269005847953217,2060,2044
19,4204,10,100,1e-05,0.01,0.69,0.9107992388201712,2111,2093
19,4304,10,100,1e-05,0.01,0.674,0.8506040892193308,2160,2144
19,4404,10,100,1e-05,0.01,0.706,0.9164396003633061,2218,2186
19,4504,10,100,1e-05,0.01,0.718,0.9234014209591475,2268,2236
19,4604,10,100,1e-05,0.01,0.712,0.9313640312771503,2312,2292
19,4704,10,100,1e-05,0.01,0.744,0.9604591836734694,2362,2342
19,4804,10,100,1e-05,0.01,0.738,0.9585761865112407,2413,2391
19,4904,10,100,1e-05,0.01,0.764,0.9716557911908646,2461,2443
19,5004,10,100,1e-05,0.01,0.762,0.9646282973621103,2508,2496
19,5104,10,100,1e-05,0.01,0.736,0.9713949843260188,2559,2545
19,5204,10,100,1e-05,0.01,0.732,0.9657955418908531,2623,2581
19,5304,10,100,1e-05,0.01,0.758,0.9622926093514329,2673,2631
19,5404,10,100,1e-05,0.01,0.772,0.9759437453737971,2721,2683
19,5504,10,100,1e-05,0.01,0.79,0.9723837209302325,2774,2730
19,5604,10,100,1e-05,0.01,0.78,0.9746609564596717,2824,2780
19,5704,10,100,1e-05,0.01,0.79,0.9523141654978962,2882,2822
19,5804,10,100,1e-05,0.01,0.794,0.9655410062026188,2935,2869
19,5904,10,100,1e-05,0.01,0.802,0.9740853658536586,2987,2917
19,6004,10,100,1e-05,0.01,0.792,0.9701865423051299,3039,2965
19,6104,10,100,1e-05,0.01,0.772,0.9655963302752294,3093,3011
19,6204,10,100,1e-05,0.01,0.792,0.980174081237911,3139,3065
19,6304,10,100,1e-05,0.01,0.814,0.9855647208121827,3189,3115
19,6404,10,100,1e-05,0.01,0.82,0.9898500936914428,3242,3162
19,6504,10,100,1e-05,0.01,0.824,0.971709717097171,3294,3210
19,6604,10,100,1e-05,0.01,0.806,0.9692610539067232,3344,3260
19,6704,10,100,1e-05,0.01,0.83,0.9801610978520287,3395,3309
19,6804,10,100,1e-05,0.01,0.814,0.9742798353909465,3439,3365
19,6904,10,100,1e-05,0.01,0.806,0.9495944380069525,3478,3426
19,7004,10,100,1e-05,0.01,0.83,0.9657338663620788,3527,3477
19,7104,10,100,1e-05,0.01,0.848,0.9790259009009009,3586,3518
19,7204,10,100,1e-05,0.01,0.848,0.9797334813992227,3627,3577
19,7304,10,100,1e-05,0.01,0.85,0.9874041621029573,3674,3630
19,7404,10,100,1e-05,0.01,0.828,0.9877093462992976,3720,3684
19,7504,10,100,1e-05,0.01,0.842,0.9870735607675906,3769,3735
19,7604,10,100,1e-05,0.01,0.842,0.980405049973698,3819,3785
19,7704,10,100,1e-05,0.01,0.854,0.9875389408099688,3862,3842
19,7804,10,100,1e-05,0.01,0.868,0.9835981547924142,3913,3891
19,7904,10,100,1e-05,0.01,0.878,0.9874746963562753,3969,3935
19,8004,10,100,1e-05,0.01,0.85,0.9826336831584208,4025,3979
19,8104,10,100,1e-05,0.01,0.868,0.9853158933859822,4070,4034
19,8204,10,100,1e-05,0.01,0.854,0.984763529985373,4119,4085
19,8304,10,100,1e-05,0.01,0.87,0.9844653179190751,4163,4141
19,8404,10,100,1e-05,0.01,0.854,0.985721085197525,4217,4187
19,8504,10,100,1e-05,0.01,0.852,0.9761288805268109,4272,4232
19,8604,10,100,1e-05,0.01,0.82,0.9429335192933519,4328,4276
19,8704,10,100,1e-05,0.01,0.84,0.9474954044117647,4375,4329
19,8804,10,100,1e-05,0.01,0.85,0.9555883689232167,4416,4388
19,8904,10,100,1e-05,0.01,0.862,0.977088948787062,4466,4438
19,9004,10,100,1e-05,0.01,0.866,0.9905597512216793,4521,4483
19,9104,10,100,1e-05,0.01,0.894,0.9930799648506151,4568,4536
19,9204,10,100,1e-05,0.01,0.87,0.9716427640156454,4620,4584
19,9304,10,100,1e-05,0.01,0.832,0.9537833190025795,4671,4633
19,9404,10,100,1e-05,0.01,0.848,0.9651212250106338,4722,4682
19,9504,10,100,1e-05,0.01,0.866,0.9756944444444444,4767,4737
19,9604,10,100,1e-05,0.01,0.886,0.9843815077051229,4821,4783
19,9704,10,100,1e-05,0.01,0.884,0.9881492168178071,4873,4831
19,9804,10,100,1e-05,0.01,0.89,0.9841901264789882,4924,4880
19,9904,10,100,1e-05,0.01,0.898,0.9913166397415186,4980,4924
19,10004,10,100,1e-05,0.01,0.906,0.9909036385445822,5028,4976
19,10104,10,100,1e-05,0.01,0.908,0.9927751385589866,5081,5023
19,10204,10,100,1e-05,0.01,0.898,0.9905919247353979,5134,5070
19,10304,10,100,1e-05,0.01,0.882,0.9866071428571429,5188,5116
19,10404,10,100,1e-05,0.01,0.886,0.9777008842752788,5241,5163
19,10504,10,100,1e-05,0.01,0.894,0.9723914699162224,5290,5214
19,10604,10,100,1e-05,0.01,0.892,0.9850999622783855,5341,5263
19,10704,10,100,1e-05,0.01,0.916,0.992059043348281,5390,5314
19,10804,10,100,1e-05,0.01,0.904,0.9953720844131803,5442,5362
19,10904,10,100,1e-05,0.01,0.908,0.9941305942773294,5498,5406
19,11004,10,100,1e-05,0.01,0.916,0.9967284623773174,5551,5453
19,11104,10,100,1e-05,0.01,0.932,0.9975684438040345,5601,5503
19,11204,10,100,1e-05,0.01,0.912,0.9945555158871832,5654,5550
19,11304,10,100,1e-05,0.01,0.916,0.9913305024769993,5708,5596
19,11404,10,100,1e-05,0.01,0.894,0.972378112942827,5766,5638
19,11504,10,100,1e-05,0.01,0.928,0.9714881780250347,5808,5696
19,11604,10,100,1e-05,0.01,0.932,0.9894002068252327,5867,5737
19,11704,10,100,1e-05,0.01,0.926,0.9857313738892687,5917,5787
19,11804,10,100,1e-05,0.01,0.938,0.994916977295832,5955,5849
19,11904,10,100,1e-05,0.01,0.93,0.9949596774193549,5999,5905
19,12004,10,100,1e-05,0.01,0.934,0.9947517494168611,6049,5955
19,12104,10,100,1e-05,0.01,0.94,0.9974388631857237,6093,6011
19,12204,10,100,1e-05,0.01,0.926,0.9880367092756474,6136,6068
19,12304,10,100,1e-05,0.01,0.914,0.9830949284785435,6199,6105
19,12404,10,100,1e-05,0.01,0.944,0.9912125120928733,6245,6159
19,12504,10,100,1e-05,0.01,0.944,0.994721689059501,6290,6214
19,12604,10,100,1e-05,0.01,0.942,0.9953982862583307,6337,6267
19,12704,10,100,1e-05,0.01,0.932,0.9944112090680101,6384,6320
19,12804,10,100,1e-05,0.01,0.93,0.9932052483598875,6432,6372
19,12904,10,100,1e-05,0.01,0.946,0.9967451952882826,6483,6421
19,13004,10,100,1e-05,0.01,0.926,0.9930021531836358,6539,6465
19,13104,10,100,1e-05,0.01,0.94,0.9911477411477412,6590,6514
19,13204,10,100,1e-05,0.01,0.938,0.9935625568009694,6639,6565
19,13304,10,100,1e-05,0.01,0.944,0.9877480457005412,6682,6622
19,13404,10,100,1e-05,0.01,0.948,0.9938824231572665,6740,6664
19,13504,10,100,1e-05,0.01,0.944,0.988077606635071,6783,6721
19,13604,10,100,1e-05,0.01,0.946,0.9921346662746251,6840,6764
19,13704,10,100,1e-05,0.01,0.938,0.9905137186223001,6881,6823
19,13804,10,100,1e-05,0.01,0.956,0.9937699217618081,6931,6873
19,13904,10,100,1e-05,0.01,0.966,0.9951093210586881,6985,6919
19,14004,10,100,1e-05,0.01,0.96,0.9978577549271637,7030,6974
19,14104,10,100,1e-05,0.01,0.958,0.9950368689733409,7074,7030
19,14204,10,100,1e-05,0.01,0.958,0.9951422134609968,7118,7086
19,14304,10,100,1e-05,0.01,0.958,0.993847874720358,7173,7131
19,14404,10,100,1e-05,0.01,0.958,0.9969452929741739,7223,7181
19,14504,10,100,1e-05,0.01,0.958,0.9945532266960838,7275,7229
19,14604,10,100,1e-05,0.01,0.948,0.986510545056149,7331,7273
19,14704,10,100,1e-05,0.01,0.958,0.9932671381936888,7376,7328
19,14804,10,100,1e-05,0.01,0.962,0.9954066468522021,7425,7379
19,14904,10,100,1e-05,0.01,0.956,0.995101986044015,7468,7436
19,15004,10,100,1e-05,0.01,0.96,0.9959344174886697,7515,7489
20,104,10,100,1e-05,0.01,0.5,0.5192307692307693,54,50
20,204,10,100,1e-05,0.01,0.51,0.6666666666666666,99,105
20,304,10,100,1e-05,0.01,0.522,0.5921052631578947,154,150
20,404,10,100,1e-05,0.01,0.518,0.6584158415841584,211,193
20,504,10,100,1e-05,0.01,0.526,0.6448412698412699,261,243
20,604,10,100,1e-05,0.01,0.484,0.6837748344370861,311,293
20,704,10,100,1e-05,0.01,0.504,0.6732954545454546,369,335
20,804,10,100,1e-05,0.01,0.476,0.6840796019900498,422,382
20,904,10,100,1e-05,0.01,0.484,0.6692477876106194,467,437
20,1004,10,100,1e-05,0.01,0.476,0.6882470119521913,518,486
20,1104,10,100,1e-05,0.01,0.53,0.6929347826086957,566,538
20,1204,10,100,1e-05,0.01,0.494,0.7333887043189369,616,588
20,1304,10,100,1e-05,0.01,0.528,0.7323619631901841,662,642
20,1404,10,100,1e-05,0.01,0.502,0.7549857549857549,721,683
20,1504,10,100,1e-05,0.01,0.528,0.7519946808510638,763,741
20,1604,10,100,1e-05,0.01,0.526,0.7468827930174564,818,786
20,1704,10,100,1e-05,0.01,0.53,0.7617370892018779,864,840
20,1804,10,100,1e-05,0.01,0.564,0.7932372505543237,912,892
20,1904,10,100,1e-05,0.01,0.544,0.8025210084033614,961,943
20,2004,10,100,1e-05,0.01,0.582,0.8038922155688623,1010,994
20,2104,10,100,1e-05,0.01,0.588,0.8060836501901141,1068,1036
20,2204,10,100,1e-05,0.01,0.616,0.838475499092559,1120,1084
20,2304,10,100,1e-05,0.01,0.62,0.8541666666666666,1173,1131
20,2404,10,100,1e-05,0.01,0.646,0.8851913477537438,1216,1188
20,2504,10,100,1e-05,0.01,0.64,0.9085463258785943,1272,1232
20,2604,10,100,1e-05,0.01,0.662,0.8755760368663594,1326,1278
20,2704,10,100,1e-05,0.01,0.666,0.8520710059171598,1374,1330
20,2804,10,100,1e-05,0.01,0.656,0.8773181169757489,1419,1385
20,2904,10,100,1e-05,0.01,0.734,0.9028925619834711,1473,1431
20,3004,10,100,1e-05,0.01,0.746,0.9117842876165113,1522,1482
20,3104,10,100,1e-05,0.01,0.72,0.8891752577319587,1565,1539
20,3204,10,100,1e-05,0.01,0.772,0.9410112359550562,1609,1595
20,3304,10,100,1e-05,0.01,0.79,0.9567191283292978,1661,1643
20,3404,10,100,1e-05,0.01,0.776,0.9562279670975323,1712,1692
20,3504,10,100,1e-05,0.01,0.77,0.9463470319634704,1760,1744
20,3604,10,100,1e-05,0.01,0.812,0.9608768035516093,1813,1791
20,3704,10,100,1e-05,0.01,0.792,0.9524838012958964,1862,1842
20,3804,10,100,1e-05,0.01,0.79,0.9637223974763407,1910,1894
20,3904,10,100,1e-05,0.01,0.816,0.9802766393442623,1967,1937
20,4004,10,100,1e-05,0.01,0.828,0.9812687312687313,2029,1975
20,4104,10,100,1e-05,0.01,0.834,0.9800194931773879,2083,2021
20,4204,10,100,1e-05,0.01,0.842,0.9762131303520457,2134,2070
20,4304,10,100,1e-05,0.01,0.826,0.9537639405204461,2178,2126
20,4404,10,100,1e-05,0.01,0.842,0.9816076294277929,2235,2169
20,4504,10,100,1e-05,0.01,0.848,0.980683836589698,2282,2222
20,4604,10,100,1e-05,0.01,0.858,0.9887054735013032,2322,2282
20,4704,10,100,1e-05,0.01,0.882,0.9938350340136054,2378,2326
20,4804,10,100,1e-05,0.01,0.882,0.9937552039966694,2426,2378
20,4904,10,100,1e-05,0.01,0.884,0.9889885807504079,2472,2432
20,5004,10,100,1e-05,0.01,0.868,0.9792166266986411,2527,2477
20,5104,10,100,1e-05,0.01,0.882,0.9898119122257053,2574,2530
20,5204,10,100,1e-05,0.01,0.89,0.9644504227517294,2616,2588
20,5304,10,100,1e-05,0.01,0.882,0.9786953242835595,2669,2635
20,5404,10,100,1e-05,0.01,0.88,0.9833456698741673,2717,2687
20,5504,10,100,1e-05,0.01,0.878,0.9876453488372093,2770,2734
20,5604,10,100,1e-05,0.01,0.896,0.9894718058529621,2817,2787
20,5704,10,100,1e-05,0.01,0.898,0.9940392706872371,2863,2841
20,5804,10,100,1e-05,0.01,0.916,0.9943142660234321,2912,2892
20,5904,10,100,1e-05,0.01,0.914,0.9935636856368564,2954,2950
20,6004,10,100,1e-05,0.01,0.91,0.9955029980013325,3001,3003
20,6104,10,100,1e-05,0.01,0.912,0.987221494102228,3053,3051
20,6204,10,100,1e-05,0.01,0.912,0.9953255963894262,3102,3102
20,6304,10,100,1e-05,0.01,0.926,0.9938134517766497,3146,3158
20,6404,10,100,1e-05,0.01,0.914,0.9900062460961899,3201,3203
20,6504,10,100,1e-05,0.01,0.93,0.997539975399754,3247,3257
20,6604,10,100,1e-05,0.01,0.932,0.9936402180496668,3299,3305
20,6704,10,100,1e-05,0.01,0.926,0.9943317422434368,3349,3355
20,6804,10,100,1e-05,0.01,0.924,0.9945620223398001,3399,3405
20,6904,10,100,1e-05,0.01,0.932,0.994351100811124,3437,3467
20,7004,10,100,1e-05,0.01,0.932,0.9934323243860651,3493,3511
20,7104,10,100,1e-05,0.01,0.93,0.9942286036036037,3549,3555
20,7204,10,100,1e-05,0.01,0.922,0.9882009994447529,3596,3608
20,7304,10,100,1e-05,0.01,0.934,0.9939759036144579,3644,3660
20,7404,10,100,1e-05,0.01,0.934,0.9928417071853053,3694,3710
20,7504,10,100,1e-05,0.01,0.942,0.9948027718550106,3743,3761
20,7604,10,100,1e-05,0.01,0.944,0.9886901630720674,3801,3803
20,7704,10,100,1e-05,0.01,0.946,0.9909138110072689,3844,3860
20,7804,10,100,1e-05,0.01,0.934,0.9879548949256791,3892,3912
20,7904,10,100,1e-05,0.01,0.942,0.9949392712550608,3939,3965
20,8004,10,100,1e-05,0.01,0.95,0.9960019990004998,3989,4015
20,8104,10,100,1e-05,0.01,0.942,0.9948173741362291,4029,4075
20,8204,10,100,1e-05,0.01,0.948,0.9964651389566065,4077,4127
20,8304,10,100,1e-05,0.01,0.948,0.9961464354527938,4126,4178
20,8404,10,100,1e-05,0.01,0.948,0.9946454069490719,4178,4226
20,8504,10,100,1e-05,0.01,0.948,0.9912982126058325,4225,4279
20,8604,10,100,1e-05,0.01,0.956,0.9961645746164575,4281,4323
20,8704,10,100,1e-05,0.01,0.956,0.9943704044117647,4335,4369
20,8804,10,100,1e-05,0.01,0.952,0.9975011358473421,4388,4416
20,8904,10,100,1e-05,0.01,0.958,0.9959568733153639,4435,4469
20,9004,10,100,1e-05,0.01,0.958,0.9956685917370057,4486,4518
20,9104,10,100,1e-05,0.01,0.96,0.9953866432337434,4537,4567
20,9204,10,100,1e-05,0.01,0.96,0.997283789656671,4586,4618
20,9304,10,100,1e-05,0.01,0.96,0.9939810834049871,4638,4666
20,9404,10,100,1e-05,0.01,0.956,0.9959591663122076,4683,4721
20,9504,10,100,1e-05,0.01,0.95,0.9945286195286195,4737,4767
20,9604,10,100,1e-05,0.01,0.952,0.9920866305705955,4791,4813
20,9704,10,100,1e-05,0.01,0.958,0.9904163231657048,4841,4863
20,9804,10,100,1e-05,0.01,0.952,0.9904120767033864,4890,4914
20,9904,10,100,1e-05,0.01,0.962,0.9964660743134087,4947,4957
20,10004,10,100,1e-05,0.01,0.966,0.9915033986405438,4999,5005
20,10104,10,100,1e-05,0.01,0.966,0.9937648456057007,5046,5058
20,10204,10,100,1e-05,0.01,0.978,0.9972559780478244,5090,5114
20,10304,10,100,1e-05,0.01,0.968,0.9970885093167702,5137,5167
20,10404,10,100,1e-05,0.01,0.972,0.9982698961937716,5190,5214
20,10504,10,100,1e-05,0.01,0.978,0.9988575780654989,5248,5256
20,10604,10,100,1e-05,0.01,0.964,0.996605054696341,5309,5295
20,10704,10,100,1e-05,0.01,0.966,0.992526158445441,5362,5342
20,10804,10,100,1e-05,0.01,0.974,0.9986116253239541,5410,5394
20,10904,10,100,1e-05,0.01,0.962,0.9914710198092443,5460,5444
20,11004,10,100,1e-05,0.01,0.968,0.9931842966194111,5505,5499
20,11104,10,100,1e-05,0.01,0.962,0.9882024495677233,5556,5548
20,11204,10,100,1e-05,0.01,0.976,0.9949125312388433,5604,5600
20,11304,10,100,1e-05,0.01,0.968,0.9982307147912244,5656,5648
20,11404,10,100,1e-05,0.01,0.978,0.9980708523325149,5706,5698
20,11504,10,100,1e-05,0.01,0.97,0.9974791376912379,5757,5747
20,11604,10,100,1e-05,0.01,0.98,0.9985349879351948,5805,5799
20,11704,10,100,1e-05,0.01,0.984,0.9970095693779905,5859,5845
20,11804,10,100,1e-05,0.01,0.982,0.9993222636394442,5902,5902
20,11904,10,100,1e-05,0.01,0.972,0.9968077956989247,5968,5936
20,12004,10,100,1e-05,0.01,0.978,0.9955848050649784,6016,5988
20,12104,10,100,1e-05,0.01,0.98,0.9971083939193655,6062,6042
20,12204,10,100,1e-05,0.01,0.97,0.9947558177646674,6115,6089
20,12304,10,100,1e-05,0.01,0.98,0.9963426527958388,6161,6143
20,12404,10,100,1e-05,0.01,0.976,0.9983876168977749,6208,6196
20,12504,10,100,1e-05,0.01,0.97,0.995361484325016,6258,6246
20,12604,10,100,1e-05,0.01,0.976,0.9959536655030149,6311,6293
20,12704,10,100,1e-05,0.01,0.974,0.9951983627204031,6356,6348
20,12804,10,100,1e-05,0.01,0.974,0.9919556388628553,6401,6403
20,12904,10,100,1e-05,0.01,0.974,0.9930254184748915,6441,6463
20,13004,10,100,1e-05,0.01,0.976,0.9976161181175023,6489,6515
20,13104,10,100,1e-05,0.01,0.974,0.9991605616605617,6531,6573
20,13204,10,100,1e-05,0.01,0.978,0.999924265374129,6592,6612
20,13304,10,100,1e-05,0.01,0.982,0.9998496692723993,6641,6663
20,13404,10,100,1e-05,0.01,0.978,0.9997761862130707,6693,6711
20,13504,10,100,1e-05,0.01,0.982,1.0,6744,6760
20,13604,10,100,1e-05,0.01,0.98,0.9986768597471332,6792,6812
20,13704,10,100,1e-05,0.01,0.982,0.9999270286047869,6841,6863
20,13804,10,100,1e-05,0.01,0.98,0.9993480150680962,6891,6913
20,13904,10,100,1e-05,0.01,0.982,0.9997842347525892,6946,6958
20,14004,10,100,1e-05,0.01,0.982,0.9999285918309054,6991,7013
20,14104,10,100,1e-05,0.01,0.98,0.9997163925127623,7046,7058
20,14204,10,100,1e-05,0.01,0.978,0.9978175161926218,7093,7111
20,14304,10,100,1e-05,0.01,0.958,0.9838506711409396,7141,7163
20,14404,10,100,1e-05,0.01,0.982,0.9928492085531797,7196,7208
20,14504,10,100,1e-05,0.01,0.97,0.9982073910645339,7243,7261
20,14604,10,100,1e-05,0.01,0.982,0.9993837304847987,7299,7305
20,14704,10,100,1e-05,0.01,0.982,0.9995239390642002,7344,7360
20,14804,10,100,1e-05,0.01,0.98,0.9999324506890029,7394,7410
20,14904,10,100,1e-05,0.01,0.98,0.9996645195920558,7449,7455
20,15004,10,100,1e-05,0.01,0.976,0.9959344174886697,7502,7502
1,104,10,100,0.0001,0.01,0.504,0.5576923076923077,57,47
1,204,10,100,0.0001,0.01,0.502,0.6274509803921569,100,104
1,304,10,100,0.0001,0.01,0.504,0.6578947368421053,145,159
1,404,10,100,0.0001,0.01,0.504,0.6534653465346535,189,215
1,504,10,100,0.0001,0.01,0.494,0.6507936507936508,240,264
1,604,10,100,0.0001,0.01,0.502,0.6771523178807947,288,316
1,704,10,100,0.0001,0.01,0.524,0.6818181818181818,333,371
1,804,10,100,0.0001,0.01,0.512,0.677860696517413,390,414
1,904,10,100,0.0001,0.01,0.504,0.6880530973451328,445,459
1,1004,10,100,0.0001,0.01,0.48,0.6703187250996016,494,510
1,1104,10,100,0.0001,0.01,0.488,0.6612318840579711,535,569
1,1204,10,100,0.0001,0.01,0.488,0.6926910299003323,586,618
1,1304,10,100,0.0001,0.01,0.47,0.656441717791411,631,673
1,1404,10,100,0.0001,0.01,0.49,0.6937321937321937,680,724
1,1504,10,100,0.0001,0.01,0.462,0.680186170212766,726,778
1,1604,10,100,0.0001,0.01,0.516,0.6807980049875312,781,823
1,1704,10,100,0.0001,0.01,0.504,0.6854460093896714,824,880
1,1804,10,100,0.0001,0.01,0.524,0.7289356984478935,873,931
1,1904,10,100,0.0001,0.01,0.522,0.7284663865546218,924,980
1,2004,10,100,0.0001,0.01,0.504,0.7639720558882236,977,1027
1,2104,10,100,0.0001,0.01,0.524,0.7609315589353612,1034,1070
1,2204,10,100,0.0001,0.01,0.55,0.8103448275862069,1086,1118
1,2304,10,100,0.0001,0.01,0.566,0.8090277777777778,1142,1162
1,2404,10,100,0.0001,0.01,0.59,0.8194675540765392,1186,1218
1,2504,10,100,0.0001,0.01,0.582,0.8262779552715654,1237,1267
1,2604,10,100,0.0001,0.01,0.596,0.8486943164362519,1283,1321
1,2704,10,100,0.0001,0.01,0.606,0.8594674556213018,1332,1372
1,2804,10,100,0.0001,0.01,0.64,0.8502139800285307,1378,1426
1,2904,10,100,0.0001,0.01,0.618,0.828168044077135,1424,1480
1,3004,10,100,0.0001,0.01,0.65,0.8418774966711052,1474,1530
1,3104,10,100,0.0001,0.01,0.644,0.8472938144329897,1527,1577
1,3204,10,100,0.0001,0.01,0.686,0.885143570536829,1576,1628
1,3304,10,100,0.0001,0.01,0.698,0.8901331719128329,1625,1679
1,3404,10,100,0.0001,0.01,0.68,0.9103995299647474,1679,1725
1,3504,10,100,0.0001,0.01,0.694,0.9283675799086758,1743,1761
1,3604,10,100,0.0001,0.01,0.684,0.9156492785793563,1796,1808
1,3704,10,100,0.0001,0.01,0.694,0.8693304535637149,1850,1854
1,3804,10,100,0.0001,0.01,0.702,0.900105152471083,1900,1904
1,3904,10,100,0.0001,0.01,0.706,0.9008709016393442,1946,1958
1,4004,10,100,0.0001,0.01,0.73,0.8998501498501499,2005,1999
1,4104,10,100,0.0001,0.01,0.732,0.9010721247563352,2051,2053
1,4204,10,100,0.0001,0.01,0.748,0.9000951474785919,2104,2100
1,4304,10,100,0.0001,0.01,0.75,0.9442379182156134,2145,2159
1,4404,10,100,0.0001,0.01,0.776,0.9489100817438693,2193,2211
1,4504,10,100,0.0001,0.01,0.768,0.9431616341030196,2244,2260
1,4604,10,100,0.0001,0.01,0.768,0.9513466550825369,2294,2310
1,4704,10,100,0.0001,0.01,0.782,0.9583333333333334,2346,2358
1,4804,10,100,0.0001,0.01,0.792,0.9612822647793505,2401,2403
1,4904,10,100,0.0001,0.01,0.78,0.9500407830342578,2451,2453
1,5004,10,100,0.0001,0.01,0.764,0.9584332533972821,2494,2510
1,5104,10,100,0.0001,0.01,0.8,0.9643416927899686,2551,2553
1,5204,10,100,0.0001,0.01,0.79,0.9513835511145273,2608,2596
1,5304,10,100,0.0001,0.01,0.774,0.9353318250377074,2662,2642
1,5404,10,100,0.0001,0.01,0.794,0.9465210954848261,2714,2690
1,5504,10,100,0.0001,0.01,0.76,0.901344476744186,2763,2741
1,5604,10,100,0.0001,0.01,0.808,0.9311206281227694,2813,2791
1,5704,10,100,0.0001,0.01,0.8,0.9396914446002805,2862,2842
1,5804,10,100,0.0001,0.01,0.83,0.9636457615437629,2908,2896
1,5904,10,100,0.0001,0.01,0.826,0.9752710027100271,2957,2947
1,6004,10,100,0.0001,0.01,0.822,0.9703530979347101,3012,2992
1,6104,10,100,0.0001,0.01,0.852,0.9826343381389253,3054,3050
1,6204,10,100,0.0001,0.01,0.842,0.9832366215344939,3105,3099
1,6304,10,100,0.0001,0.01,0.852,0.983502538071066,3145,3159
1,6404,10,100,0.0001,0.01,0.832,0.9728294815740163,3196,3208
1,6504,10,100,0.0001,0.01,0.844,0.9743234932349324,3248,3256
1,6604,10,100,0.0001,0.01,0.846,0.9757722592368262,3302,3302
1,6704,10,100,0.0001,0.01,0.854,0.972255369928401,3352,3352
1,6804,10,100,0.0001,0.01,0.842,0.9673721340388007,3406,3398
1,6904,10,100,0.0001,0.01,0.822,0.9414831981460023,3457,3447
1,7004,10,100,0.0001,0.01,0.832,0.9653055396916048,3507,3497
1,7104,10,100,0.0001,0.01,0.854,0.9887387387387387,3556,3548
1,7204,10,100,0.0001,0.01,0.866,0.9866740699611327,3604,3600
1,7304,10,100,0.0001,0.01,0.866,0.9882256297918949,3652,3652
1,7404,10,100,0.0001,0.01,0.878,0.9829821717990276,3709,3695
1,7504,10,100,0.0001,0.01,0.858,0.9830756929637526,3758,3746
1,7604,10,100,0.0001,0.01,0.868,0.983035244608101,3813,3791
1,7704,10,100,0.0001,0.01,0.88,0.976895119418484,3861,3843
1,7804,10,100,0.0001,0.01,0.846,0.9675807278318811,3913,3891
1,7904,10,100,0.0001,0.01,0.86,0.978744939271255,3964,3940
1,8004,10,100,0.0001,0.01,0.898,0.9881309345327336,4016,3988
1,8104,10,100,0.0001,0.01,0.88,0.9869200394866733,4068,4036
1,8204,10,100,0.0001,0.01,0.882,0.9882983910287665,4119,4085
1,8304,10,100,0.0001,0.01,0.894,0.9867533718689788,4173,4131
1,8404,10,100,0.0001,0.01,0.888,0.9796525464064731,4223,4181
1,8504,10,100,0.0001,0.01,0.87,0.9680150517403575,4274,4230
1,8604,10,100,0.0001,0.01,0.888,0.9757089725708973,4326,4278
1,8704,10,100,0.0001,0.01,0.888,0.9765625,4374,4330
1,8804,10,100,0.0001,0.01,0.908,0.9894366197183099,4424,4380
1,8904,10,100,0.0001,0.01,0.908,0.9925876010781671,4471,4433
1,9004,10,100,0.0001,0.01,0.894,0.9895601954686806,4520,4484
1,9104,10,100,0.0001,0.01,0.898,0.9961555360281195,4574,4530
1,9204,10,100,0.0001,0.01,0.914,0.9964146023468058,4623,4581
1,9304,10,100,0.0001,0.01,0.912,0.9969905417024936,4671,4633
1,9404,10,100,0.0001,0.01,0.896,0.9893662271373883,4725,4679
1,9504,10,100,0.0001,0.01,0.908,0.9921085858585859,4769,4735
1,9604,10,100,0.0001,0.01,0.92,0.994585589337776,4818,4786
1,9704,10,100,0.0001,0.01,0.942,0.9953627370156637,4864,4840
1,9804,10,100,0.0001,0.01,0.898,0.9812321501427989,4913,4891
1,9904,10,100,0.0001,0.01,0.916,0.9820274636510501,4963,4941
1,10004,10,100,0.0001,0.01,0.916,0.9845061975209916,5017,4987
1,10104,10,100,0.0001,0.01,0.924,0.9893111638954869,5068,5036
1,10204,10,100,0.0001,0.01,0.94,0.9915719325754606,5121,5083
1,10304,10,100,0.0001,0.01,0.934,0.9859277950310559,5168,5136
1,10404,10,100,0.0001,0.01,0.956,0.9920222991157247,5219,5185
1,10504,10,100,0.0001,0.01,0.944,0.9962871287128713,5265,5239
1,10604,10,100,0.0001,0.01,0.95,0.9972651829498302,5309,5295
1,10704,10,100,0.0001,0.01,0.934,0.991872197309417,5352,5352
1,10804,10,100,0.0001,0.01,0.914,0.9647352832284339,5387,5417
1,10904,10,100,0.0001,0.01,0.922,0.9480007336757154,5435,5469
1,11004,10,100,0.0001,0.01,0.948,0.9723736822973464,5483,5521
1,11104,10,100,0.0001,0.01,0.956,0.9935158501440923,5529,5575
1,11204,10,100,0.0001,0.01,0.966,0.9974116387004641,5587,5617
1,11304,10,100,0.0001,0.01,0.968,0.9984076433121019,5642,5662
1,11404,10,100,0.0001,0.01,0.97,0.9994738688179586,5694,5710
1,11504,10,100,0.0001,0.01,0.972,0.9999130737134909,5751,5753
1,11604,10,100,0.0001,0.01,0.976,0.9995691140985867,5799,5805
1,11704,10,100,0.0001,0.01,0.978,0.9982057416267942,5848,5856
1,11804,10,100,0.0001,0.01,0.974,0.9983903761436801,5906,5898
1,11904,10,100,0.0001,0.01,0.982,0.9977318548387096,5955,5949
1,12004,10,100,0.0001,0.01,0.978,0.9951682772409197,5996,6008
1,12104,10,100,0.0001,0.01,0.964,0.9818241903502974,6048,6056
1,12204,10,100,0.0001,0.01,0.966,0.9845132743362832,6094,6110
1,12304,10,100,0.0001,0.01,0.968,0.9961801040312094,6149,6155
1,12404,10,100,0.0001,0.01,0.952,0.991131892937762,6199,6205
1,12504,10,100,0.0001,0.01,0.968,0.9932821497120922,6253,6251
1,12604,10,100,0.0001,0.01,0.97,0.9968264043160902,6311,6293
1,12704,10,100,0.0001,0.01,0.984,0.998661838790932,6368,6336
1,12804,10,100,0.0001,0.01,0.976,0.9982036863480163,6420,6384
1,12904,10,100,0.0001,0.01,0.98,0.9989925604463732,6473,6431
1,13004,10,100,0.0001,0.01,0.978,0.9966933251307291,6514,6490
1,13104,10,100,0.0001,0.01,0.976,0.9968711843711844,6566,6538
1,13204,10,100,0.0001,0.01,0.98,0.997046349591033,6618,6586
1,13304,10,100,0.0001,0.01,0.968,0.9878983764281419,6663,6641
1,13404,10,100,0.0001,0.01,0.964,0.9849298716800955,6709,6695
1,13504,10,100,0.0001,0.01,0.97,0.9926688388625592,6750,6754
1,13604,10,100,0.0001,0.01,0.978,0.9975007350779183,6806,6798
1,13704,10,100,0.0001,0.01,0.976,0.9979568009340338,6857,6847
1,13804,10,100,0.0001,0.01,0.982,0.9992031295276731,6904,6900
1,13904,10,100,0.0001,0.01,0.976,0.9970512082853855,6948,6956
1,14004,10,100,0.0001,0.01,0.978,0.9945729791488146,6989,7015
1,14104,10,100,0.0001,0.01,0.976,0.9966676120249575,7037,7067
1,14204,10,100,0.0001,0.01,0.968,0.993945367502112,7089,7115
1,14304,10,100,0.0001,0.01,0.976,0.9909116331096197,7137,7167
1,14404,10,100,0.0001,0.01,0.982,0.9971535684532075,7191,7213
1,14504,10,100,0.0001,0.01,0.988,0.9995173745173745,7245,7259
1,14604,10,100,0.0001,0.01,0.982,0.9997945768282662,7296,7308
1,14704,10,100,0.0001,0.01,0.984,0.9990478781284005,7349,7355
1,14804,10,100,0.0001,0.01,0.988,0.9995271548230208,7391,7413
1,14904,10,100,0.0001,0.01,0.99,0.9999329039184112,7447,7457
1,15004,10,100,0.0001,0.01,0.984,0.9974673420421221,7501,7503
2,104,10,100,0.0001,0.01,0.504,0.5673076923076923,48,56
2,204,10,100,0.0001,0.01,0.506,0.6127450980392157,97,107
2,304,10,100,0.0001,0.01,0.506,0.625,145,159
2,404,10,100,0.0001,0.01,0.5,0.5767326732673267,201,203
2,504,10,100,0.0001,0.01,0.48,0.625,254,250
2,604,10,100,0.0001,0.01,0.474,0.6241721854304636,292,312
2,704,10,100,0.0001,0.01,0.474,0.6605113636363636,346,358
2,804,10,100,0.0001,0.01,0.476,0.6517412935323383,402,402
2,904,10,100,0.0001,0.01,0.502,0.6924778761061947,446,458
2,1004,10,100,0.0001,0.01,0.516,0.701195219123506,494,510
2,1104,10,100,0.0001,0.01,0.496,0.6856884057971014,554,550
2,1204,10,100,0.0001,0.01,0.518,0.7117940199335548,604,600
2,1304,10,100,0.0001,0.01,0.498,0.7200920245398773,644,660
2,1404,10,100,0.0001,0.01,0.526,0.6958689458689459,689,715
2,1504,10,100,0.0001,0.01,0.524,0.7180851063829787,737,767
2,1604,10,100,0.0001,0.01,0.518,0.7481296758104738,793,811
2,1704,10,100,0.0001,0.01,0.528,0.7435446009389671,843,861
2,1804,10,100,0.0001,0.01,0.55,0.7694013303769401,890,914
2,1904,10,100,0.0001,0.01,0.566,0.7757352941176471,945,959
2,2004,10,100,0.0001,0.01,0.584,0.7604790419161677,993,1011
2,2104,10,100,0.0001,0.01,0.566,0.7347908745247148,1042,1062
2,2204,10,100,0.0001,0.01,0.57,0.7726860254083484,1097,1107
2,2304,10,100,0.0001,0.01,0.606,0.7699652777777778,1147,1157
2,2404,10,100,0.0001,0.01,0.602,0.8074043261231281,1192,1212
2,2504,10,100,0.0001,0.01,0.6,0.797923322683706,1243,1261
2,2604,10,100,0.0001,0.01,0.646,0.8367895545314901,1302,1302
2,2704,10,100,0.0001,0.01,0.644,0.8295118343195266,1354,1350
2,2804,10,100,0.0001,0.01,0.624,0.8266761768901569,1398,1406
2,2904,10,100,0.0001,0.01,0.638,0.8130165289256198,1452,1452
2,3004,10,100,0.0001,0.01,0.696,0.8771637816245007,1494,1510
2,3104,10,100,0.0001,0.01,0.686,0.9023840206185567,1543,1561
2,3204,10,100,0.0001,0.01,0.698,0.9113607990012484,1586,1618
2,3304,10,100,0.0001,0.01,0.708,0.899818401937046,1629,1675
2,3404,10,100,0.0001,0.01,0.742,0.9294947121034077,1675,1729
2,3504,10,100,0.0001,0.01,0.734,0.9497716894977168,1730,1774
2,3604,10,100,0.0001,0.01,0.748,0.959211986681465,1783,1821
2,3704,10,100,0.0001,0.01,0.778,0.9665226781857451,1829,1875
2,3804,10,100,0.0001,0.01,0.764,0.9616193480546793,1881,1923
2,3904,10,100,0.0001,0.01,0.754,0.9590163934426229,1931,1973
2,4004,10,100,0.0001,0.01,0.778,0.9642857142857143,1984,2020
2,4104,10,100,0.0001,0.01,0.818,0.9870857699805068,2029,2075
2,4204,10,100,0.0001,0.01,0.806,0.9835870599429115,2081,2123
2,4304,10,100,0.0001,0.01,0.784,0.9481877323420075,2136,2168
2,4404,10,100,0.0001,0.01,0.786,0.9432334241598547,2197,2207
2,4504,10,100,0.0001,0.01,0.78,0.9189609236234458,2242,2262
2,4604,10,100,0.0001,0.01,0.816,0.9420069504778453,2288,2316
2,4704,10,100,0.0001,0.01,0.874,0.9798044217687075,2342,2362
2,4804,10,100,0.0001,0.01,0.874,0.9870940882597835,2385,2419
2,4904,10,100,0.0001,0.01,0.87,0.9879690048939641,2432,2472
2,5004,10,100,0.0001,0.01,0.87,0.9886091127098321,2479,2525
2,5104,10,100,0.0001,0.01,0.894,0.9949059561128527,2533,2571
2,5204,10,100,0.0001,0.01,0.886,0.9805918524212145,2581,2623
2,5304,10,100,0.0001,0.01,0.87,0.9715309200603318,2629,2675
2,5404,10,100,0.0001,0.01,0.88,0.9827905255366395,2677,2727
2,5504,10,100,0.0001,0.01,0.902,0.9923691860465116,2722,2782
2,5604,10,100,0.0001,0.01,0.912,0.9962526766595289,2772,2832
2,5704,10,100,0.0001,0.01,0.916,0.9977208976157083,2828,2876
2,5804,10,100,0.0001,0.01,0.91,0.9993108201240524,2877,2927
2,5904,10,100,0.0001,0.01,0.918,0.9979674796747967,2928,2976
2,6004,10,100,0.0001,0.01,0.912,0.9980013324450366,2981,3023
2,6104,10,100,0.0001,0.01,0.916,0.9973787680209698,3024,3080
2,6204,10,100,0.0001,0.01,0.934,0.9974210186976145,3075,3129
2,6304,10,100,0.0001,0.01,0.924,0.9976205583756346,3129,3175
2,6404,10,100,0.0001,0.01,0.95,0.9993753903810119,3180,3224
2,6504,10,100,0.0001,0.01,0.936,0.998769987699877,3227,3277
2,6604,10,100,0.0001,0.01,0.94,0.9987886129618413,3275,3329
2,6704,10,100,0.0001,0.01,0.916,0.9701670644391408,3316,3388
2,6804,10,100,0.0001,0.01,0.93,0.9936801881246325,3367,3437
2,6904,10,100,0.0001,0.01,0.93,0.9946407879490151,3420,3484
2,7004,10,100,0.0001,0.01,0.948,0.9924328954882924,3473,3531
2,7104,10,100,0.0001,0.01,0.942,0.9902871621621622,3522,3582
2,7204,10,100,0.0001,0.01,0.946,0.9926429761243754,3571,3633
2,7304,10,100,0.0001,0.01,0.948,0.9926067907995619,3624,3680
2,7404,10,100,0.0001,0.01,0.954,0.9977039438141545,3668,3736
2,7504,10,100,0.0001,0.01,0.97,0.9982675906183369,3711,3793
2,7604,10,100,0.0001,0.01,0.956,0.9914518674381905,3760,3844
2,7704,10,100,0.0001,0.01,0.968,0.9983125649013499,3813,3891
2,7804,10,100,0.0001,0.01,0.968,0.9974372116863147,3865,3939
2,7904,10,100,0.0001,0.01,0.968,0.9991143724696356,3916,3988
2,8004,10,100,0.0001,0.01,0.966,0.9988755622188905,3973,4031
2,8104,10,100,0.0001,0.01,0.97,0.9969151036525172,4013,4091
2,8204,10,100,0.0001,0.01,0.968,0.999634324719649,4063,4141
2,8304,10,100,0.0001,0.01,0.97,0.9997591522157996,4119,4185
2,8404,10,100,0.0001,0.01,0.97,0.9997620180866255,4180,4224
2,8504,10,100,0.0001,0.01,0.974,0.9971777986829727,4235,4269
2,8604,10,100,0.0001,0.01,0.956,0.9973268247326825,4289,4315
2,8704,10,100,0.0001,0.01,0.966,0.9986213235294118,4328,4376
2,8804,10,100,0.0001,0.01,0.972,0.9988641526578828,4384,4420
2,8904,10,100,0.0001,0.01,0.976,0.995507637017071,4425,4479
2,9004,10,100,0.0001,0.01,0.956,0.9907818747223456,4484,4520
2,9104,10,100,0.0001,0.01,0.966,0.9947275922671354,4530,4574
2,9204,10,100,0.0001,0.01,0.97,0.9947848761408083,4577,4627
2,9304,10,100,0.0001,0.01,0.956,0.9907566638005159,4625,4679
2,9404,10,100,0.0001,0.01,0.978,0.9975542322415993,4669,4735
2,9504,10,100,0.0001,0.01,0.972,0.9930555555555556,4725,4779
2,9604,10,100,0.0001,0.01,0.98,0.9963556851311953,4782,4822
2,9704,10,100,0.0001,0.01,0.976,0.9975267930750206,4824,4880
2,9804,10,100,0.0001,0.01,0.98,0.9991840065279478,4873,4931
2,9904,10,100,0.0001,0.01,0.984,0.9997980613893377,4922,4982
2,10004,10,100,0.0001,0.01,0.982,0.9994002399040384,4969,5035
2,10104,10,100,0.0001,0.01,0.98,0.9993072050673001,5022,5082
2,10204,10,100,0.0001,0.01,0.982,0.9998039984319874,5072,5132
2,10304,10,100,0.0001,0.01,0.984,0.999126552795031,5126,5178
2,10404,10,100,0.0001,0.01,0.988,0.998558246828143,5179,5225
2,10504,10,100,0.0001,0.01,0.974,0.9985719725818736,5235,5269
2,10604,10,100,0.0001,0.01,0.974,0.997736703130894,5292,5312
2,10704,10,100,0.0001,0.01,0.98,0.9961696562032885,5340,5364
2,10804,10,100,0.0001,0.01,0.986,0.9987041836356905,5391,5413
2,10904,10,100,0.0001,0.01,0.984,0.998624358033749,5445,5459
2,11004,10,100,0.0001,0.01,0.974,0.9885496183206107,5492,5512
2,11104,10,100,0.0001,0.01,0.956,0.9826188760806917,5549,5555
2,11204,10,100,0.0001,0.01,0.974,0.9923241699393074,5600,5604
2,11304,10,100,0.0001,0.01,0.976,0.997169143665959,5651,5653
2,11404,10,100,0.0001,0.01,0.984,0.9983339179235357,5709,5695
2,11504,10,100,0.0001,0.01,0.978,0.9995653685674548,5751,5753
2,11604,10,100,0.0001,0.01,0.984,0.9993967597380213,5802,5802
2,11704,10,100,0.0001,0.01,0.986,0.9998291182501708,5862,5842
2,11804,10,100,0.0001,0.01,0.984,0.9995764147746526,5923,5881
2,11904,10,100,0.0001,0.01,0.972,0.994119623655914,5974,5930
2,12004,10,100,0.0001,0.01,0.978,0.9980006664445185,6020,5984
2,12104,10,100,0.0001,0.01,0.982,0.9974388631857237,6063,6041
2,12204,10,100,0.0001,0.01,0.976,0.9977876106194691,6114,6090
2,12304,10,100,0.0001,0.01,0.99,0.9980494148244473,6158,6146
2,12404,10,100,0.0001,0.01,0.984,0.9975814253466624,6212,6192
2,12504,10,100,0.0001,0.01,0.986,0.9992002559181062,6258,6246
2,12604,10,100,0.0001,0.01,0.988,0.9997619803237068,6312,6292
2,12704,10,100,0.0001,0.01,0.986,0.9990554156171285,6363,6341
2,12804,10,100,0.0001,0.01,0.99,0.9992970946579194,6409,6395
2,12904,10,100,0.0001,0.01,0.986,0.9996125232486051,6464,6440
2,13004,10,100,0.0001,0.01,0.99,0.99930790525992,6511,6493
2,13104,10,100,0.0001,0.01,0.988,0.9999236874236874,6566,6538
2,13204,10,100,0.0001,0.01,0.99,0.9996213268706453,6618,6586
2,13304,10,100,0.0001,0.01,0.992,0.9987221888153939,6660,6644
2,13404,10,100,0.0001,0.01,0.986,0.9970904207699194,6702,6702
2,13504,10,100,0.0001,0.01,0.986,0.996667654028436,6758,6746
2,13604,10,100,0.0001,0.01,0.982,0.9963981182005293,6812,6792
2,13704,10,100,0.0001,0.01,0.986,0.9941622883829538,6854,6850
2,13804,10,100,0.0001,0.01,0.982,0.9952912199362504,6909,6895
2,13904,10,100,0.0001,0.01,0.994,0.9987054085155351,6968,6936
2,14004,10,100,0.0001,0.01,0.99,0.9999285918309054,7021,6983
2,14104,10,100,0.0001,0.01,0.992,0.9999290981281905,7072,7032
2,14204,10,100,0.0001,0.01,0.994,0.9997887918896086,7113,7091
2,14304,10,100,0.0001,0.01,0.99,0.9999300894854586,7159,7145
2,14404,10,100,0.0001,0.01,0.984,0.9934046098306026,7206,7198
2,14504,10,100,0.0001,0.01,0.982,0.995311638168781,7257,7247
2,14604,10,100,0.0001,0.01,0.982,0.9969871268145714,7312,7292
2,14704,10,100,0.0001,0.01,0.984,0.9989798694232862,7361,7343
2,14804,10,100,0.0001,0.01,0.992,0.999864901378006,7407,7397
2,14904,10,100,0.0001,0.01,0.992,0.9994632313472893,7456,7448
2,15004,10,100,0.0001,0.01,0.992,0.9996667555318581,7504,7500
3,104,10,100,0.0001,0.01,0.508,0.5769230769230769,60,44
3,204,10,100,0.0001,0.01,0.49,0.5,108,96
3,304,10,100,0.0001,0.01,0.502,0.555921052631579,167,137
3,404,10,100,0.0001,0.01,0.496,0.5495049504950495,206,198
3,504,10,100,0.0001,0.01,0.51,0.5456349206349206,260,244
3,604,10,100,0.0001,0.01,0.54,0.6539735099337748,315,289
3,704,10,100,0.0001,0.01,0.486,0.6505681818181818,370,334
3,804,10,100,0.0001,0.01,0.468,0.6492537313432836,423,381
3,904,10,100,0.0001,0.01,0.466,0.6592920353982301,483,421
3,1004,10,100,0.0001,0.01,0.482,0.6792828685258964,529,475
3,1104,10,100,0.0001,0.01,0.496,0.6739130434782609,582,522
3,1204,10,100,0.0001,0.01,0.48,0.6918604651162791,630,574
3,1304,10,100,0.0001,0.01,0.49,0.6901840490797546,690,614
3,1404,10,100,0.0001,0.01,0.518,0.7207977207977208,745,659
3,1504,10,100,0.0001,0.01,0.498,0.7134308510638298,793,711
3,1604,10,100,0.0001,0.01,0.51,0.7562344139650873,843,761
3,1704,10,100,0.0001,0.01,0.532,0.7576291079812206,897,807
3,1804,10,100,0.0001,0.01,0.524,0.7732815964523282,948,856
3,1904,10,100,0.0001,0.01,0.528,0.7757352941176471,992,912
3,2004,10,100,0.0001,0.01,0.544,0.7849301397205589,1042,962
3,2104,10,100,0.0001,0.01,0.562,0.7927756653992395,1087,1017
3,2204,10,100,0.0001,0.01,0.584,0.8357531760435571,1140,1064
3,2304,10,100,0.0001,0.01,0.616,0.8472222222222222,1195,1109
3,2404,10,100,0.0001,0.01,0.618,0.8897670549084858,1249,1155
3,2504,10,100,0.0001,0.01,0.67,0.8765974440894568,1297,1207
3,2604,10,100,0.0001,0.01,0.692,0.9101382488479263,1350,1254
3,2704,10,100,0.0001,0.01,0.71,0.9252958579881657,1403,1301
3,2804,10,100,0.0001,0.01,0.72,0.93830242510699,1460,1344
3,2904,10,100,0.0001,0.01,0.698,0.9090909090909091,1519,1385
3,3004,10,100,0.0001,0.01,0.732,0.9327563249001332,1566,1438
3,3104,10,100,0.0001,0.01,0.726,0.9155927835051546,1609,1495
3,3204,10,100,0.0001,0.01,0.764,0.9413233458177278,1655,1549
3,3304,10,100,0.0001,0.01,0.776,0.9427966101694916,1699,1605
3,3404,10,100,0.0001,0.01,0.782,0.9600470035252644,1752,1652
3,3504,10,100,0.0001,0.01,0.798,0.9606164383561644,1804,1700
3,3604,10,100,0.0001,0.01,0.816,0.9730854605993341,1849,1755
3,3704,10,100,0.0001,0.01,0.836,0.9767818574514039,1906,1798
3,3804,10,100,0.0001,0.01,0.846,0.9802839116719243,1960,1844
3,3904,10,100,0.0001,0.01,0.814,0.9779713114754098,2008,1896
3,4004,10,100,0.0001,0.01,0.858,0.9717782217782218,2056,1948
3,4104,10,100,0.0001,0.01,0.812,0.9334795321637427,2101,2003
3,4204,10,100,0.0001,0.01,0.832,0.9631303520456708,2151,2053
3,4304,10,100,0.0001,0.01,0.844,0.9772304832713755,2196,2108
3,4404,10,100,0.0001,0.01,0.87,0.9813805631244323,2250,2154
3,4504,10,100,0.0001,0.01,0.868,0.9875666074600356,2307,2197
3,4604,10,100,0.0001,0.01,0.868,0.9908774978279756,2365,2239
3,4704,10,100,0.0001,0.01,0.872,0.9917091836734694,2420,2284
3,4804,10,100,0.0001,0.01,0.892,0.988134887593672,2458,2346
3,4904,10,100,0.0001,0.01,0.878,0.9881729200652528,2515,2389
3,5004,10,100,0.0001,0.01,0.892,0.9904076738609112,2569,2435
3,5104,10,100,0.0001,0.01,0.894,0.9964733542319749,2617,2487
3,5204,10,100,0.0001,0.01,0.9,0.9923136049192929,2668,2536
3,5304,10,100,0.0001,0.01,0.908,0.9949095022624435,2722,2582
3,5404,10,100,0.0001,0.01,0.928,0.9925980754996299,2769,2635
3,5504,10,100,0.0001,0.01,0.922,0.9927325581395349,2812,2692
3,5604,10,100,0.0001,0.01,0.876,0.956281227694504,2859,2745
3,5704,10,100,0.0001,0.01,0.858,0.9240883590462833,2910,2794
3,5804,10,100,0.0001,0.01,0.902,0.9655410062026188,2960,2844
3,5904,10,100,0.0001,0.01,0.942,0.9883130081300813,3006,2898
3,6004,10,100,0.0001,0.01,0.95,0.9930046635576283,3058,2946
3,6104,10,100,0.0001,0.01,0.964,0.9959043250327654,3105,2999
3,6204,10,100,0.0001,0.01,0.96,0.9898452611218569,3147,3057
3,6304,10,100,0.0001,0.01,0.962,0.9971446700507615,3207,3097
3,6404,10,100,0.0001,0.01,0.968,0.9971892567145534,3253,3151
3,6504,10,100,0.0001,0.01,0.972,0.995079950799508,3294,3210
3,6604,10,100,0.0001,0.01,0.964,0.9948516050878256,3345,3259
3,6704,10,100,0.0001,0.01,0.97,0.9991050119331742,3388,3316
3,6804,10,100,0.0001,0.01,0.974,0.9988242210464433,3440,3364
3,6904,10,100,0.0001,0.01,0.968,0.9994206257242179,3491,3413
3,7004,10,100,0.0001,0.01,0.968,0.9971444888635066,3544,3460
3,7104,10,100,0.0001,0.01,0.97,0.9946509009009009,3589,3515
3,7204,10,100,0.0001,0.01,0.966,0.9895891171571349,3652,3552
3,7304,10,100,0.0001,0.01,0.972,0.9916484118291348,3695,3609
3,7404,10,100,0.0001,0.01,0.976,0.9967585089141004,3750,3654
3,7504,10,100,0.0001,0.01,0.97,0.9976012793176973,3798,3706
3,7604,10,100,0.0001,0.01,0.974,0.998290373487638,3850,3754
3,7704,10,100,0.0001,0.01,0.968,0.9964953271028038,3895,3809
3,7804,10,100,0.0001,0.01,0.964,0.9915427985648385,3938,3866
3,7904,10,100,0.0001,0.01,0.972,0.9908906882591093,3985,3919
3,8004,10,100,0.0001,0.01,0.972,0.9936281859070465,4042,3962
3,8104,10,100,0.0001,0.01,0.966,0.9937068114511353,4098,4006
3,8204,10,100,0.0001,0.01,0.974,0.9962213554363725,4144,4060
3,8304,10,100,0.0001,0.01,0.978,0.9965077071290944,4182,4122
3,8404,10,100,0.0001,0.01,0.976,0.9983341266063779,4240,4164
3,8504,10,100,0.0001,0.01,0.98,0.9978833490122295,4288,4216
3,8604,10,100,0.0001,0.01,0.978,0.99907019990702,4333,4271
3,8704,10,100,0.0001,0.01,0.978,0.9996553308823529,4384,4320
3,8804,10,100,0.0001,0.01,0.98,0.9989777373920945,4429,4375
3,8904,10,100,0.0001,0.01,0.94,0.9866352201257862,4474,4430
3,9004,10,100,0.0001,0.01,0.966,0.9902265659706797,4522,4482
3,9104,10,100,0.0001,0.01,0.972,0.9889059753954306,4571,4533
3,9204,10,100,0.0001,0.01,0.974,0.9947848761408083,4622,4582
3,9304,10,100,0.0001,0.01,0.99,0.9962381771281169,4674,4630
3,9404,10,100,0.0001,0.01,0.986,0.9984049340706083,4722,4682
3,9504,10,100,0.0001,0.01,0.986,0.9987373737373737,4774,4730
3,9604,10,100,0.0001,0.01,0.978,0.9968763015410246,4823,4781
3,9704,10,100,0.0001,0.01,0.988,0.9998969497114591,4865,4839
3,9804,10,100,0.0001,0.01,0.988,0.9997960016319869,4922,4882
3,9904,10,100,0.0001,0.01,0.99,0.9992932148626817,4964,4940
3,10004,10,100,0.0001,0.01,0.988,0.999500199920032,5014,4990
3,10104,10,100,0.0001,0.01,0.986,0.9989113222486145,5059,5045
3,10204,10,100,0.0001,0.01,0.988,0.9993139945119561,5103,5101
3,10304,10,100,0.0001,0.01,0.986,0.9970885093167702,5153,5151
3,10404,10,100,0.0001,0.01,0.986,0.9989427143406382,5203,5201
3,10504,10,100,0.0001,0.01,0.988,0.9993335872048743,5260,5244
3,10604,10,100,0.0001,0.01,0.98,0.9933044134288948,5313,5291
3,10704,10,100,0.0001,0.01,0.978,0.9909379671150972,5353,5351
3,10804,10,100,0.0001,0.01,0.984,0.9972232506479082,5412,5392
3,10904,10,100,0.0001,0.01,0.968,0.9867021276595744,5453,5451
3,11004,10,100,0.0001,0.01,0.996,0.9976372228280626,5498,5506
3,11104,10,100,0.0001,0.01,0.996,0.9982889048991355,5540,5564
3,11204,10,100,0.0001,0.01,0.996,0.9978579078900393,5595,5609
3,11304,10,100,0.0001,0.01,0.988,0.9968152866242038,5653,5651
3,11404,10,100,0.0001,0.01,0.99,0.9975447211504735,5701,5703
3,11504,10,100,0.0001,0.01,0.996,0.9991307371349096,5745,5759
3,11604,10,100,0.0001,0.01,0.994,0.9982764563943468,5792,5812
3,11704,10,100,0.0001,0.01,0.994,0.9998291182501708,5847,5857
3,11804,10,100,0.0001,0.01,0.992,0.9976279227380549,5887,5917
3,11904,10,100,0.0001,0.01,1.0,0.9994119623655914,5946,5958
3,12004,10,100,0.0001,0.01,0.998,0.9999166944351883,5997,6007
3,12104,10,100,0.0001,0.01,0.996,0.9999173826834105,6051,6053
3,12204,10,100,0.0001,0.01,0.998,1.0,6107,6097
3,12304,10,100,0.0001,0.01,0.998,1.0,6152,6152
3,12404,10,100,0.0001,0.01,1.0,0.9992744276039988,6197,6207
3,12504,10,100,0.0001,0.01,0.998,0.9996801023672425,6249,6255
3,12604,10,100,0.0001,0.01,0.998,1.0,6305,6299
3,12704,10,100,0.0001,0.01,1.0,0.9996851385390428,6361,6343
3,12804,10,100,0.0001,0.01,0.986,0.975398313027179,6414,6390
3,12904,10,100,0.0001,0.01,0.984,0.9889181649101054,6457,6447
3,13004,10,100,0.0001,0.01,0.978,0.9906951707167025,6507,6497
3,13104,10,100,0.0001,0.01,0.994,0.998550061050061,6549,6555
3,13204,10,100,0.0001,0.01,0.994,0.9994698576189034,6596,6608
3,13304,10,100,0.0001,0.01,0.996,0.9998496692723993,6649,6655
3,13404,10,100,0.0001,0.01,0.996,0.9998507908087139,6695,6709
3,13504,10,100,0.0001,0.01,0.996,1.0,6750,6754
3,13604,10,100,0.0001,0.01,0.996,0.9997794766245222,6792,6812
3,13704,10,100,0.0001,0.01,0.996,0.9981027437244601,6843,6861
3,13804,10,100,0.0001,0.01,0.992,0.9978991596638656,6894,6910
3,13904,10,100,0.0001,0.01,0.988,0.9962600690448792,6936,6968
3,14004,10,100,0.0001,0.01,0.996,0.9977863467580691,6988,7016
3,14104,10,100,0.0001,0.01,0.984,0.9973766307430516,7037,7067
3,14204,10,100,0.0001,0.01,0.998,0.9976063080822304,7101,7103
3,14304,10,100,0.0001,0.01,0.992,0.9979026845637584,7153,7151
3,14404,10,100,0.0001,0.01,0.998,0.9984726464870869,7201,7203
3,14504,10,100,0.0001,0.01,0.996,0.9982073910645339,7250,7254
3,14604,10,100,0.0001,0.01,0.99,0.9944535743631882,7303,7301
3,14704,10,100,0.0001,0.01,0.994,0.9959194776931447,7352,7352
3,14804,10,100,0.0001,0.01,0.992,0.9982437179140773,7400,7404
3,14904,10,100,0.0001,0.01,0.994,0.9983225979602791,7450,7454
3,15004,10,100,0.0001,0.01,1.0,0.9982004798720341,7498,7506
4,104,10,100,0.0001,0.01,0.51,0.5769230769230769,60,44
4,204,10,100,0.0001,0.01,0.506,0.5882352941176471,114,90
4,304,10,100,0.0001,0.01,0.538,0.6907894736842105,161,143
4,404,10,100,0.0001,0.01,0.5,0.6064356435643564,212,192
4,504,10,100,0.0001,0.01,0.51,0.6329365079365079,265,239
4,604,10,100,0.0001,0.01,0.51,0.6490066225165563,322,282
4,704,10,100,0.0001,0.01,0.516,0.6647727272727273,373,331
4,804,10,100,0.0001,0.01,0.488,0.6517412935323383,427,377
4,904,10,100,0.0001,0.01,0.508,0.6504424778761062,480,424
4,1004,10,100,0.0001,0.01,0.498,0.6673306772908366,526,478
4,1104,10,100,0.0001,0.01,0.488,0.6748188405797102,574,530
4,1204,10,100,0.0001,0.01,0.474,0.6893687707641196,627,577
4,1304,10,100,0.0001,0.01,0.502,0.691717791411043,678,626
4,1404,10,100,0.0001,0.01,0.486,0.7115384615384616,733,671
4,1504,10,100,0.0001,0.01,0.492,0.7200797872340425,788,716
4,1604,10,100,0.0001,0.01,0.47,0.7082294264339152,829,775
4,1704,10,100,0.0001,0.01,0.528,0.6766431924882629,880,824
4,1804,10,100,0.0001,0.01,0.538,0.7172949002217295,933,871
4,1904,10,100,0.0001,0.01,0.486,0.6911764705882353,984,920
4,2004,10,100,0.0001,0.01,0.474,0.7285429141716567,1032,972
4,2104,10,100,0.0001,0.01,0.476,0.7352661596958175,1082,1022
4,2204,10,100,0.0001,0.01,0.494,0.7658802177858439,1136,1068
4,2304,10,100,0.0001,0.01,0.516,0.7686631944444444,1181,1123
4,2404,10,100,0.0001,0.01,0.508,0.757071547420965,1233,1171
4,2504,10,100,0.0001,0.01,0.492,0.771964856230032,1290,1214
4,2604,10,100,0.0001,0.01,0.506,0.7511520737327189,1340,1264
4,2704,10,100,0.0001,0.01,0.534,0.7440828402366864,1391,1313
4,2804,10,100,0.0001,0.01,0.514,0.7920827389443652,1437,1367
4,2904,10,100,0.0001,0.01,0.528,0.7926997245179064,1479,1425
4,3004,10,100,0.0001,0.01,0.508,0.8082556591211718,1533,1471
4,3104,10,100,0.0001,0.01,0.544,0.8228092783505154,1578,1526
4,3204,10,100,0.0001,0.01,0.516,0.8102372034956304,1628,1576
4,3304,10,100,0.0001,0.01,0.526,0.8480629539951574,1681,1623
4,3404,10,100,0.0001,0.01,0.556,0.8739717978848414,1735,1669
4,3504,10,100,0.0001,0.01,0.546,0.8738584474885844,1786,1718
4,3604,10,100,0.0001,0.01,0.57,0.8759711431742508,1835,1769
4,3704,10,100,0.0001,0.01,0.554,0.8237041036717062,1886,1818
4,3804,10,100,0.0001,0.01,0.54,0.842534174553102,1933,1871
4,3904,10,100,0.0001,0.01,0.558,0.8755122950819673,1993,1911
4,4004,10,100,0.0001,0.01,0.57,0.8846153846153846,2039,1965
4,4104,10,100,0.0001,0.01,0.586,0.8745126705653021,2087,2017
4,4204,10,100,0.0001,0.01,0.584,0.8884395813510942,2132,2072
4,4304,10,100,0.0001,0.01,0.604,0.9007899628252788,2176,2128
4,4404,10,100,0.0001,0.01,0.596,0.8994096276112625,2220,2184
4,4504,10,100,0.0001,0.01,0.634,0.8803285968028419,2272,2232
4,4604,10,100,0.0001,0.01,0.624,0.8950912250217202,2317,2287
4,4704,10,100,0.0001,0.01,0.662,0.9183673469387755,2361,2343
4,4804,10,100,0.0001,0.01,0.654,0.9288093255620317,2423,2381
4,4904,10,100,0.0001,0.01,0.632,0.9284257748776509,2482,2422
4,5004,10,100,0.0001,0.01,0.648,0.9288569144684252,2534,2470
4,5104,10,100,0.0001,0.01,0.66,0.9337774294670846,2586,2518
4,5204,10,100,0.0001,0.01,0.66,0.9452344350499615,2629,2575
4,5304,10,100,0.0001,0.01,0.668,0.930052790346908,2678,2626
4,5404,10,100,0.0001,0.01,0.676,0.9095114729829755,2730,2674
4,5504,10,100,0.0001,0.01,0.618,0.8717296511627907,2780,2724
4,5604,10,100,0.0001,0.01,0.636,0.8893647394718058,2831,2773
4,5704,10,100,0.0001,0.01,0.676,0.8707924263674615,2885,2819
4,5804,10,100,0.0001,0.01,0.682,0.8957615437629222,2933,2871
4,5904,10,100,0.0001,0.01,0.686,0.9105691056910569,2979,2925
4,6004,10,100,0.0001,0.01,0.686,0.920219853431046,3030,2974
4,6104,10,100,0.0001,0.01,0.682,0.9272608125819135,3083,3021
4,6204,10,100,0.0001,0.01,0.694,0.9356866537717602,3136,3068
4,6304,10,100,0.0001,0.01,0.696,0.9348032994923858,3187,3117
4,6404,10,100,0.0001,0.01,0.714,0.9295752654590881,3244,3160
4,6504,10,100,0.0001,0.01,0.73,0.9308118081180812,3296,3208
4,6604,10,100,0.0001,0.01,0.716,0.9350393700787402,3348,3256
4,6704,10,100,0.0001,0.01,0.724,0.9553997613365155,3396,3308
4,6804,10,100,0.0001,0.01,0.742,0.9587007642563198,3454,3350
4,6904,10,100,0.0001,0.01,0.732,0.9537949015063731,3504,3400
4,7004,10,100,0.0001,0.01,0.752,0.9624500285551114,3555,3449
4,7104,10,100,0.0001,0.01,0.752,0.9649493243243243,3609,3495
4,7204,10,100,0.0001,0.01,0.756,0.9536368684064409,3663,3541
4,7304,10,100,0.0001,0.01,0.768,0.9656352683461117,3713,3591
4,7404,10,100,0.0001,0.01,0.77,0.9617774176121016,3765,3639
4,7504,10,100,0.0001,0.01,0.778,0.9613539445628998,3813,3691
4,7604,10,100,0.0001,0.01,0.788,0.9602840610205156,3865,3739
4,7704,10,100,0.0001,0.01,0.764,0.9361370716510904,3911,3793
4,7804,10,100,0.0001,0.01,0.808,0.9656586365966171,3962,3842
4,7904,10,100,0.0001,0.01,0.796,0.9673582995951417,4009,3895
4,8004,10,100,0.0001,0.01,0.776,0.9787606196901549,4063,3941
4,8104,10,100,0.0001,0.01,0.788,0.9749506416584403,4114,3990
4,8204,10,100,0.0001,0.01,0.804,0.9783032666991711,4170,4034
4,8304,10,100,0.0001,0.01,0.808,0.9735067437379576,4218,4086
4,8404,10,100,0.0001,0.01,0.802,0.9731080437886721,4264,4140
4,8504,10,100,0.0001,0.01,0.83,0.9695437441204139,4313,4191
4,8604,10,100,0.0001,0.01,0.804,0.9697814969781497,4358,4246
4,8704,10,100,0.0001,0.01,0.824,0.9669117647058824,4409,4295
4,8804,10,100,0.0001,0.01,0.84,0.9727396637891867,4453,4351
4,8904,10,100,0.0001,0.01,0.824,0.97911051212938,4499,4405
4,9004,10,100,0.0001,0.01,0.848,0.9826743669480231,4547,4457
4,9104,10,100,0.0001,0.01,0.848,0.9867091388400703,4601,4503
4,9204,10,100,0.0001,0.01,0.846,0.9831594958713603,4648,4556
4,9304,10,100,0.0001,0.01,0.856,0.9831255374032674,4695,4609
4,9404,10,100,0.0001,0.01,0.864,0.9820289238621863,4743,4661
4,9504,10,100,0.0001,0.01,0.844,0.9835858585858586,4786,4718
4,9604,10,100,0.0001,0.01,0.87,0.990420658059142,4834,4770
4,9704,10,100,0.0001,0.01,0.852,0.9819661995053586,4878,4826
4,9804,10,100,0.0001,0.01,0.848,0.97796817625459,4932,4872
4,9904,10,100,0.0001,0.01,0.876,0.9829361873990307,4980,4924
4,10004,10,100,0.0001,0.01,0.868,0.9767093162734906,5035,4969
4,10104,10,100,0.0001,0.01,0.872,0.9800079176563737,5081,5023
4,10204,10,100,0.0001,0.01,0.866,0.9799098392787142,5135,5069
4,10304,10,100,0.0001,0.01,0.882,0.9879658385093167,5185,5119
4,10404,10,100,0.0001,0.01,0.864,0.988081507112649,5234,5170
4,10504,10,100,0.0001,0.01,0.904,0.9928598629093679,5280,5224
4,10604,10,100,0.0001,0.01,0.892,0.9941531497548095,5321,5283
4,10704,10,100,0.0001,0.01,0.894,0.9930866965620329,5364,5340
4,10804,10,100,0.0001,0.01,0.892,0.9927804516845613,5418,5386
4,10904,10,100,0.0001,0.01,0.904,0.9901870873074101,5457,5447
4,11004,10,100,0.0001,0.01,0.892,0.9830970556161396,5504,5500
4,11104,10,100,0.0001,0.01,0.904,0.9763148414985591,5556,5548
4,11204,10,100,0.0001,0.01,0.884,0.9784005712245627,5604,5600
4,11304,10,100,0.0001,0.01,0.892,0.9877034677990092,5654,5650
4,11404,10,100,0.0001,0.01,0.91,0.9885128025254297,5705,5699
4,11504,10,100,0.0001,0.01,0.914,0.9961752433936022,5750,5754
4,11604,10,100,0.0001,0.01,0.924,0.9967252671492589,5790,5814
4,11704,10,100,0.0001,0.01,0.928,0.9966678058783321,5840,5864
4,11804,10,100,0.0001,0.01,0.914,0.9928837682141647,5888,5916
4,11904,10,100,0.0001,0.01,0.928,0.9945396505376344,5935,5969
4,12004,10,100,0.0001,0.01,0.93,0.9869210263245585,5988,6016
4,12104,10,100,0.0001,0.01,0.926,0.9893423661599471,6038,6066
4,12204,10,100,0.0001,0.01,0.94,0.9963126843657817,6086,6118
4,12304,10,100,0.0001,0.01,0.942,0.991222366710013,6135,6169
4,12404,10,100,0.0001,0.01,0.918,0.9783940664301838,6190,6214
4,12504,10,100,0.0001,0.01,0.918,0.9833653230966091,6249,6255
4,12604,10,100,0.0001,0.01,0.932,0.9907965725166614,6298,6306
4,12704,10,100,0.0001,0.01,0.938,0.9917348866498741,6348,6356
4,12804,10,100,0.0001,0.01,0.938,0.9899250234301781,6399,6405
4,12904,10,100,0.0001,0.01,0.952,0.9987600743955363,6448,6456
4,13004,10,100,0.0001,0.01,0.948,0.9987696093509689,6496,6508
4,13104,10,100,0.0001,0.01,0.948,0.9989316239316239,6559,6545
4,13204,10,100,0.0001,0.01,0.96,0.9991669191154195,6604,6600
4,13304,10,100,0.0001,0.01,0.954,0.9996241731809982,6651,6653
4,13404,10,100,0.0001,0.01,0.958,0.9994777678304984,6703,6701
4,13504,10,100,0.0001,0.01,0.96,0.9996297393364929,6755,6749
4,13604,10,100,0.0001,0.01,0.96,0.9995589532490444,6811,6793
4,13704,10,100,0.0001,0.01,0.966,0.9994892002335085,6862,6842
4,13804,10,100,0.0001,0.01,0.954,0.9970298464213272,6917,6887
4,13904,10,100,0.0001,0.01,0.944,0.9925920598388953,6964,6940
4,14004,10,100,0.0001,0.01,0.936,0.9830048557554985,7016,6988
4,14104,10,100,0.0001,0.01,0.95,0.986528644356211,7067,7037
4,14204,10,100,0.0001,0.01,0.958,0.9952126161644607,7107,7097
4,14304,10,100,0.0001,0.01,0.976,0.9964345637583892,7145,7159
4,14404,10,100,0.0001,0.01,0.962,0.9975701194112746,7198,7206
4,14504,10,100,0.0001,0.01,0.968,0.9970353006067292,7238,7266
4,14604,10,100,0.0001,0.01,0.97,0.9996576280471103,7288,7316
4,14704,10,100,0.0001,0.01,0.964,0.9942872687704026,7355,7349
4,14804,10,100,0.0001,0.01,0.968,0.9989867603350446,7401,7403
4,14904,10,100,0.0001,0.01,0.968,0.9985909822866345,7454,7450
4,15004,10,100,0.0001,0.01,0.96,0.9957344708077845,7497,7507
5,104,10,100,0.0001,0.01,0.512,0.5,52,52
5,204,10,100,0.0001,0.01,0.494,0.6078431372549019,101,103
5,304,10,100,0.0001,0.01,0.47,0.6118421052631579,152,152
5,404,10,100,0.0001,0.01,0.51,0.556930693069307,194,210
5,504,10,100,0.0001,0.01,0.5,0.5535714285714286,244,260
5,604,10,100,0.0001,0.01,0.472,0.6473509933774835,292,312
5,704,10,100,0.0001,0.01,0.49,0.6164772727272727,345,359
5,804,10,100,0.0001,0.01,0.51,0.6467661691542289,398,406
5,904,10,100,0.0001,0.01,0.506,0.6548672566371682,451,453
5,1004,10,100,0.0001,0.01,0.52,0.6882470119521913,502,502
5,1104,10,100,0.0001,0.01,0.518,0.7056159420289855,558,546
5,1204,10,100,0.0001,0.01,0.512,0.729235880398671,606,598
5,1304,10,100,0.0001,0.01,0.526,0.7047546012269938,659,645
5,1404,10,100,0.0001,0.01,0.552,0.7243589743589743,712,692
5,1504,10,100,0.0001,0.01,0.514,0.7160904255319149,763,741
5,1604,10,100,0.0001,0.01,0.566,0.7381546134663342,817,787
5,1704,10,100,0.0001,0.01,0.55,0.7341549295774648,869,835
5,1804,10,100,0.0001,0.01,0.54,0.7716186252771619,920,884
5,1904,10,100,0.0001,0.01,0.554,0.7715336134453782,975,929
5,2004,10,100,0.0001,0.01,0.556,0.7395209580838323,1028,976
5,2104,10,100,0.0001,0.01,0.566,0.7576045627376425,1078,1026
5,2204,10,100,0.0001,0.01,0.584,0.8121597096188747,1131,1073
5,2304,10,100,0.0001,0.01,0.558,0.7921006944444444,1187,1117
5,2404,10,100,0.0001,0.01,0.564,0.8015806988352745,1239,1165
5,2504,10,100,0.0001,0.01,0.588,0.8190894568690096,1286,1218
5,2604,10,100,0.0001,0.01,0.628,0.8571428571428571,1338,1266
5,2704,10,100,0.0001,0.01,0.634,0.8890532544378699,1389,1315
5,2804,10,100,0.0001,0.01,0.66,0.9037089871611983,1444,1360
5,2904,10,100,0.0001,0.01,0.688,0.918732782369146,1495,1409
5,3004,10,100,0.0001,0.01,0.7,0.9064580559254327,1552,1452
5,3104,10,100,0.0001,0.01,0.732,0.9226804123711341,1606,1498
5,3204,10,100,0.0001,0.01,0.768,0.936641697877653,1653,1551
5,3304,10,100,0.0001,0.01,0.78,0.9524818401937046,1703,1601
5,3404,10,100,0.0001,0.01,0.788,0.9668037602820212,1746,1658
5,3504,10,100,0.0001,0.01,0.788,0.954337899543379,1794,1710
5,3604,10,100,0.0001,0.01,0.816,0.9614317425083241,1836,1768
5,3704,10,100,0.0001,0.01,0.82,0.9303455723542117,1887,1817
5,3804,10,100,0.0001,0.01,0.806,0.945583596214511,1938,1866
5,3904,10,100,0.0001,0.01,0.856,0.9697745901639344,1986,1918
5,4004,10,100,0.0001,0.01,0.858,0.9667832167832168,2041,1963
5,4104,10,100,0.0001,0.01,0.862,0.9868421052631579,2091,2013
5,4204,10,100,0.0001,0.01,0.896,0.9883444338725024,2139,2065
5,4304,10,100,0.0001,0.01,0.894,0.9965148698884758,2180,2124
5,4404,10,100,0.0001,0.01,0.904,0.992960944595822,2230,2174
5,4504,10,100,0.0001,0.01,0.912,0.9960035523978685,2281,2223
5,4604,10,100,0.0001,0.01,0.902,0.9821894005212859,2328,2276
5,4704,10,100,0.0001,0.01,0.906,0.9893707482993197,2379,2325
5,4804,10,100,0.0001,0.01,0.922,0.9929225645295587,2439,2365
5,4904,10,100,0.0001,0.01,0.916,0.9930668841761827,2488,2416
5,5004,10,100,0.0001,0.01,0.91,0.9960031974420464,2543,2461
5,5104,10,100,0.0001,0.01,0.906,0.9907915360501567,2600,2504
5,5204,10,100,0.0001,0.01,0.928,0.9796310530361261,2643,2561
5,5304,10,100,0.0001,0.01,0.89,0.956447963800905,2695,2609
5,5404,10,100,0.0001,0.01,0.91,0.9759437453737971,2745,2659
5,5504,10,100,0.0001,0.01,0.944,0.9880087209302325,2801,2703
5,5604,10,100,0.0001,0.01,0.956,0.9944682369735903,2851,2753
5,5704,10,100,0.0001,0.01,0.956,0.9982468443197756,2899,2805
5,5804,10,100,0.0001,0.01,0.962,0.9960372157133012,2951,2853
5,5904,10,100,0.0001,0.01,0.958,0.9988143631436315,2994,2910
5,6004,10,100,0.0001,0.01,0.958,0.9976682211858761,3040,2964
5,6104,10,100,0.0001,0.01,0.956,0.9981979030144168,3088,3016
5,6204,10,100,0.0001,0.01,0.938,0.9895228884590587,3141,3063
5,6304,10,100,0.0001,0.01,0.948,0.9895304568527918,3184,3120
5,6404,10,100,0.0001,0.01,0.952,0.9896939412866959,3236,3168
5,6504,10,100,0.0001,0.01,0.952,0.9898523985239852,3280,3224
5,6604,10,100,0.0001,0.01,0.958,0.9892489400363416,3341,3263
5,6704,10,100,0.0001,0.01,0.968,0.9977625298329356,3396,3308
5,6804,10,100,0.0001,0.01,0.968,0.9985302763080541,3445,3359
5,6904,10,100,0.0001,0.01,0.966,0.9985515643105446,3501,3403
5,7004,10,100,0.0001,0.01,0.966,0.9997144488863506,3540,3464
5,7104,10,100,0.0001,0.01,0.968,0.9992961711711712,3584,3520
5,7204,10,100,0.0001,0.01,0.972,0.9956968350916158,3630,3574
5,7304,10,100,0.0001,0.01,0.97,0.9990416210295728,3677,3627
5,7404,10,100,0.0001,0.01,0.978,0.9991896272285251,3726,3678
5,7504,10,100,0.0001,0.01,0.964,0.9950692963752665,3779,3725
5,7604,10,100,0.0001,0.01,0.944,0.9805365597054182,3830,3774
5,7704,10,100,0.0001,0.01,0.966,0.990134994807892,3879,3825
5,7804,10,100,0.0001,0.01,0.972,0.9973090722706305,3921,3883
5,7904,10,100,0.0001,0.01,0.974,0.9964574898785425,3969,3935
5,8004,10,100,0.0001,0.01,0.974,0.9973763118440779,4027,3977
5,8104,10,100,0.0001,0.01,0.976,0.9972852912142152,4077,4027
5,8204,10,100,0.0001,0.01,0.976,0.9951243295953194,4126,4078
5,8304,10,100,0.0001,0.01,0.98,0.9967485549132948,4177,4127
5,8404,10,100,0.0001,0.01,0.956,0.9811994288434079,4219,4185
5,8504,10,100,0.0001,0.01,0.97,0.9883584195672624,4267,4237
5,8604,10,100,0.0001,0.01,0.982,0.9920966992096699,4319,4285
5,8704,10,100,0.0001,0.01,0.982,0.9978170955882353,4370,4334
5,8804,10,100,0.0001,0.01,0.986,0.9986369831894594,4423,4381
5,8904,10,100,0.0001,0.01,0.986,0.998989218328841,4471,4433
5,9004,10,100,0.0001,0.01,0.988,0.9988893824966681,4524,4480
5,9104,10,100,0.0001,0.01,0.984,0.9990114235500879,4572,4532
5,9204,10,100,0.0001,0.01,0.98,0.9956540634506736,4625,4579
5,9304,10,100,0.0001,0.01,0.978,0.9941960447119519,4667,4637
5,9404,10,100,0.0001,0.01,0.982,0.9956401531263293,4716,4688
5,9504,10,100,0.0001,0.01,0.984,0.9963173400673401,4772,4732
5,9604,10,100,0.0001,0.01,0.988,0.9978134110787172,4827,4777
5,9704,10,100,0.0001,0.01,0.98,0.997835943940643,4876,4828
5,9804,10,100,0.0001,0.01,0.966,0.9703182374541004,4926,4878
5,9904,10,100,0.0001,0.01,0.97,0.9810177705977383,4977,4927
5,10004,10,100,0.0001,0.01,0.98,0.9929028388644542,5029,4975
5,10104,10,100,0.0001,0.01,0.984,0.9927751385589866,5082,5022
5,10204,10,100,0.0001,0.01,0.99,0.996765974127793,5133,5071
5,10304,10,100,0.0001,0.01,0.99,0.9918478260869565,5190,5114
5,10404,10,100,0.0001,0.01,0.988,0.9955786236063052,5236,5168
5,10504,10,100,0.0001,0.01,0.99,0.9973343488194973,5280,5224
5,10604,10,100,0.0001,0.01,0.988,0.9985854394568088,5328,5276
5,10704,10,100,0.0001,0.01,0.992,0.9988789237668162,5378,5326
5,10804,10,100,0.0001,0.01,0.992,0.9997223250647909,5431,5373
5,10904,10,100,0.0001,0.01,0.992,0.9990829053558328,5479,5425
5,11004,10,100,0.0001,0.01,0.986,0.9980916030534351,5531,5473
5,11104,10,100,0.0001,0.01,0.99,0.9987391930835735,5580,5524
5,11204,10,100,0.0001,0.01,0.99,0.9994644769725098,5632,5572
5,11304,10,100,0.0001,0.01,0.982,0.9947806086341118,5682,5622
5,11404,10,100,0.0001,0.01,0.994,0.9970185899684322,5735,5669
5,11504,10,100,0.0001,0.01,0.986,0.9967837273991655,5794,5710
5,11604,10,100,0.0001,0.01,0.992,0.995432609445019,5848,5756
5,11704,10,100,0.0001,0.01,0.992,0.9984620642515379,5893,5811
5,11804,10,100,0.0001,0.01,0.996,0.9983903761436801,5943,5861
5,11904,10,100,0.0001,0.01,0.992,0.998067876344086,5994,5910
5,12004,10,100,0.0001,0.01,0.992,0.9972509163612129,6036,5968
5,12104,10,100,0.0001,0.01,0.99,0.9952081956378057,6089,6015
5,12204,10,100,0.0001,0.01,0.994,0.9969682071451983,6129,6075
5,12304,10,100,0.0001,0.01,0.994,0.997074122236671,6173,6131
5,12404,10,100,0.0001,0.01,0.992,0.9941148016768784,6215,6189
5,12504,10,100,0.0001,0.01,0.988,0.9882437619961613,6258,6246
5,12604,10,100,0.0001,0.01,0.992,0.9963503649635036,6307,6297
5,12704,10,100,0.0001,0.01,0.994,0.9974811083123426,6356,6348
5,12804,10,100,0.0001,0.01,0.99,0.9974226804123711,6404,6400
5,12904,10,100,0.0001,0.01,0.996,0.9986050836949782,6453,6451
5,13004,10,100,0.0001,0.01,0.996,0.99930790525992,6507,6497
5,13104,10,100,0.0001,0.01,0.996,0.9997710622710623,6562,6542
5,13204,10,100,0.0001,0.01,0.996,1.0,6612,6592
5,13304,10,100,0.0001,0.01,0.996,1.0,6655,6649
5,13404,10,100,0.0001,0.01,0.996,1.0,6704,6700
5,13504,10,100,0.0001,0.01,0.994,0.9984449052132701,6753,6751
5,13604,10,100,0.0001,0.01,0.982,0.9851514260511615,6799,6805
5,13704,10,100,0.0001,0.01,0.996,0.9964244016345593,6854,6850
5,13804,10,100,0.0001,0.01,0.994,0.997681831353231,6903,6901
5,13904,10,100,0.0001,0.01,0.996,0.9985615650172612,6958,6946
5,14004,10,100,0.0001,0.01,0.996,0.9995715509854327,7003,7001
5,14104,10,100,0.0001,0.01,0.994,0.9995745887691435,7056,7048
5,14204,10,100,0.0001,0.01,0.996,0.9999295972965362,7103,7101
5,14304,10,100,0.0001,0.01,0.994,0.9995805369127517,7156,7148
5,14404,10,100,0.0001,0.01,0.994,0.9998611496806442,7201,7203
5,14504,10,100,0.0001,0.01,0.996,0.9998621070049641,7259,7245
5,14604,10,100,0.0001,0.01,0.992,0.9969871268145714,7311,7293
5,14704,10,100,0.0001,0.01,0.972,0.9803454842219804,7361,7343
5,14804,10,100,0.0001,0.01,0.99,0.995271548230208,7410,7394
5,14904,10,100,0.0001,0.01,0.994,0.9975174449812131,7464,7440
5,15004,10,100,0.0001,0.01,0.996,0.999466808850973,7508,7496
6,104,10,100,0.0001,0.01,0.49,0.5288461538461539,53,51
6,204,10,100,0.0001,0.01,0.474,0.6078431372549019,100,104
6,304,10,100,0.0001,0.01,0.484,0.6151315789473685,156,148
6,404,10,100,0.0001,0.01,0.482,0.6386138613861386,211,193
6,504,10,100,0.0001,0.01,0.48,0.6468253968253969,259,245
6,604,10,100,0.0001,0.01,0.486,0.6688741721854304,309,295
6,704,10,100,0.0001,0.01,0.482,0.6704545454545454,359,345
6,804,10,100,0.0001,0.01,0.492,0.6803482587064676,410,394
6,904,10,100,0.0001,0.01,0.486,0.668141592920354,457,447
6,1004,10,100,0.0001,0.01,0.502,0.6972111553784861,503,501
6,1104,10,100,0.0001,0.01,0.496,0.6666666666666666,545,559
6,1204,10,100,0.0001,0.01,0.484,0.7250830564784053,590,614
6,1304,10,100,0.0001,0.01,0.524,0.7039877300613497,631,673
6,1404,10,100,0.0001,0.01,0.508,0.7514245014245015,685,719
6,1504,10,100,0.0001,0.01,0.484,0.7493351063829787,739,765
6,1604,10,100,0.0001,0.01,0.484,0.7786783042394015,789,815
6,1704,10,100,0.0001,0.01,0.526,0.7764084507042254,838,866
6,1804,10,100,0.0001,0.01,0.482,0.7987804878048781,900,904
6,1904,10,100,0.0001,0.01,0.49,0.8114495798319328,951,953
6,2004,10,100,0.0001,0.01,0.53,0.8273453093812375,995,1009
6,2104,10,100,0.0001,0.01,0.522,0.8578897338403042,1049,1055
6,2204,10,100,0.0001,0.01,0.552,0.8348457350272233,1087,1117
6,2304,10,100,0.0001,0.01,0.58,0.8454861111111112,1140,1164
6,2404,10,100,0.0001,0.01,0.558,0.841514143094842,1197,1207
6,2504,10,100,0.0001,0.01,0.582,0.8821884984025559,1242,1262
6,2604,10,100,0.0001,0.01,0.572,0.825652841781874,1285,1319
6,2704,10,100,0.0001,0.01,0.622,0.9005177514792899,1344,1360
6,2804,10,100,0.0001,0.01,0.604,0.8905135520684736,1388,1416
6,2904,10,100,0.0001,0.01,0.64,0.9025482093663911,1436,1468
6,3004,10,100,0.0001,0.01,0.67,0.8625166444740346,1476,1528
6,3104,10,100,0.0001,0.01,0.692,0.8617912371134021,1520,1584
6,3204,10,100,0.0001,0.01,0.664,0.9313358302122348,1573,1631
6,3304,10,100,0.0001,0.01,0.72,0.9176755447941889,1628,1676
6,3404,10,100,0.0001,0.01,0.766,0.9529964747356052,1674,1730
6,3504,10,100,0.0001,0.01,0.772,0.964041095890411,1729,1775
6,3604,10,100,0.0001,0.01,0.788,0.9730854605993341,1775,1829
6,3704,10,100,0.0001,0.01,0.794,0.9719222462203023,1831,1873
6,3804,10,100,0.0001,0.01,0.792,0.9710830704521556,1887,1917
6,3904,10,100,0.0001,0.01,0.772,0.9628586065573771,1932,1972
6,4004,10,100,0.0001,0.01,0.808,0.9715284715284715,1983,2021
6,4104,10,100,0.0001,0.01,0.816,0.98635477582846,2037,2067
6,4204,10,100,0.0001,0.01,0.798,0.9716936251189343,2080,2124
6,4304,10,100,0.0001,0.01,0.83,0.9848977695167286,2129,2175
6,4404,10,100,0.0001,0.01,0.818,0.9663941871026339,2171,2233
6,4504,10,100,0.0001,0.01,0.852,0.9757992895204263,2226,2278
6,4604,10,100,0.0001,0.01,0.848,0.9837098175499566,2274,2330
6,4704,10,100,0.0001,0.01,0.846,0.9887329931972789,2326,2378
6,4804,10,100,0.0001,0.01,0.856,0.9910491257285595,2385,2419
6,4904,10,100,0.0001,0.01,0.878,0.9918433931484503,2429,2475
6,5004,10,100,0.0001,0.01,0.866,0.9864108713029577,2479,2525
6,5104,10,100,0.0001,0.01,0.872,0.992358934169279,2527,2577
6,5204,10,100,0.0001,0.01,0.882,0.9942352036894696,2577,2627
6,5304,10,100,0.0001,0.01,0.886,0.9905731523378583,2627,2677
6,5404,10,100,0.0001,0.01,0.88,0.9937083641746854,2680,2724
6,5504,10,100,0.0001,0.01,0.874,0.9823764534883721,2731,2773
6,5604,10,100,0.0001,0.01,0.906,0.9841184867951464,2782,2822
6,5704,10,100,0.0001,0.01,0.87,0.958625525946704,2828,2876
6,5804,10,100,0.0001,0.01,0.884,0.9669193659545141,2878,2926
6,5904,10,100,0.0001,0.01,0.846,0.9366531165311653,2930,2974
6,6004,10,100,0.0001,0.01,0.898,0.9766822118587608,2986,3018
6,6104,10,100,0.0001,0.01,0.9,0.9852555701179554,3040,3064
6,6204,10,100,0.0001,0.01,0.904,0.9887169568020632,3098,3106
6,6304,10,100,0.0001,0.01,0.92,0.9893718274111675,3153,3151
6,6404,10,100,0.0001,0.01,0.922,0.9950031230480949,3203,3201
6,6504,10,100,0.0001,0.01,0.93,0.9973862238622386,3252,3252
6,6604,10,100,0.0001,0.01,0.916,0.9940944881889764,3297,3307
6,6704,10,100,0.0001,0.01,0.928,0.9920942720763724,3349,3355
6,6804,10,100,0.0001,0.01,0.924,0.9769253380364491,3403,3401
6,6904,10,100,0.0001,0.01,0.912,0.9634994206257242,3443,3461
6,7004,10,100,0.0001,0.01,0.934,0.9875785265562536,3495,3509
6,7104,10,100,0.0001,0.01,0.928,0.9918355855855856,3543,3561
6,7204,10,100,0.0001,0.01,0.936,0.9929205996668518,3590,3614
6,7304,10,100,0.0001,0.01,0.938,0.9956188389923329,3643,3661
6,7404,10,100,0.0001,0.01,0.946,0.9974338195569962,3691,3713
6,7504,10,100,0.0001,0.01,0.942,0.9972014925373134,3728,3776
6,7604,10,100,0.0001,0.01,0.938,0.9981588637559179,3774,3830
6,7704,10,100,0.0001,0.01,0.944,0.9964953271028038,3826,3878
6,7804,10,100,0.0001,0.01,0.944,0.996155817529472,3878,3926
6,7904,10,100,0.0001,0.01,0.948,0.9953188259109311,3927,3977
6,8004,10,100,0.0001,0.01,0.944,0.9945027486256871,3963,4041
6,8104,10,100,0.0001,0.01,0.94,0.991238894373149,4009,4095
6,8204,10,100,0.0001,0.01,0.932,0.98488542174549,4069,4135
6,8304,10,100,0.0001,0.01,0.952,0.9956647398843931,4123,4181
6,8404,10,100,0.0001,0.01,0.952,0.9955973346025702,4177,4227
6,8504,10,100,0.0001,0.01,0.956,0.9941204139228599,4225,4279
6,8604,10,100,0.0001,0.01,0.916,0.9615295211529521,4276,4328
6,8704,10,100,0.0001,0.01,0.92,0.9426700367647058,4327,4377
6,8804,10,100,0.0001,0.01,0.946,0.9773966378918674,4378,4426
6,8904,10,100,0.0001,0.01,0.946,0.9895552560646901,4423,4481
6,9004,10,100,0.0001,0.01,0.96,0.9930031097290093,4478,4526
6,9104,10,100,0.0001,0.01,0.958,0.992640597539543,4535,4569
6,9204,10,100,0.0001,0.01,0.954,0.992503259452412,4587,4617
6,9304,10,100,0.0001,0.01,0.964,0.9946259673258814,4633,4671
6,9404,10,100,0.0001,0.01,0.962,0.995427477669077,4683,4721
6,9504,10,100,0.0001,0.01,0.968,0.9953703703703703,4738,4766
6,9604,10,100,0.0001,0.01,0.968,0.9984381507705122,4787,4817
6,9704,10,100,0.0001,0.01,0.972,0.9976298433635614,4830,4874
6,9804,10,100,0.0001,0.01,0.966,0.9940840473276213,4892,4912
6,9904,10,100,0.0001,0.01,0.962,0.9958602584814217,4944,4960
6,10004,10,100,0.0001,0.01,0.964,0.991703318672531,4985,5019
6,10104,10,100,0.0001,0.01,0.976,0.9979216152019003,5035,5069
6,10204,10,100,0.0001,0.01,0.968,0.992061936495492,5082,5122
6,10304,10,100,0.0001,0.01,0.962,0.9970885093167702,5138,5166
6,10404,10,100,0.0001,0.01,0.974,0.9970203767781622,5193,5211
6,10504,10,100,0.0001,0.01,0.966,0.992003046458492,5235,5269
6,10604,10,100,0.0001,0.01,0.972,0.9919841569219162,5281,5323
6,10704,10,100,0.0001,0.01,0.972,0.9962630792227205,5333,5371
6,10804,10,100,0.0001,0.01,0.97,0.9985190670122177,5390,5414
6,10904,10,100,0.0001,0.01,0.96,0.9947725605282465,5439,5465
6,11004,10,100,0.0001,0.01,0.97,0.9970919665576155,5496,5508
6,11104,10,100,0.0001,0.01,0.968,0.9950468299711815,5550,5554
6,11204,10,100,0.0001,0.01,0.97,0.9950017850767583,5594,5610
6,11304,10,100,0.0001,0.01,0.974,0.9974345364472753,5646,5658
6,11404,10,100,0.0001,0.01,0.97,0.9980708523325149,5693,5711
6,11504,10,100,0.0001,0.01,0.978,0.9954798331015299,5736,5768
6,11604,10,100,0.0001,0.01,0.97,0.995174077904171,5787,5817
6,11704,10,100,0.0001,0.01,0.96,0.9921394395078605,5847,5857
6,11804,10,100,0.0001,0.01,0.97,0.9938156557099288,5898,5906
6,11904,10,100,0.0001,0.01,0.97,0.9938676075268817,5942,5962
6,12004,10,100,0.0001,0.01,0.97,0.9956681106297901,5994,6010
6,12104,10,100,0.0001,0.01,0.976,0.9975214805023133,6041,6063
6,12204,10,100,0.0001,0.01,0.976,0.9984431333988856,6094,6110
6,12304,10,100,0.0001,0.01,0.97,0.9967490247074122,6143,6161
6,12404,10,100,0.0001,0.01,0.976,0.9909706546275395,6197,6207
6,12504,10,100,0.0001,0.01,0.974,0.9912827895073576,6246,6258
6,12604,10,100,0.0001,0.01,0.976,0.9931767692795938,6297,6307
6,12704,10,100,0.0001,0.01,0.972,0.9945686397984886,6337,6367
6,12804,10,100,0.0001,0.01,0.98,0.9972664792252421,6387,6417
6,12904,10,100,0.0001,0.01,0.982,0.9970551766893986,6439,6465
6,13004,10,100,0.0001,0.01,0.984,0.9984620116887112,6494,6510
6,13104,10,100,0.0001,0.01,0.982,0.999465811965812,6548,6556
6,13204,10,100,0.0001,0.01,0.974,0.9906089063920024,6606,6598
6,13304,10,100,0.0001,0.01,0.978,0.9964672279013831,6660,6644
6,13404,10,100,0.0001,0.01,0.984,0.9985825126827813,6703,6701
6,13504,10,100,0.0001,0.01,0.984,0.9973341232227488,6756,6748
6,13604,10,100,0.0001,0.01,0.93,0.9514848573948839,6814,6790
6,13704,10,100,0.0001,0.01,0.946,0.9575306479859895,6863,6841
6,13804,10,100,0.0001,0.01,0.97,0.9800782381918285,6906,6898
6,13904,10,100,0.0001,0.01,0.976,0.9900747986191024,6955,6949
6,14004,10,100,0.0001,0.01,0.972,0.9904313053413311,7010,6994
6,14104,10,100,0.0001,0.01,0.98,0.9934061259217243,7059,7045
6,14204,10,100,0.0001,0.01,0.98,0.9932413404674739,7106,7098
6,14304,10,100,0.0001,0.01,0.978,0.9941974272930649,7156,7148
6,14404,10,100,0.0001,0.01,0.98,0.9931269091918912,7212,7192
6,14504,10,100,0.0001,0.01,0.982,0.9900027578599007,7269,7235
6,14604,10,100,0.0001,0.01,0.954,0.9709668583949603,7313,7291
6,14704,10,100,0.0001,0.01,0.98,0.9948313384113167,7363,7341
6,14804,10,100,0.0001,0.01,0.98,0.9969602810051338,7412,7392
6,14904,10,100,0.0001,0.01,0.98,0.9928207192699946,7460,7444
6,15004,10,100,0.0001,0.01,0.982,0.9978672354038923,7505,7499
7,104,10,100,0.0001,0.01,0.56,0.5961538461538461,52,52
7,204,10,100,0.0001,0.01,0.508,0.6470588235294118,95,109
7,304,10,100,0.0001,0.01,0.496,0.5888157894736842,140,164
7,404,10,100,0.0001,0.01,0.502,0.6262376237623762,193,211
7,504,10,100,0.0001,0.01,0.532,0.623015873015873,242,262
7,604,10,100,0.0001,0.01,0.522,0.6043046357615894,295,309
7,704,10,100,0.0001,0.01,0.512,0.6065340909090909,346,358
7,804,10,100,0.0001,0.01,0.532,0.6567164179104478,389,415
7,904,10,100,0.0001,0.01,0.528,0.6382743362831859,441,463
7,1004,10,100,0.0001,0.01,0.528,0.6673306772908366,492,512
7,1104,10,100,0.0001,0.01,0.53,0.6938405797101449,537,567
7,1204,10,100,0.0001,0.01,0.546,0.7026578073089701,580,624
7,1304,10,100,0.0001,0.01,0.524,0.7001533742331288,634,670
7,1404,10,100,0.0001,0.01,0.538,0.7257834757834758,693,711
7,1504,10,100,0.0001,0.01,0.512,0.7406914893617021,745,759
7,1604,10,100,0.0001,0.01,0.562,0.7724438902743143,799,805
7,1704,10,100,0.0001,0.01,0.53,0.7846244131455399,847,857
7,1804,10,100,0.0001,0.01,0.56,0.7450110864745011,895,909
7,1904,10,100,0.0001,0.01,0.52,0.7741596638655462,944,960
7,2004,10,100,0.0001,0.01,0.522,0.779441117764471,992,1012
7,2104,10,100,0.0001,0.01,0.586,0.7913498098859315,1037,1067
7,2204,10,100,0.0001,0.01,0.59,0.8325771324863884,1083,1121
7,2304,10,100,0.0001,0.01,0.618,0.8328993055555556,1131,1173
7,2404,10,100,0.0001,0.01,0.624,0.8406821963394343,1187,1217
7,2504,10,100,0.0001,0.01,0.606,0.8354632587859425,1250,1254
7,2604,10,100,0.0001,0.01,0.63,0.8832565284178188,1302,1302
7,2704,10,100,0.0001,0.01,0.634,0.8912721893491125,1346,1358
7,2804,10,100,0.0001,0.01,0.62,0.8477175463623395,1396,1408
7,2904,10,100,0.0001,0.01,0.696,0.8997933884297521,1439,1465
7,3004,10,100,0.0001,0.01,0.702,0.9091211717709721,1485,1519
7,3104,10,100,0.0001,0.01,0.732,0.9420103092783505,1548,1556
7,3204,10,100,0.0001,0.01,0.742,0.932896379525593,1594,1610
7,3304,10,100,0.0001,0.01,0.77,0.9458232445520581,1643,1661
7,3404,10,100,0.0001,0.01,0.764,0.9565217391304348,1693,1711
7,3504,10,100,0.0001,0.01,0.782,0.9620433789954338,1738,1766
7,3604,10,100,0.0001,0.01,0.768,0.9503329633740288,1786,1818
7,3704,10,100,0.0001,0.01,0.778,0.9395248380129589,1844,1860
7,3804,10,100,0.0001,0.01,0.794,0.9526813880126183,1899,1905
7,3904,10,100,0.0001,0.01,0.826,0.9585040983606558,1944,1960
7,4004,10,100,0.0001,0.01,0.848,0.9737762237762237,1993,2011
7,4104,10,100,0.0001,0.01,0.866,0.9841617933723197,2049,2055
7,4204,10,100,0.0001,0.01,0.862,0.9766888677450047,2100,2104
7,4304,10,100,0.0001,0.01,0.882,0.9823420074349443,2159,2145
7,4404,10,100,0.0001,0.01,0.886,0.9820617620345141,2210,2194
7,4504,10,100,0.0001,0.01,0.904,0.991785079928952,2257,2247
7,4604,10,100,0.0001,0.01,0.904,0.9928323197219809,2306,2298
7,4704,10,100,0.0001,0.01,0.902,0.9944727891156463,2356,2348
7,4804,10,100,0.0001,0.01,0.892,0.9866777685262281,2413,2391
7,4904,10,100,0.0001,0.01,0.894,0.9877650897226754,2465,2439
7,5004,10,100,0.0001,0.01,0.894,0.9822142286171063,2508,2496
7,5104,10,100,0.0001,0.01,0.92,0.9933385579937304,2552,2552
7,5204,10,100,0.0001,0.01,0.892,0.9715603382013835,2607,2597
7,5304,10,100,0.0001,0.01,0.896,0.9743589743589743,2661,2643
7,5404,10,100,0.0001,0.01,0.9,0.9742783123612139,2716,2688
7,5504,10,100,0.0001,0.01,0.874,0.9384084302325582,2775,2729
7,5604,10,100,0.0001,0.01,0.908,0.9657387580299786,2815,2789
7,5704,10,100,0.0001,0.01,0.914,0.9784361851332398,2868,2836
7,5804,10,100,0.0001,0.01,0.928,0.9912129565816679,2913,2891
7,5904,10,100,0.0001,0.01,0.936,0.9966124661246613,2966,2938
7,6004,10,100,0.0001,0.01,0.938,0.9943371085942705,3011,2993
7,6104,10,100,0.0001,0.01,0.938,0.9965596330275229,3057,3047
7,6204,10,100,0.0001,0.01,0.956,0.9961315280464217,3099,3105
7,6304,10,100,0.0001,0.01,0.948,0.9963515228426396,3137,3167
7,6404,10,100,0.0001,0.01,0.956,0.9976577139287945,3187,3217
7,6504,10,100,0.0001,0.01,0.946,0.9958487084870848,3235,3269
7,6604,10,100,0.0001,0.01,0.954,0.9981829194427619,3287,3317
7,6704,10,100,0.0001,0.01,0.958,0.9992541766109785,3347,3357
7,6804,10,100,0.0001,0.01,0.954,0.993533215755438,3400,3404
7,6904,10,100,0.0001,0.01,0.954,0.9929026651216686,3448,3456
7,7004,10,100,0.0001,0.01,0.956,0.9872929754426042,3501,3503
7,7104,10,100,0.0001,0.01,0.964,0.9950731981981982,3557,3547
7,7204,10,100,0.0001,0.01,0.92,0.9809827873403665,3611,3593
7,7304,10,100,0.0001,0.01,0.962,0.9928806133625411,3662,3642
7,7404,10,100,0.0001,0.01,0.968,0.9963533225283631,3717,3687
7,7504,10,100,0.0001,0.01,0.972,0.9986673773987207,3762,3742
7,7604,10,100,0.0001,0.01,0.958,0.9894792214623882,3805,3799
7,7704,10,100,0.0001,0.01,0.972,0.9970145379023884,3855,3849
7,7804,10,100,0.0001,0.01,0.962,0.9894925679138903,3900,3904
7,7904,10,100,0.0001,0.01,0.952,0.9771002024291497,3957,3947
7,8004,10,100,0.0001,0.01,0.964,0.9907546226886557,4012,3992
7,8104,10,100,0.0001,0.01,0.936,0.9732230997038499,4065,4039
7,8204,10,100,0.0001,0.01,0.946,0.984519746465139,4114,4090
7,8304,10,100,0.0001,0.01,0.968,0.9938583815028902,4165,4139
7,8404,10,100,0.0001,0.01,0.978,0.9990480723465016,4212,4192
7,8504,10,100,0.0001,0.01,0.98,0.9995296331138288,4265,4239
7,8604,10,100,0.0001,0.01,0.982,0.9994188749418875,4320,4284
7,8704,10,100,0.0001,0.01,0.974,0.9989659926470589,4367,4337
7,8804,10,100,0.0001,0.01,0.974,0.9973875511131304,4421,4383
7,8904,10,100,0.0001,0.01,0.978,0.9987646001796945,4467,4437
7,9004,10,100,0.0001,0.01,0.982,0.9995557529986673,4515,4489
7,9104,10,100,0.0001,0.01,0.972,0.9927504393673111,4559,4545
7,9204,10,100,0.0001,0.01,0.958,0.9893524554541504,4607,4597
7,9304,10,100,0.0001,0.01,0.964,0.9882846087704213,4662,4642
7,9404,10,100,0.0001,0.01,0.952,0.9760740110591237,4722,4682
7,9504,10,100,0.0001,0.01,0.966,0.9835858585858586,4770,4734
7,9604,10,100,0.0001,0.01,0.966,0.9940649729279467,4815,4789
7,9704,10,100,0.0001,0.01,0.97,0.9979389942291839,4859,4845
7,9804,10,100,0.0001,0.01,0.98,0.9993880048959608,4913,4891
7,9904,10,100,0.0001,0.01,0.984,0.999394184168013,4971,4933
7,10004,10,100,0.0001,0.01,0.982,0.9986005597760895,5025,4979
7,10104,10,100,0.0001,0.01,0.98,1.0,5080,5024
7,10204,10,100,0.0001,0.01,0.984,0.9994119952959624,5130,5074
7,10304,10,100,0.0001,0.01,0.972,0.9956327639751553,5167,5137
7,10404,10,100,0.0001,0.01,0.982,0.999519415609381,5215,5189
7,10504,10,100,0.0001,0.01,0.982,0.9996191926884996,5273,5231
7,10604,10,100,0.0001,0.01,0.99,0.9994341757827235,5330,5274
7,10704,10,100,0.0001,0.01,0.982,0.9988789237668162,5382,5322
7,10804,10,100,0.0001,0.01,0.982,0.9978711588300629,5432,5372
7,10904,10,100,0.0001,0.01,0.988,0.9984409391049156,5484,5420
7,11004,10,100,0.0001,0.01,0.978,0.9968193384223919,5537,5467
7,11104,10,100,0.0001,0.01,0.966,0.9848703170028819,5586,5518
7,11204,10,100,0.0001,0.01,0.974,0.9897358086397715,5636,5568
7,11304,10,100,0.0001,0.01,0.976,0.9955767869780608,5685,5619
7,11404,10,100,0.0001,0.01,0.982,0.9968432129077517,5735,5669
7,11504,10,100,0.0001,0.01,0.968,0.9966098748261474,5793,5711
7,11604,10,100,0.0001,0.01,0.982,0.9982764563943468,5842,5762
7,11704,10,100,0.0001,0.01,0.982,0.9994873547505126,5891,5813
7,11804,10,100,0.0001,0.01,0.982,0.9992375465943748,5944,5860
7,11904,10,100,0.0001,0.01,0.98,0.9981518817204301,5991,5913
7,12004,10,100,0.0001,0.01,0.986,0.9985838053982006,6045,5959
7,12104,10,100,0.0001,0.01,0.976,0.9922339722405816,6086,6018
7,12204,10,100,0.0001,0.01,0.978,0.9965585054080629,6137,6067
7,12304,10,100,0.0001,0.01,0.98,0.9986996098829649,6180,6124
7,12404,10,100,0.0001,0.01,0.98,0.9979845211222187,6230,6174
7,12504,10,100,0.0001,0.01,0.978,0.9958413307741523,6283,6221
7,12604,10,100,0.0001,0.01,0.972,0.9969057442081879,6336,6268
7,12704,10,100,0.0001,0.01,0.984,0.999448992443325,6387,6317
7,12804,10,100,0.0001,0.01,0.984,0.999843798812871,6427,6377
7,12904,10,100,0.0001,0.01,0.986,0.9996900185988841,6475,6429
7,13004,10,100,0.0001,0.01,0.98,0.9988465087665334,6531,6473
7,13104,10,100,0.0001,0.01,0.986,1.0,6581,6523
7,13204,10,100,0.0001,0.01,0.984,0.9989397152378068,6641,6563
7,13304,10,100,0.0001,0.01,0.978,0.9982711966325917,6686,6618
7,13404,10,100,0.0001,0.01,0.972,0.9908236347358997,6740,6664
7,13504,10,100,0.0001,0.01,0.97,0.9911877962085308,6783,6721
7,13604,10,100,0.0001,0.01,0.974,0.9963981182005293,6832,6772
7,13704,10,100,0.0001,0.01,0.99,0.9935055458260362,6881,6823
7,13804,10,100,0.0001,0.01,0.984,0.9989858012170385,6930,6874
7,13904,10,100,0.0001,0.01,0.988,0.9989211737629459,6983,6921
7,14004,10,100,0.0001,0.01,0.982,0.9987146529562982,7034,6970
7,14104,10,100,0.0001,0.01,0.978,0.9980856494611458,7078,7026
7,14204,10,100,0.0001,0.01,0.984,0.99852154322726,7132,7072
7,14304,10,100,0.0001,0.01,0.978,0.9928691275167785,7180,7124
7,14404,10,100,0.0001,0.01,0.974,0.9956262149402944,7225,7179
7,14504,10,100,0.0001,0.01,0.98,0.9914506343077771,7275,7229
7,14604,10,100,0.0001,0.01,0.97,0.9928101889893179,7326,7278
7,14704,10,100,0.0001,0.01,0.986,0.9987758433079434,7375,7329
7,14804,10,100,0.0001,0.01,0.986,0.9991894082680357,7425,7379
7,14904,10,100,0.0001,0.01,0.986,0.9991277509393451,7466,7438
7,15004,10,100,0.0001,0.01,0.984,0.9997334044254865,7520,7484
8,104,10,100,0.0001,0.01,0.51,0.7692307692307693,52,52
8,204,10,100,0.0001,0.01,0.53,0.5343137254901961,103,101
8,304,10,100,0.0001,0.01,0.536,0.618421052631579,161,143
8,404,10,100,0.0001,0.01,0.47,0.5173267326732673,211,193
8,504,10,100,0.0001,0.01,0.478,0.6051587301587301,260,244
8,604,10,100,0.0001,0.01,0.512,0.5480132450331126,304,300
8,704,10,100,0.0001,0.01,0.514,0.6534090909090909,359,345
8,804,10,100,0.0001,0.01,0.494,0.6256218905472637,406,398
8,904,10,100,0.0001,0.01,0.548,0.668141592920354,455,449
8,1004,10,100,0.0001,0.01,0.548,0.6842629482071713,504,500
8,1104,10,100,0.0001,0.01,0.524,0.6893115942028986,561,543
8,1204,10,100,0.0001,0.01,0.536,0.7242524916943521,619,585
8,1304,10,100,0.0001,0.01,0.546,0.7208588957055214,669,635
8,1404,10,100,0.0001,0.01,0.542,0.7649572649572649,722,682
8,1504,10,100,0.0001,0.01,0.55,0.711436170212766,761,743
8,1604,10,100,0.0001,0.01,0.546,0.7693266832917706,818,786
8,1704,10,100,0.0001,0.01,0.564,0.7975352112676056,871,833
8,1804,10,100,0.0001,0.01,0.566,0.8226164079822617,925,879
8,1904,10,100,0.0001,0.01,0.566,0.8135504201680672,976,928
8,2004,10,100,0.0001,0.01,0.574,0.814870259481038,1027,977
8,2104,10,100,0.0001,0.01,0.586,0.8079847908745247,1067,1037
8,2204,10,100,0.0001,0.01,0.576,0.8579854809437386,1118,1086
8,2304,10,100,0.0001,0.01,0.578,0.8116319444444444,1179,1125
8,2404,10,100,0.0001,0.01,0.618,0.8394342762063228,1227,1177
8,2504,10,100,0.0001,0.01,0.618,0.8506389776357828,1273,1231
8,2604,10,100,0.0001,0.01,0.624,0.869431643625192,1318,1286
8,2704,10,100,0.0001,0.01,0.672,0.8868343195266272,1365,1339
8,2804,10,100,0.0001,0.01,0.694,0.9186875891583453,1408,1396
8,2904,10,100,0.0001,0.01,0.722,0.9321625344352618,1460,1444
8,3004,10,100,0.0001,0.01,0.712,0.9410785619174434,1501,1503
8,3104,10,100,0.0001,0.01,0.748,0.9497422680412371,1541,1563
8,3204,10,100,0.0001,0.01,0.736,0.9260299625468165,1587,1617
8,3304,10,100,0.0001,0.01,0.764,0.9491525423728814,1648,1656
8,3404,10,100,0.0001,0.01,0.756,0.9400705052878966,1699,1705
8,3504,10,100,0.0001,0.01,0.778,0.932648401826484,1744,1760
8,3604,10,100,0.0001,0.01,0.784,0.9450610432852387,1791,1813
8,3704,10,100,0.0001,0.01,0.806,0.9659827213822895,1835,1869
8,3804,10,100,0.0001,0.01,0.832,0.9810725552050473,1884,1920
8,3904,10,100,0.0001,0.01,0.84,0.9820696721311475,1920,1984
8,4004,10,100,0.0001,0.01,0.862,0.9785214785214785,1971,2033
8,4104,10,100,0.0001,0.01,0.866,0.9917153996101364,2026,2078
8,4204,10,100,0.0001,0.01,0.878,0.9954804947668887,2075,2129
8,4304,10,100,0.0001,0.01,0.872,0.9948884758364313,2127,2177
8,4404,10,100,0.0001,0.01,0.866,0.9915985467756585,2181,2223
8,4504,10,100,0.0001,0.01,0.856,0.9835701598579041,2232,2272
8,4604,10,100,0.0001,0.01,0.888,0.9882710686359687,2283,2321
8,4704,10,100,0.0001,0.01,0.876,0.9885204081632653,2335,2369
8,4804,10,100,0.0001,0.01,0.89,0.9877185678601166,2384,2420
8,4904,10,100,0.0001,0.01,0.9,0.9961256117455138,2431,2473
8,5004,10,100,0.0001,0.01,0.914,0.9952038369304557,2484,2520
8,5104,10,100,0.0001,0.01,0.918,0.9974529780564263,2539,2565
8,5204,10,100,0.0001,0.01,0.926,0.9975019215987702,2579,2625
8,5304,10,100,0.0001,0.01,0.926,0.9984917043740573,2615,2689
8,5404,10,100,0.0001,0.01,0.918,0.9953737971872687,2659,2745
8,5504,10,100,0.0001,0.01,0.912,0.9878270348837209,2709,2795
8,5604,10,100,0.0001,0.01,0.922,0.9835831548893648,2756,2848
8,5704,10,100,0.0001,0.01,0.926,0.9957924263674615,2802,2902
8,5804,10,100,0.0001,0.01,0.928,0.9956926257753274,2854,2950
8,5904,10,100,0.0001,0.01,0.912,0.9820460704607046,2905,2999
8,6004,10,100,0.0001,0.01,0.928,0.9920053297801465,2955,3049
8,6104,10,100,0.0001,0.01,0.938,0.9962319790301442,3008,3096
8,6204,10,100,0.0001,0.01,0.942,0.99822695035461,3055,3149
8,6304,10,100,0.0001,0.01,0.942,0.9979378172588832,3100,3204
8,6404,10,100,0.0001,0.01,0.956,0.9996876951905059,3149,3255
8,6504,10,100,0.0001,0.01,0.958,0.9998462484624846,3210,3294
8,6604,10,100,0.0001,0.01,0.958,0.9989400363416111,3270,3334
8,6704,10,100,0.0001,0.01,0.96,0.9997016706443914,3328,3376
8,6804,10,100,0.0001,0.01,0.956,0.9991181657848325,3372,3432
8,6904,10,100,0.0001,0.01,0.956,0.9985515643105446,3423,3481
8,7004,10,100,0.0001,0.01,0.96,0.9981439177612793,3475,3529
8,7104,10,100,0.0001,0.01,0.948,0.9980292792792793,3530,3574
8,7204,10,100,0.0001,0.01,0.964,0.9980566352026652,3580,3624
8,7304,10,100,0.0001,0.01,0.942,0.9857612267250822,3625,3679
8,7404,10,100,0.0001,0.01,0.934,0.9855483522420313,3667,3737
8,7504,10,100,0.0001,0.01,0.946,0.9886727078891258,3719,3785
8,7604,10,100,0.0001,0.01,0.95,0.9935560231457128,3777,3827
8,7704,10,100,0.0001,0.01,0.968,0.9990913811007269,3833,3871
8,7804,10,100,0.0001,0.01,0.958,0.9983341875961046,3882,3922
8,7904,10,100,0.0001,0.01,0.966,0.9979757085020243,3922,3982
8,8004,10,100,0.0001,0.01,0.96,0.9995002498750625,3980,4024
8,8104,10,100,0.0001,0.01,0.964,0.9993830207305034,4028,4076
8,8204,10,100,0.0001,0.01,0.968,0.999634324719649,4085,4119
8,8304,10,100,0.0001,0.01,0.974,0.9993978805394991,4140,4164
8,8404,10,100,0.0001,0.01,0.964,0.9986910994764397,4182,4222
8,8504,10,100,0.0001,0.01,0.964,0.998824082784572,4232,4272
8,8604,10,100,0.0001,0.01,0.962,0.9925615992561599,4287,4317
8,8704,10,100,0.0001,0.01,0.954,0.9926470588235294,4336,4368
8,8804,10,100,0.0001,0.01,0.968,0.9962517037710131,4391,4413
8,8904,10,100,0.0001,0.01,0.97,0.9988769092542678,4450,4454
8,9004,10,100,0.0001,0.01,0.97,0.9998889382496668,4494,4510
8,9104,10,100,0.0001,0.01,0.964,0.9993409490333919,4546,4558
8,9204,10,100,0.0001,0.01,0.976,1.0,4595,4609
8,9304,10,100,0.0001,0.01,0.978,0.9995700773860705,4641,4663
8,9404,10,100,0.0001,0.01,0.976,1.0,4692,4712
8,9504,10,100,0.0001,0.01,0.972,0.9928451178451179,4749,4755
8,9604,10,100,0.0001,0.01,0.968,0.9926072469804248,4795,4809
8,9704,10,100,0.0001,0.01,0.972,0.9950535861500412,4840,4864
8,9804,10,100,0.0001,0.01,0.972,0.9940840473276213,4891,4913
8,9904,10,100,0.0001,0.01,0.98,0.9984854604200323,4942,4962
8,10004,10,100,0.0001,0.01,0.98,0.9988004798080767,4991,5013
8,10104,10,100,0.0001,0.01,0.988,0.9993072050673001,5044,5060
8,10204,10,100,0.0001,0.01,0.988,0.9997059976479812,5086,5118
8,10304,10,100,0.0001,0.01,0.988,0.9993206521739131,5139,5165
8,10404,10,100,0.0001,0.01,0.992,0.999519415609381,5188,5216
8,10504,10,100,0.0001,0.01,0.986,0.9997143945163747,5235,5269
8,10604,10,100,0.0001,0.01,0.984,0.9997170878913617,5284,5320
8,10704,10,100,0.0001,0.01,0.994,0.999813153961136,5325,5379
8,10804,10,100,0.0001,0.01,0.978,0.9959274342835986,5372,5432
8,10904,10,100,0.0001,0.01,0.986,0.997982391782832,5428,5476
8,11004,10,100,0.0001,0.01,0.986,0.9982733551435842,5468,5536
8,11104,10,100,0.0001,0.01,0.988,0.9972082132564841,5518,5586
8,11204,10,100,0.0001,0.01,0.98,0.9953588004284184,5579,5625
8,11304,10,100,0.0001,0.01,0.99,0.9986730360934183,5633,5671
8,11404,10,100,0.0001,0.01,0.986,0.9986846720448965,5682,5722
8,11504,10,100,0.0001,0.01,0.99,0.9994784422809457,5740,5764
8,11604,10,100,0.0001,0.01,0.99,0.9977593933126508,5785,5819
8,11704,10,100,0.0001,0.01,0.988,0.9976076555023924,5843,5861
8,11804,10,100,0.0001,0.01,0.992,0.9973737716028465,5898,5906
8,11904,10,100,0.0001,0.01,0.982,0.9965557795698925,5950,5954
8,12004,10,100,0.0001,0.01,0.994,0.9985004998333888,6003,6001
8,12104,10,100,0.0001,0.01,0.982,0.9896728354263054,6052,6052
8,12204,10,100,0.0001,0.01,0.992,0.9995902982628646,6100,6104
8,12304,10,100,0.0001,0.01,0.99,0.9985370611183355,6152,6152
8,12404,10,100,0.0001,0.01,0.984,0.9985488552079974,6212,6192
8,12504,10,100,0.0001,0.01,0.99,0.9989603326935381,6251,6253
8,12604,10,100,0.0001,0.01,0.992,0.9984132021580451,6309,6295
8,12704,10,100,0.0001,0.01,0.988,0.9969301007556675,6363,6341
8,12804,10,100,0.0001,0.01,0.984,0.9962511715089035,6414,6390
8,12904,10,100,0.0001,0.01,0.994,0.9993800371977681,6455,6449
8,13004,10,100,0.0001,0.01,0.986,0.9963857274684712,6509,6495
8,13104,10,100,0.0001,0.01,0.982,0.9961080586080586,6551,6553
8,13204,10,100,0.0001,0.01,0.99,0.9996213268706453,6605,6599
8,13304,10,100,0.0001,0.01,0.988,0.9966175586289837,6653,6651
8,13404,10,100,0.0001,0.01,0.994,0.993509400179051,6702,6702
8,13504,10,100,0.0001,0.01,0.994,0.9974822274881516,6742,6762
8,13604,10,100,0.0001,0.01,0.996,0.9986033519553073,6787,6817
8,13704,10,100,0.0001,0.01,0.996,0.9998540572095739,6838,6866
8,13804,10,100,0.0001,0.01,0.996,0.9999275572297884,6886,6918
8,13904,10,100,0.0001,0.01,0.996,1.0,6935,6969
8,14004,10,100,0.0001,0.01,0.996,1.0,6983,7021
8,14104,10,100,0.0001,0.01,0.996,1.0,7030,7074
8,14204,10,100,0.0001,0.01,0.996,1.0,7071,7133
8,14304,10,100,0.0001,0.01,0.99,0.9990212527964206,7126,7178
8,14404,10,100,0.0001,0.01,0.992,0.9978478200499861,7177,7227
8,14504,10,100,0.0001,0.01,0.996,0.9988279095421952,7231,7273
8,14604,10,100,0.0001,0.01,0.996,0.9976033963297727,7278,7326
8,14704,10,100,0.0001,0.01,0.992,0.9940152339499456,7330,7374
8,14804,10,100,0.0001,0.01,0.994,0.997568224804107,7381,7423
8,14904,10,100,0.0001,0.01,0.99,0.9959742351046699,7427,7477
8,15004,10,100,0.0001,0.01,0.996,0.9986003732338044,7484,7520
9,104,10,100,0.0001,0.01,0.51,0.5,52,52
9,204,10,100,0.0001,0.01,0.488,0.6862745098039216,93,111
9,304,10,100,0.0001,0.01,0.472,0.6644736842105263,135,169
9,404,10,100,0.0001,0.01,0.484,0.6485148514851485,180,224
9,504,10,100,0.0001,0.01,0.462,0.626984126984127,236,268
9,604,10,100,0.0001,0.01,0.474,0.6423841059602649,283,321
9,704,10,100,0.0001,0.01,0.5,0.6477272727272727,331,373
9,804,10,100,0.0001,0.01,0.514,0.6803482587064676,390,414
9,904,10,100,0.0001,0.01,0.512,0.6692477876106194,440,464
9,1004,10,100,0.0001,0.01,0.496,0.6912350597609562,489,515
9,1104,10,100,0.0001,0.01,0.512,0.6856884057971014,541,563
9,1204,10,100,0.0001,0.01,0.47,0.696843853820598,597,607
9,1304,10,100,0.0001,0.01,0.494,0.6993865030674846,642,662
9,1404,10,100,0.0001,0.01,0.492,0.7008547008547008,689,715
9,1504,10,100,0.0001,0.01,0.494,0.7081117021276596,729,775
9,1604,10,100,0.0001,0.01,0.494,0.7549875311720698,783,821
9,1704,10,100,0.0001,0.01,0.482,0.7464788732394366,829,875
9,1804,10,100,0.0001,0.01,0.482,0.7732815964523282,873,931
9,1904,10,100,0.0001,0.01,0.514,0.7305672268907563,921,983
9,2004,10,100,0.0001,0.01,0.528,0.7864271457085829,974,1030
9,2104,10,100,0.0001,0.01,0.502,0.7490494296577946,1040,1064
9,2204,10,100,0.0001,0.01,0.566,0.7962794918330308,1093,1111
9,2304,10,100,0.0001,0.01,0.536,0.7955729166666666,1136,1168
9,2404,10,100,0.0001,0.01,0.556,0.7970049916805324,1195,1209
9,2504,10,100,0.0001,0.01,0.554,0.729632587859425,1241,1263
9,2604,10,100,0.0001,0.01,0.624,0.8145161290322581,1290,1314
9,2704,10,100,0.0001,0.01,0.596,0.8036242603550295,1339,1365
9,2804,10,100,0.0001,0.01,0.622,0.8395149786019972,1378,1426
9,2904,10,100,0.0001,0.01,0.684,0.8670798898071626,1433,1471
9,3004,10,100,0.0001,0.01,0.676,0.8721704394141145,1481,1523
9,3104,10,100,0.0001,0.01,0.718,0.8849871134020618,1528,1576
9,3204,10,100,0.0001,0.01,0.704,0.900749063670412,1584,1620
9,3304,10,100,0.0001,0.01,0.76,0.926452784503632,1628,1676
9,3404,10,100,0.0001,0.01,0.756,0.9115746180963572,1679,1725
9,3504,10,100,0.0001,0.01,0.738,0.8955479452054794,1730,1774
9,3604,10,100,0.0001,0.01,0.77,0.9078801331853497,1786,1818
9,3704,10,100,0.0001,0.01,0.79,0.9195464362850972,1844,1860
9,3804,10,100,0.0001,0.01,0.828,0.9568874868559412,1898,1906
9,3904,10,100,0.0001,0.01,0.838,0.9633709016393442,1957,1947
9,4004,10,100,0.0001,0.01,0.848,0.9762737262737263,2017,1987
9,4104,10,100,0.0001,0.01,0.836,0.9680799220272904,2063,2041
9,4204,10,100,0.0001,0.01,0.874,0.9802568981921979,2113,2091
9,4304,10,100,0.0001,0.01,0.878,0.9786245353159851,2168,2136
9,4404,10,100,0.0001,0.01,0.88,0.995685740236149,2220,2184
9,4504,10,100,0.0001,0.01,0.9,0.9913410301953819,2269,2235
9,4604,10,100,0.0001,0.01,0.886,0.987619461337967,2324,2280
9,4704,10,100,0.0001,0.01,0.904,0.9876700680272109,2381,2323
9,4804,10,100,0.0001,0.01,0.91,0.992714404662781,2428,2376
9,4904,10,100,0.0001,0.01,0.914,0.9955138662316476,2477,2427
9,5004,10,100,0.0001,0.01,0.898,0.995603517186251,2536,2468
9,5104,10,100,0.0001,0.01,0.91,0.9911833855799373,2581,2523
9,5204,10,100,0.0001,0.01,0.884,0.9652190622598001,2629,2575
9,5304,10,100,0.0001,0.01,0.894,0.9730392156862745,2692,2612
9,5404,10,100,0.0001,0.01,0.914,0.978719467061436,2744,2660
9,5504,10,100,0.0001,0.01,0.894,0.9749273255813954,2789,2715
9,5604,10,100,0.0001,0.01,0.908,0.9789436117059244,2843,2761
9,5704,10,100,0.0001,0.01,0.924,0.988429172510519,2882,2822
9,5804,10,100,0.0001,0.01,0.916,0.9894900068917988,2934,2870
9,5904,10,100,0.0001,0.01,0.922,0.9913617886178862,2986,2918
9,6004,10,100,0.0001,0.01,0.938,0.9978347768154564,3039,2965
9,6104,10,100,0.0001,0.01,0.93,0.9921363040629095,3087,3017
9,6204,10,100,0.0001,0.01,0.946,0.9959703417150225,3138,3066
9,6304,10,100,0.0001,0.01,0.932,0.983502538071066,3183,3121
9,6404,10,100,0.0001,0.01,0.946,0.9909431605246721,3235,3169
9,6504,10,100,0.0001,0.01,0.942,0.9936961869618696,3282,3222
9,6604,10,100,0.0001,0.01,0.948,0.9886432465172623,3344,3260
9,6704,10,100,0.0001,0.01,0.94,0.9928400954653938,3389,3315
9,6804,10,100,0.0001,0.01,0.944,0.9914756025867137,3437,3367
9,6904,10,100,0.0001,0.01,0.944,0.9956546929316339,3487,3417
9,7004,10,100,0.0001,0.01,0.958,0.9915762421473444,3530,3474
9,7104,10,100,0.0001,0.01,0.948,0.9926801801801802,3582,3522
9,7204,10,100,0.0001,0.01,0.962,0.9984730705163798,3621,3583
9,7304,10,100,0.0001,0.01,0.954,0.9971248630887185,3666,3638
9,7404,10,100,0.0001,0.01,0.954,0.998109130199892,3715,3689
9,7504,10,100,0.0001,0.01,0.944,0.9949360341151386,3771,3733
9,7604,10,100,0.0001,0.01,0.962,0.9961862177801157,3823,3781
9,7704,10,100,0.0001,0.01,0.958,0.9983125649013499,3866,3838
9,7804,10,100,0.0001,0.01,0.91,0.9560481804202973,3918,3886
9,7904,10,100,0.0001,0.01,0.916,0.9423076923076923,3981,3923
9,8004,10,100,0.0001,0.01,0.954,0.9785107446276862,4030,3974
9,8104,10,100,0.0001,0.01,0.954,0.9937068114511353,4082,4022
9,8204,10,100,0.0001,0.01,0.964,0.9962213554363725,4127,4077
9,8304,10,100,0.0001,0.01,0.968,0.9972302504816956,4179,4125
9,8404,10,100,0.0001,0.01,0.964,0.9975011899095668,4237,4167
9,8504,10,100,0.0001,0.01,0.964,0.9962370649106302,4296,4208
9,8604,10,100,0.0001,0.01,0.966,0.99814039981404,4342,4262
9,8704,10,100,0.0001,0.01,0.96,0.9963235294117647,4393,4311
9,8804,10,100,0.0001,0.01,0.962,0.9968196274420718,4447,4357
9,8904,10,100,0.0001,0.01,0.968,0.9938230008984726,4495,4409
9,9004,10,100,0.0001,0.01,0.942,0.9806752554420257,4554,4450
9,9104,10,100,0.0001,0.01,0.956,0.9884666080843585,4599,4505
9,9204,10,100,0.0001,0.01,0.966,0.9943502824858758,4648,4556
9,9304,10,100,0.0001,0.01,0.97,0.9963456577815993,4700,4604
9,9404,10,100,0.0001,0.01,0.958,0.9895789025946405,4746,4658
9,9504,10,100,0.0001,0.01,0.942,0.9748526936026936,4794,4710
9,9604,10,100,0.0001,0.01,0.96,0.9886505622657226,4842,4762
9,9704,10,100,0.0001,0.01,0.964,0.9972176422093982,4887,4817
9,9804,10,100,0.0001,0.01,0.96,0.9967360261117911,4928,4876
9,9904,10,100,0.0001,0.01,0.972,0.998889337641357,4980,4924
9,10004,10,100,0.0001,0.01,0.974,0.9988004798080767,5027,4977
9,10104,10,100,0.0001,0.01,0.968,0.9982185273159145,5077,5027
9,10204,10,100,0.0001,0.01,0.968,0.9972559780478244,5130,5074
9,10304,10,100,0.0001,0.01,0.974,0.9966032608695652,5175,5129
9,10404,10,100,0.0001,0.01,0.974,0.9973087274125336,5215,5189
9,10504,10,100,0.0001,0.01,0.952,0.9812452399086062,5268,5236
9,10604,10,100,0.0001,0.01,0.954,0.9940588457185967,5311,5293
9,10704,10,100,0.0001,0.01,0.97,0.9978512705530643,5355,5349
9,10804,10,100,0.0001,0.01,0.976,0.999537208441318,5407,5397
9,10904,10,100,0.0001,0.01,0.98,0.9998165810711666,5451,5453
9,11004,10,100,0.0001,0.01,0.976,0.9996364958197019,5504,5500
9,11104,10,100,0.0001,0.01,0.976,0.999549711815562,5556,5548
9,11204,10,100,0.0001,0.01,0.98,0.99982149232417,5602,5602
9,11304,10,100,0.0001,0.01,0.978,0.9995576786978061,5653,5651
9,11404,10,100,0.0001,0.01,0.978,0.9999123114696598,5709,5695
9,11504,10,100,0.0001,0.01,0.976,0.997739916550765,5751,5753
9,11604,10,100,0.0001,0.01,0.978,0.999224405377456,5799,5805
9,11704,10,100,0.0001,0.01,0.956,0.9839371155160629,5847,5857
9,11804,10,100,0.0001,0.01,0.962,0.9816164012199254,5891,5913
9,11904,10,100,0.0001,0.01,0.976,0.9901713709677419,5928,5976
9,12004,10,100,0.0001,0.01,0.968,0.9961679440186605,5975,6029
9,12104,10,100,0.0001,0.01,0.976,0.9990912095175148,6025,6079
9,12204,10,100,0.0001,0.01,0.972,0.9994264175680105,6079,6125
9,12304,10,100,0.0001,0.01,0.978,0.9995123537061118,6126,6178
9,12404,10,100,0.0001,0.01,0.974,0.9999193808448887,6183,6221
9,12504,10,100,0.0001,0.01,0.974,0.9999200255918106,6232,6272
9,12604,10,100,0.0001,0.01,0.974,0.9999206601079023,6287,6317
9,12704,10,100,0.0001,0.01,0.976,0.999448992443325,6339,6365
9,12804,10,100,0.0001,0.01,0.974,0.9989065916900969,6397,6407
9,12904,10,100,0.0001,0.01,0.974,0.9970551766893986,6445,6459
9,13004,10,100,0.0001,0.01,0.974,0.9988465087665334,6495,6509
9,13104,10,100,0.0001,0.01,0.976,0.992979242979243,6547,6557
9,13204,10,100,0.0001,0.01,0.952,0.9814450166616177,6601,6603
9,13304,10,100,0.0001,0.01,0.97,0.9942122669873722,6651,6653
9,13404,10,100,0.0001,0.01,0.974,0.997612652939421,6704,6700
9,13504,10,100,0.0001,0.01,0.978,0.995260663507109,6759,6745
9,13604,10,100,0.0001,0.01,0.974,0.9959570714495737,6808,6796
9,13704,10,100,0.0001,0.01,0.976,0.9989054290718039,6855,6849
9,13804,10,100,0.0001,0.01,0.968,0.9936250362213851,6904,6900
9,13904,10,100,0.0001,0.01,0.98,0.9974827387802071,6954,6950
9,14004,10,100,0.0001,0.01,0.966,0.9934304484433019,7002,7002
9,14104,10,100,0.0001,0.01,0.982,0.9980856494611458,7052,7052
9,14204,10,100,0.0001,0.01,0.978,0.996268656716418,7105,7099
9,14304,10,100,0.0001,0.01,0.98,0.997832774049217,7150,7154
9,14404,10,100,0.0001,0.01,0.974,0.9970147181338517,7209,7195
9,14504,10,100,0.0001,0.01,0.972,0.9986210700496415,7258,7246
9,14604,10,100,0.0001,0.01,0.98,0.9983566146261298,7312,7292
9,14704,10,100,0.0001,0.01,0.978,0.9985038084874864,7369,7335
9,14804,10,100,0.0001,0.01,0.978,0.997568224804107,7411,7393
9,14904,10,100,0.0001,0.01,0.982,0.9975845410628019,7462,7442
9,15004,10,100,0.0001,0.01,0.98,0.9974006931484938,7507,7497
10,104,10,100,0.0001,0.01,0.526,0.6923076923076923,53,51
10,204,10,100,0.0001,0.01,0.518,0.6519607843137255,97,107
10,304,10,100,0.0001,0.01,0.49,0.6381578947368421,145,159
10,404,10,100,0.0001,0.01,0.486,0.6584158415841584,199,205
10,504,10,100,0.0001,0.01,0.506,0.6111111111111112,248,256
10,604,10,100,0.0001,0.01,0.534,0.6009933774834437,301,303
10,704,10,100,0.0001,0.01,0.498,0.6519886363636364,356,348
10,804,10,100,0.0001,0.01,0.47,0.695273631840796,402,402
10,904,10,100,0.0001,0.01,0.486,0.6747787610619469,451,453
10,1004,10,100,0.0001,0.01,0.492,0.6832669322709163,502,502
10,1104,10,100,0.0001,0.01,0.486,0.6911231884057971,558,546
10,1204,10,100,0.0001,0.01,0.512,0.707641196013289,615,589
10,1304,10,100,0.0001,0.01,0.516,0.7254601226993865,655,649
10,1404,10,100,0.0001,0.01,0.484,0.7186609686609686,702,702
10,1504,10,100,0.0001,0.01,0.5,0.7227393617021277,760,744
10,1604,10,100,0.0001,0.01,0.484,0.6708229426433915,820,784
10,1704,10,100,0.0001,0.01,0.528,0.6731220657276995,880,824
10,1804,10,100,0.0001,0.01,0.482,0.7034368070953437,937,867
10,1904,10,100,0.0001,0.01,0.49,0.7226890756302521,978,926
10,2004,10,100,0.0001,0.01,0.51,0.7435129740518962,1030,974
10,2104,10,100,0.0001,0.01,0.504,0.719106463878327,1080,1024
10,2204,10,100,0.0001,0.01,0.498,0.7558983666061706,1126,1078
10,2304,10,100,0.0001,0.01,0.514,0.7552083333333334,1177,1127
10,2404,10,100,0.0001,0.01,0.492,0.7816139767054908,1225,1179
10,2504,10,100,0.0001,0.01,0.468,0.7587859424920128,1275,1229
10,2604,10,100,0.0001,0.01,0.504,0.7634408602150538,1327,1277
10,2704,10,100,0.0001,0.01,0.534,0.8062130177514792,1376,1328
10,2804,10,100,0.0001,0.01,0.528,0.8042082738944365,1434,1370
10,2904,10,100,0.0001,0.01,0.546,0.8054407713498623,1482,1422
10,3004,10,100,0.0001,0.01,0.514,0.8139147802929427,1528,1476
10,3104,10,100,0.0001,0.01,0.558,0.8150773195876289,1576,1528
10,3204,10,100,0.0001,0.01,0.534,0.8414481897627965,1623,1581
10,3304,10,100,0.0001,0.01,0.5,0.8232445520581114,1678,1626
10,3404,10,100,0.0001,0.01,0.546,0.7984723854289072,1731,1673
10,3504,10,100,0.0001,0.01,0.526,0.7962328767123288,1789,1715
10,3604,10,100,0.0001,0.01,0.522,0.8018867924528302,1845,1759
10,3704,10,100,0.0001,0.01,0.55,0.8269438444924406,1898,1806
10,3804,10,100,0.0001,0.01,0.524,0.7960042060988434,1943,1861
10,3904,10,100,0.0001,0.01,0.532,0.8017418032786885,1990,1914
10,4004,10,100,0.0001,0.01,0.534,0.8361638361638362,2043,1961
10,4104,10,100,0.0001,0.01,0.546,0.8235867446393762,2092,2012
10,4204,10,100,0.0001,0.01,0.524,0.8608468125594672,2148,2056
10,4304,10,100,0.0001,0.01,0.56,0.8557156133828996,2204,2100
10,4404,10,100,0.0001,0.01,0.552,0.873069936421435,2255,2149
10,4504,10,100,0.0001,0.01,0.562,0.8603463587921847,2306,2198
10,4604,10,100,0.0001,0.01,0.566,0.8740225890529973,2358,2246
10,4704,10,100,0.0001,0.01,0.56,0.8696853741496599,2415,2289
10,4804,10,100,0.0001,0.01,0.588,0.8965445462114904,2462,2342
10,4904,10,100,0.0001,0.01,0.578,0.9011011419249593,2509,2395
10,5004,10,100,0.0001,0.01,0.558,0.8852917665867306,2561,2443
10,5104,10,100,0.0001,0.01,0.588,0.9096786833855799,2615,2489
10,5204,10,100,0.0001,0.01,0.566,0.9012298232129131,2676,2528
10,5304,10,100,0.0001,0.01,0.582,0.8776395173453997,2724,2580
10,5404,10,100,0.0001,0.01,0.608,0.9052553663952627,2767,2637
10,5504,10,100,0.0001,0.01,0.618,0.9024345930232558,2822,2682
10,5604,10,100,0.0001,0.01,0.626,0.9039971448965025,2870,2734
10,5704,10,100,0.0001,0.01,0.636,0.9232117812061711,2922,2782
10,5804,10,100,0.0001,0.01,0.63,0.9288421778084079,2977,2827
10,5904,10,100,0.0001,0.01,0.656,0.9473238482384824,3020,2884
10,6004,10,100,0.0001,0.01,0.676,0.9400399733510992,3071,2933
10,6104,10,100,0.0001,0.01,0.638,0.9452817824377457,3115,2989
10,6204,10,100,0.0001,0.01,0.638,0.9263378465506125,3164,3040
10,6304,10,100,0.0001,0.01,0.66,0.8789657360406091,3210,3094
10,6404,10,100,0.0001,0.01,0.662,0.9084946908182386,3268,3136
10,6504,10,100,0.0001,0.01,0.666,0.9218942189421894,3315,3189
10,6604,10,100,0.0001,0.01,0.696,0.9406420351302242,3364,3240
10,6704,10,100,0.0001,0.01,0.688,0.9422732696897375,3421,3283
10,6804,10,100,0.0001,0.01,0.704,0.9463550852439742,3459,3345
10,6904,10,100,0.0001,0.01,0.702,0.9464078794901506,3514,3390
10,7004,10,100,0.0001,0.01,0.688,0.9408909194745859,3560,3444
10,7104,10,100,0.0001,0.01,0.696,0.9367961711711712,3608,3496
10,7204,10,100,0.0001,0.01,0.712,0.9543309272626319,3656,3548
10,7304,10,100,0.0001,0.01,0.71,0.9597480832420592,3713,3591
10,7404,10,100,0.0001,0.01,0.722,0.9683954619124797,3766,3638
10,7504,10,100,0.0001,0.01,0.738,0.9577558635394456,3814,3690
10,7604,10,100,0.0001,0.01,0.75,0.9559442398737507,3862,3742
10,7704,10,100,0.0001,0.01,0.726,0.9537902388369678,3910,3794
10,7804,10,100,0.0001,0.01,0.748,0.9538698103536648,3957,3847
10,7904,10,100,0.0001,0.01,0.78,0.9744433198380567,4006,3898
10,8004,10,100,0.0001,0.01,0.766,0.9622688655672164,4057,3947
10,8104,10,100,0.0001,0.01,0.756,0.9512586377097729,4097,4007
10,8204,10,100,0.0001,0.01,0.774,0.9559970745977572,4146,4058
10,8304,10,100,0.0001,0.01,0.778,0.9619460500963392,4199,4105
10,8404,10,100,0.0001,0.01,0.774,0.9683484055211804,4248,4156
10,8504,10,100,0.0001,0.01,0.792,0.9751881467544685,4291,4213
10,8604,10,100,0.0001,0.01,0.778,0.9674569967456996,4340,4264
10,8704,10,100,0.0001,0.01,0.788,0.9618566176470589,4396,4308
10,8804,10,100,0.0001,0.01,0.802,0.9723989095865516,4444,4360
10,8904,10,100,0.0001,0.01,0.764,0.9520440251572327,4494,4410
10,9004,10,100,0.0001,0.01,0.8,0.9666814749000444,4538,4466
10,9104,10,100,0.0001,0.01,0.798,0.9512302284710018,4582,4522
10,9204,10,100,0.0001,0.01,0.808,0.9619730551933942,4626,4578
10,9304,10,100,0.0001,0.01,0.812,0.9756018916595013,4671,4633
10,9404,10,100,0.0001,0.01,0.818,0.9794768183751595,4715,4689
10,9504,10,100,0.0001,0.01,0.828,0.9709595959595959,4763,4741
10,9604,10,100,0.0001,0.01,0.806,0.9788629737609329,4817,4787
10,9704,10,100,0.0001,0.01,0.844,0.9821723000824403,4871,4833
10,9804,10,100,0.0001,0.01,0.86,0.9873521011831905,4924,4880
10,9904,10,100,0.0001,0.01,0.84,0.9822294022617124,4970,4934
10,10004,10,100,0.0001,0.01,0.858,0.9877049180327869,5024,4980
10,10104,10,100,0.0001,0.01,0.846,0.9863420427553444,5077,5027
10,10204,10,100,0.0001,0.01,0.846,0.985593884751078,5126,5078
10,10304,10,100,0.0001,0.01,0.852,0.9856366459627329,5178,5126
10,10404,10,100,0.0001,0.01,0.86,0.9802960399846213,5222,5182
10,10504,10,100,0.0001,0.01,0.866,0.9867669459253617,5275,5229
10,10604,10,100,0.0001,0.01,0.826,0.979253112033195,5328,5276
10,10704,10,100,0.0001,0.01,0.864,0.9869207772795217,5370,5334
10,10804,10,100,0.0001,0.01,0.868,0.9660310995927435,5423,5381
10,10904,10,100,0.0001,0.01,0.874,0.9696441672780631,5479,5425
10,11004,10,100,0.0001,0.01,0.868,0.980189022173755,5526,5478
10,11104,10,100,0.0001,0.01,0.882,0.985050432276657,5566,5538
10,11204,10,100,0.0001,0.01,0.88,0.9891110317743663,5618,5586
10,11304,10,100,0.0001,0.01,0.884,0.993895966029724,5671,5633
10,11404,10,100,0.0001,0.01,0.896,0.9896527534198527,5720,5684
10,11504,10,100,0.0001,0.01,0.892,0.9943497913769124,5762,5742
10,11604,10,100,0.0001,0.01,0.884,0.9903481558083419,5822,5782
10,11704,10,100,0.0001,0.01,0.888,0.9888926862611073,5861,5843
10,11804,10,100,0.0001,0.01,0.896,0.9794984750931888,5916,5888
10,11904,10,100,0.0001,0.01,0.886,0.985299059139785,5952,5952
10,12004,10,100,0.0001,0.01,0.904,0.9902532489170277,5995,6009
10,12104,10,100,0.0001,0.01,0.9,0.9850462656972901,6045,6059
10,12204,10,100,0.0001,0.01,0.898,0.9872992461488037,6096,6108
10,12304,10,100,0.0001,0.01,0.902,0.9894343302990898,6139,6165
10,12404,10,100,0.0001,0.01,0.916,0.9816994517897453,6188,6216
10,12504,10,100,0.0001,0.01,0.918,0.9927223288547665,6238,6266
10,12604,10,100,0.0001,0.01,0.914,0.9854014598540146,6296,6308
10,12704,10,100,0.0001,0.01,0.924,0.9936240554156172,6343,6361
10,12804,10,100,0.0001,0.01,0.918,0.996329272102468,6397,6407
10,12904,10,100,0.0001,0.01,0.922,0.995272783632982,6454,6450
10,13004,10,100,0.0001,0.01,0.93,0.9930790525992003,6500,6504
10,13104,10,100,0.0001,0.01,0.926,0.9922161172161172,6541,6563
10,13204,10,100,0.0001,0.01,0.93,0.9966676764616783,6588,6616
10,13304,10,100,0.0001,0.01,0.946,0.9963920625375827,6636,6668
10,13404,10,100,0.0001,0.01,0.904,0.9774694121157863,6686,6718
10,13504,10,100,0.0001,0.01,0.938,0.9904472748815166,6736,6768
10,13604,10,100,0.0001,0.01,0.932,0.9843428403410761,6796,6808
10,13704,10,100,0.0001,0.01,0.946,0.9956217162872154,6842,6862
10,13804,10,100,0.0001,0.01,0.95,0.9971747319617502,6887,6917
10,13904,10,100,0.0001,0.01,0.95,0.9977704257767549,6933,6971
10,14004,10,100,0.0001,0.01,0.956,0.9987860611253927,6984,7020
10,14104,10,100,0.0001,0.01,0.96,0.9988655700510494,7042,7062
10,14204,10,100,0.0001,0.01,0.946,0.9869754998591946,7091,7113
10,14304,10,100,0.0001,0.01,0.95,0.9944770693512305,7139,7165
10,14404,10,100,0.0001,0.01,0.958,0.9963204665370731,7188,7216
10,14504,10,100,0.0001,0.01,0.952,0.996207942636514,7235,7269
10,14604,10,100,0.0001,0.01,0.934,0.9893179950698439,7295,7309
10,14704,10,100,0.0001,0.01,0.938,0.982385745375408,7342,7362
10,14804,10,100,0.0001,0.01,0.938,0.9790597135909214,7391,7413
10,14904,10,100,0.0001,0.01,0.96,0.9914787976382179,7444,7460
10,15004,10,100,0.0001,0.01,0.954,0.9949346840842442,7501,7503
11,104,10,100,0.0001,0.01,0.484,0.5673076923076923,45,59
11,204,10,100,0.0001,0.01,0.494,0.5931372549019608,99,105
11,304,10,100,0.0001,0.01,0.514,0.5888157894736842,156,148
11,404,10,100,0.0001,0.01,0.522,0.5470297029702971,209,195
11,504,10,100,0.0001,0.01,0.508,0.5813492063492064,259,245
11,604,10,100,0.0001,0.01,0.462,0.5480132450331126,318,286
11,704,10,100,0.0001,0.01,0.474,0.6221590909090909,367,337
11,804,10,100,0.0001,0.01,0.498,0.6243781094527363,421,383
11,904,10,100,0.0001,0.01,0.474,0.6316371681415929,473,431
11,1004,10,100,0.0001,0.01,0.494,0.6454183266932271,524,480
11,1104,10,100,0.0001,0.01,0.492,0.6403985507246377,575,529
11,1204,10,100,0.0001,0.01,0.462,0.6935215946843853,626,578
11,1304,10,100,0.0001,0.01,0.492,0.656441717791411,679,625
11,1404,10,100,0.0001,0.01,0.506,0.6930199430199431,722,682
11,1504,10,100,0.0001,0.01,0.502,0.6901595744680851,774,730
11,1604,10,100,0.0001,0.01,0.518,0.729426433915212,816,788
11,1704,10,100,0.0001,0.01,0.512,0.710093896713615,863,841
11,1804,10,100,0.0001,0.01,0.51,0.7494456762749445,915,889
11,1904,10,100,0.0001,0.01,0.536,0.7190126050420168,973,931
11,2004,10,100,0.0001,0.01,0.516,0.7704590818363274,1018,986
11,2104,10,100,0.0001,0.01,0.498,0.7699619771863118,1058,1046
11,2204,10,100,0.0001,0.01,0.546,0.7903811252268602,1105,1099
11,2304,10,100,0.0001,0.01,0.568,0.8029513888888888,1161,1143
11,2404,10,100,0.0001,0.01,0.592,0.8377703826955075,1210,1194
11,2504,10,100,0.0001,0.01,0.59,0.8322683706070287,1259,1245
11,2604,10,100,0.0001,0.01,0.59,0.8625192012288786,1299,1305
11,2704,10,100,0.0001,0.01,0.638,0.8698224852071006,1351,1353
11,2804,10,100,0.0001,0.01,0.652,0.887660485021398,1397,1407
11,2904,10,100,0.0001,0.01,0.632,0.8694903581267218,1448,1456
11,3004,10,100,0.0001,0.01,0.666,0.8781624500665779,1499,1505
11,3104,10,100,0.0001,0.01,0.692,0.9155927835051546,1542,1562
11,3204,10,100,0.0001,0.01,0.686,0.898876404494382,1592,1612
11,3304,10,100,0.0001,0.01,0.71,0.9300847457627118,1644,1660
11,3404,10,100,0.0001,0.01,0.758,0.949177438307873,1686,1718
11,3504,10,100,0.0001,0.01,0.76,0.96175799086758,1737,1767
11,3604,10,100,0.0001,0.01,0.772,0.9719755826859046,1783,1821
11,3704,10,100,0.0001,0.01,0.784,0.9705723542116631,1836,1868
11,3804,10,100,0.0001,0.01,0.786,0.9666140904311251,1885,1919
11,3904,10,100,0.0001,0.01,0.756,0.9536372950819673,1939,1965
11,4004,10,100,0.0001,0.01,0.76,0.9273226773226774,1985,2019
11,4104,10,100,0.0001,0.01,0.754,0.9042397660818714,2026,2078
11,4204,10,100,0.0001,0.01,0.778,0.9495718363463368,2072,2132
11,4304,10,100,0.0001,0.01,0.798,0.95817843866171,2130,2174
11,4404,10,100,0.0001,0.01,0.822,0.9759309718437784,2173,2231
11,4504,10,100,0.0001,0.01,0.844,0.9800177619893428,2229,2275
11,4604,10,100,0.0001,0.01,0.828,0.9871850564726324,2284,2320
11,4704,10,100,0.0001,0.01,0.84,0.9917091836734694,2334,2370
11,4804,10,100,0.0001,0.01,0.83,0.9862614487926727,2387,2417
11,4904,10,100,0.0001,0.01,0.832,0.9873572593800979,2448,2456
11,5004,10,100,0.0001,0.01,0.834,0.9902078337330136,2484,2520
11,5104,10,100,0.0001,0.01,0.842,0.989615987460815,2530,2574
11,5204,10,100,0.0001,0.01,0.852,0.9880860876249039,2575,2629
11,5304,10,100,0.0001,0.01,0.83,0.9762443438914027,2622,2682
11,5404,10,100,0.0001,0.01,0.844,0.985381199111769,2676,2728
11,5504,10,100,0.0001,0.01,0.858,0.9869186046511628,2730,2774
11,5604,10,100,0.0001,0.01,0.856,0.9891149179157744,2778,2826
11,5704,10,100,0.0001,0.01,0.858,0.9894810659186536,2834,2870
11,5804,10,100,0.0001,0.01,0.872,0.9905237767057202,2880,2924
11,5904,10,100,0.0001,0.01,0.862,0.986449864498645,2937,2967
11,6004,10,100,0.0001,0.01,0.866,0.9830113257828115,2983,3021
11,6104,10,100,0.0001,0.01,0.866,0.9891874180865007,3035,3069
11,6204,10,100,0.0001,0.01,0.852,0.9793681495809156,3080,3124
11,6304,10,100,0.0001,0.01,0.88,0.9919098984771574,3130,3174
11,6404,10,100,0.0001,0.01,0.87,0.9945346658338539,3175,3229
11,6504,10,100,0.0001,0.01,0.886,0.9978474784747847,3231,3273
11,6604,10,100,0.0001,0.01,0.882,0.997274379164143,3280,3324
11,6704,10,100,0.0001,0.01,0.872,0.9958233890214797,3333,3371
11,6804,10,100,0.0001,0.01,0.898,0.9892710170487948,3377,3427
11,6904,10,100,0.0001,0.01,0.884,0.9891367323290846,3426,3478
11,7004,10,100,0.0001,0.01,0.91,0.9911479154768703,3464,3540
11,7104,10,100,0.0001,0.01,0.904,0.9940878378378378,3510,3594
11,7204,10,100,0.0001,0.01,0.904,0.9919489172681843,3563,3641
11,7304,10,100,0.0001,0.01,0.892,0.9912376779846659,3615,3689
11,7404,10,100,0.0001,0.01,0.906,0.979740680713128,3664,3740
11,7504,10,100,0.0001,0.01,0.868,0.9482942430703625,3709,3795
11,7604,10,100,0.0001,0.01,0.856,0.927669647553919,3765,3839
11,7704,10,100,0.0001,0.01,0.874,0.9457424714434061,3814,3890
11,7804,10,100,0.0001,0.01,0.92,0.9691184008200923,3870,3934
11,7904,10,100,0.0001,0.01,0.924,0.9908906882591093,3918,3986
11,8004,10,100,0.0001,0.01,0.93,0.9918790604697652,3964,4040
11,8104,10,100,0.0001,0.01,0.934,0.9919792694965449,4016,4088
11,8204,10,100,0.0001,0.01,0.93,0.9964651389566065,4062,4142
11,8304,10,100,0.0001,0.01,0.946,0.9932562620423893,4116,4188
11,8404,10,100,0.0001,0.01,0.952,0.9964302712993812,4167,4237
11,8504,10,100,0.0001,0.01,0.948,0.9977657572906867,4220,4284
11,8604,10,100,0.0001,0.01,0.95,0.997907949790795,4264,4340
11,8704,10,100,0.0001,0.01,0.956,0.9985064338235294,4319,4385
11,8804,10,100,0.0001,0.01,0.952,0.9980690595184007,4373,4431
11,8904,10,100,0.0001,0.01,0.944,0.9957322551662174,4426,4478
11,9004,10,100,0.0001,0.01,0.954,0.9991115059973346,4475,4529
11,9104,10,100,0.0001,0.01,0.952,0.9941783831282952,4523,4581
11,9204,10,100,0.0001,0.01,0.956,0.9956540634506736,4575,4629
11,9304,10,100,0.0001,0.01,0.95,0.9957007738607051,4622,4682
11,9404,10,100,0.0001,0.01,0.958,0.9951084644831987,4671,4733
11,9504,10,100,0.0001,0.01,0.94,0.9888468013468014,4720,4784
11,9604,10,100,0.0001,0.01,0.956,0.9889629321116201,4775,4829
11,9704,10,100,0.0001,0.01,0.946,0.9823784006595219,4826,4878
11,9804,10,100,0.0001,0.01,0.938,0.9879640962872297,4882,4922
11,9904,10,100,0.0001,0.01,0.97,0.9967689822294022,4940,4964
11,10004,10,100,0.0001,0.01,0.958,0.9899040383846461,4990,5014
11,10104,10,100,0.0001,0.01,0.966,0.995744259699129,5045,5059
11,10204,10,100,0.0001,0.01,0.97,0.9973539788318306,5095,5109
11,10304,10,100,0.0001,0.01,0.974,0.9964091614906833,5142,5162
11,10404,10,100,0.0001,0.01,0.962,0.9976931949250288,5198,5206
11,10504,10,100,0.0001,0.01,0.974,0.9979055597867479,5251,5253
11,10604,10,100,0.0001,0.01,0.968,0.995473406261788,5301,5303
11,10704,10,100,0.0001,0.01,0.968,0.9834641255605381,5351,5353
11,10804,10,100,0.0001,0.01,0.976,0.9934283598667161,5404,5400
11,10904,10,100,0.0001,0.01,0.966,0.9961482024944974,5458,5446
11,11004,10,100,0.0001,0.01,0.98,0.9981824790985097,5505,5499
11,11104,10,100,0.0001,0.01,0.972,0.9955871757925072,5561,5543
11,11204,10,100,0.0001,0.01,0.974,0.996876115672974,5605,5599
11,11304,10,100,0.0001,0.01,0.974,0.9921266808209483,5652,5652
11,11404,10,100,0.0001,0.01,0.978,0.9978954752718344,5705,5699
11,11504,10,100,0.0001,0.01,0.982,0.9986091794158554,5759,5745
11,11604,10,100,0.0001,0.01,0.982,0.9990520510168908,5807,5797
11,11704,10,100,0.0001,0.01,0.984,0.9994873547505126,5849,5855
11,11804,10,100,0.0001,0.01,0.982,0.9989833954591664,5900,5904
11,11904,10,100,0.0001,0.01,0.986,0.9985719086021505,5953,5951
11,12004,10,100,0.0001,0.01,0.98,0.9970009996667777,6003,6001
11,12104,10,100,0.0001,0.01,0.98,0.9954560475875743,6051,6053
11,12204,10,100,0.0001,0.01,0.976,0.9912323828253031,6098,6106
11,12304,10,100,0.0001,0.01,0.976,0.9947171651495449,6148,6156
11,12404,10,100,0.0001,0.01,0.984,0.9957271847791035,6199,6205
11,12504,10,100,0.0001,0.01,0.978,0.9925623800383877,6247,6257
11,12604,10,100,0.0001,0.01,0.982,0.9979371628054586,6306,6298
11,12704,10,100,0.0001,0.01,0.978,0.9984256926952141,6351,6353
11,12804,10,100,0.0001,0.01,0.98,0.9905498281786942,6407,6397
11,12904,10,100,0.0001,0.01,0.978,0.9969776813391197,6450,6454
11,13004,10,100,0.0001,0.01,0.982,0.9987696093509689,6496,6508
11,13104,10,100,0.0001,0.01,0.978,0.9987026862026862,6535,6569
11,13204,10,100,0.0001,0.01,0.982,0.9991669191154195,6582,6622
11,13304,10,100,0.0001,0.01,0.98,0.9988725195429946,6637,6667
11,13404,10,100,0.0001,0.01,0.978,0.9955983288570576,6688,6716
11,13504,10,100,0.0001,0.01,0.976,0.9953347156398105,6732,6772
11,13604,10,100,0.0001,0.01,0.976,0.9903704792708027,6769,6835
11,13704,10,100,0.0001,0.01,0.978,0.9926298890834793,6815,6889
11,13804,10,100,0.0001,0.01,0.986,0.9968849608809041,6870,6934
11,13904,10,100,0.0001,0.01,0.99,0.9969792865362486,6920,6984
11,14004,10,100,0.0001,0.01,0.988,0.9977863467580691,6970,7034
11,14104,10,100,0.0001,0.01,0.99,0.9993618831537152,7016,7088
11,14204,10,100,0.0001,0.01,0.986,0.9994367783722895,7075,7129
11,14304,10,100,0.0001,0.01,0.988,0.9983920581655481,7122,7182
11,14404,10,100,0.0001,0.01,0.982,0.9988197722854762,7180,7224
11,14504,10,100,0.0001,0.01,0.984,0.9986900165471594,7228,7276
11,14604,10,100,0.0001,0.01,0.976,0.9952752670501233,7283,7321
11,14704,10,100,0.0001,0.01,0.98,0.9947633297062024,7332,7372
11,14804,10,100,0.0001,0.01,0.986,0.9969602810051338,7382,7422
11,14904,10,100,0.0001,0.01,0.978,0.9960413311862587,7439,7465
11,15004,10,100,0.0001,0.01,0.98,0.9940682484670754,7494,7510
12,104,10,100,0.0001,0.01,0.502,0.6826923076923077,55,49
12,204,10,100,0.0001,0.01,0.512,0.6470588235294118,112,92
12,304,10,100,0.0001,0.01,0.506,0.6085526315789473,171,133
12,404,10,100,0.0001,0.01,0.496,0.6683168316831684,220,184
12,504,10,100,0.0001,0.01,0.48,0.628968253968254,271,233
12,604,10,100,0.0001,0.01,0.488,0.6473509933774835,324,280
12,704,10,100,0.0001,0.01,0.488,0.6818181818181818,373,331
12,804,10,100,0.0001,0.01,0.482,0.6654228855721394,417,387
12,904,10,100,0.0001,0.01,0.486,0.6471238938053098,467,437
12,1004,10,100,0.0001,0.01,0.498,0.6782868525896414,517,487
12,1104,10,100,0.0001,0.01,0.498,0.6875,569,535
12,1204,10,100,0.0001,0.01,0.51,0.7142857142857143,629,575
12,1304,10,100,0.0001,0.01,0.484,0.6894171779141104,681,623
12,1404,10,100,0.0001,0.01,0.514,0.6866096866096866,727,677
12,1504,10,100,0.0001,0.01,0.51,0.7021276595744681,771,733
12,1604,10,100,0.0001,0.01,0.526,0.7250623441396509,819,785
12,1704,10,100,0.0001,0.01,0.48,0.7230046948356808,877,827
12,1804,10,100,0.0001,0.01,0.522,0.7522172949002217,927,877
12,1904,10,100,0.0001,0.01,0.508,0.7478991596638656,970,934
12,2004,10,100,0.0001,0.01,0.536,0.7969061876247505,1017,987
12,2104,10,100,0.0001,0.01,0.51,0.7466730038022814,1063,1041
12,2204,10,100,0.0001,0.01,0.544,0.7527223230490018,1113,1091
12,2304,10,100,0.0001,0.01,0.608,0.7660590277777778,1160,1144
12,2404,10,100,0.0001,0.01,0.574,0.8306988352745425,1211,1193
12,2504,10,100,0.0001,0.01,0.586,0.8490415335463258,1260,1244
12,2604,10,100,0.0001,0.01,0.59,0.8083717357910907,1314,1290
12,2704,10,100,0.0001,0.01,0.636,0.8498520710059172,1362,1342
12,2804,10,100,0.0001,0.01,0.658,0.8837375178316691,1421,1383
12,2904,10,100,0.0001,0.01,0.684,0.8770661157024794,1463,1441
12,3004,10,100,0.0001,0.01,0.652,0.8665113182423435,1508,1496
12,3104,10,100,0.0001,0.01,0.706,0.8553479381443299,1554,1550
12,3204,10,100,0.0001,0.01,0.74,0.9185393258426966,1597,1607
12,3304,10,100,0.0001,0.01,0.748,0.9197941888619855,1639,1665
12,3404,10,100,0.0001,0.01,0.79,0.9353701527614571,1689,1715
12,3504,10,100,0.0001,0.01,0.808,0.9474885844748858,1739,1765
12,3604,10,100,0.0001,0.01,0.818,0.9600443951165372,1796,1808
12,3704,10,100,0.0001,0.01,0.832,0.9730021598272138,1847,1857
12,3804,10,100,0.0001,0.01,0.852,0.9818611987381703,1894,1910
12,3904,10,100,0.0001,0.01,0.864,0.9815573770491803,1941,1963
12,4004,10,100,0.0001,0.01,0.878,0.9815184815184815,1986,2018
12,4104,10,100,0.0001,0.01,0.886,0.9922027290448343,2032,2072
12,4204,10,100,0.0001,0.01,0.86,0.9793054234062797,2074,2130
12,4304,10,100,0.0001,0.01,0.888,0.9907063197026023,2125,2179
12,4404,10,100,0.0001,0.01,0.89,0.9782016348773842,2175,2229
12,4504,10,100,0.0001,0.01,0.904,0.9906749555950266,2215,2289
12,4604,10,100,0.0001,0.01,0.892,0.9934839270199827,2255,2349
12,4704,10,100,0.0001,0.01,0.89,0.983843537414966,2310,2394
12,4804,10,100,0.0001,0.01,0.902,0.9922980849292257,2355,2449
12,4904,10,100,0.0001,0.01,0.912,0.9906199021207178,2402,2502
12,5004,10,100,0.0001,0.01,0.9,0.9830135891286971,2451,2553
12,5104,10,100,0.0001,0.01,0.92,0.9827586206896551,2508,2596
12,5204,10,100,0.0001,0.01,0.918,0.9771329746348962,2558,2646
12,5304,10,100,0.0001,0.01,0.922,0.9903846153846154,2607,2697
12,5404,10,100,0.0001,0.01,0.904,0.9859363434492968,2655,2749
12,5504,10,100,0.0001,0.01,0.922,0.9860101744186046,2705,2799
12,5604,10,100,0.0001,0.01,0.878,0.9589578872234118,2752,2852
12,5704,10,100,0.0001,0.01,0.838,0.9125175315568023,2803,2901
12,5804,10,100,0.0001,0.01,0.894,0.9462439696760855,2849,2955
12,5904,10,100,0.0001,0.01,0.916,0.9786585365853658,2892,3012
12,6004,10,100,0.0001,0.01,0.936,0.9896735509660226,2946,3058
12,6104,10,100,0.0001,0.01,0.938,0.992300131061599,2998,3106
12,6204,10,100,0.0001,0.01,0.948,0.9940361057382334,3046,3158
12,6304,10,100,0.0001,0.01,0.94,0.9961928934010152,3105,3199
12,6404,10,100,0.0001,0.01,0.952,0.9940662086196127,3157,3247
12,6504,10,100,0.0001,0.01,0.944,0.9916974169741697,3213,3291
12,6604,10,100,0.0001,0.01,0.95,0.9892489400363416,3256,3348
12,6704,10,100,0.0001,0.01,0.948,0.989409307875895,3310,3394
12,6804,10,100,0.0001,0.01,0.956,0.9941211052322163,3370,3434
12,6904,10,100,0.0001,0.01,0.944,0.9950753186558516,3424,3480
12,7004,10,100,0.0001,0.01,0.944,0.9950028555111365,3467,3537
12,7104,10,100,0.0001,0.01,0.952,0.9960585585585585,3509,3595
12,7204,10,100,0.0001,0.01,0.956,0.9962520821765686,3561,3643
12,7304,10,100,0.0001,0.01,0.952,0.9935651697699891,3618,3686
12,7404,10,100,0.0001,0.01,0.96,0.9947325769854133,3668,3736
12,7504,10,100,0.0001,0.01,0.946,0.9918710021321961,3721,3783
12,7604,10,100,0.0001,0.01,0.954,0.9913203577064703,3766,3838
12,7704,10,100,0.0001,0.01,0.958,0.9935098650051921,3815,3889
12,7804,10,100,0.0001,0.01,0.96,0.992696053305997,3862,3942
12,7904,10,100,0.0001,0.01,0.966,0.9967105263157895,3921,3983
12,8004,10,100,0.0001,0.01,0.96,0.9921289355322339,3972,4032
12,8104,10,100,0.0001,0.01,0.954,0.9962981243830207,4022,4082
12,8204,10,100,0.0001,0.01,0.966,0.9969527059970746,4078,4126
12,8304,10,100,0.0001,0.01,0.962,0.9993978805394991,4122,4182
12,8404,10,100,0.0001,0.01,0.966,0.9985721085197525,4171,4233
12,8504,10,100,0.0001,0.01,0.962,0.9955315145813735,4216,4288
12,8604,10,100,0.0001,0.01,0.968,0.9940725244072525,4268,4336
12,8704,10,100,0.0001,0.01,0.966,0.9906939338235294,4323,4381
12,8804,10,100,0.0001,0.01,0.96,0.9928441617446615,4357,4447
12,8904,10,100,0.0001,0.01,0.958,0.9853998203054807,4409,4495
12,9004,10,100,0.0001,0.01,0.966,0.9911150599733451,4459,4545
12,9104,10,100,0.0001,0.01,0.972,0.9962653778558875,4508,4596
12,9204,10,100,0.0001,0.01,0.97,0.9954367666232073,4553,4651
12,9304,10,100,0.0001,0.01,0.972,0.9969905417024936,4606,4698
12,9404,10,100,0.0001,0.01,0.974,0.9985112717992344,4649,4755
12,9504,10,100,0.0001,0.01,0.972,0.9994739057239057,4701,4803
12,9604,10,100,0.0001,0.01,0.974,0.9970845481049563,4755,4849
12,9704,10,100,0.0001,0.01,0.974,0.9989694971145919,4807,4897
12,9804,10,100,0.0001,0.01,0.972,0.9976540187678499,4854,4950
12,9904,10,100,0.0001,0.01,0.976,1.0,4906,4998
12,10004,10,100,0.0001,0.01,0.978,1.0,4950,5054
12,10104,10,100,0.0001,0.01,0.978,1.0,5007,5097
12,10204,10,100,0.0001,0.01,0.978,1.0,5063,5141
12,10304,10,100,0.0001,0.01,0.972,0.9957298136645962,5113,5191
12,10404,10,100,0.0001,0.01,0.956,0.9789504036908881,5162,5242
12,10504,10,100,0.0001,0.01,0.968,0.9854341203351105,5218,5286
12,10604,10,100,0.0001,0.01,0.954,0.9816107129385138,5271,5333
12,10704,10,100,0.0001,0.01,0.968,0.9865470852017937,5325,5379
12,10804,10,100,0.0001,0.01,0.974,0.9937060348019252,5370,5434
12,10904,10,100,0.0001,0.01,0.982,0.9948642699926632,5425,5479
12,11004,10,100,0.0001,0.01,0.976,0.9969102144674664,5480,5524
12,11104,10,100,0.0001,0.01,0.98,0.9991894812680115,5536,5568
12,11204,10,100,0.0001,0.01,0.982,0.9994644769725098,5581,5623
12,11304,10,100,0.0001,0.01,0.98,0.9991153573956122,5631,5673
12,11404,10,100,0.0001,0.01,0.98,0.9979831638021747,5678,5726
12,11504,10,100,0.0001,0.01,0.976,0.9993045897079277,5723,5781
12,11604,10,100,0.0001,0.01,0.982,0.9976732161323681,5766,5838
12,11704,10,100,0.0001,0.01,0.982,0.9996582365003418,5809,5895
12,11804,10,100,0.0001,0.01,0.98,0.9971196204676381,5866,5938
12,11904,10,100,0.0001,0.01,0.974,0.9922715053763441,5917,5987
12,12004,10,100,0.0001,0.01,0.974,0.9904198600466512,5970,6034
12,12104,10,100,0.0001,0.01,0.978,0.9863681427627231,6018,6086
12,12204,10,100,0.0001,0.01,0.976,0.9922976073418551,6071,6133
12,12304,10,100,0.0001,0.01,0.984,0.9990247074122237,6121,6183
12,12404,10,100,0.0001,0.01,0.984,0.9995162850693324,6161,6243
12,12504,10,100,0.0001,0.01,0.986,0.9996001279590531,6208,6296
12,12604,10,100,0.0001,0.01,0.982,0.9999206601079023,6259,6345
12,12704,10,100,0.0001,0.01,0.982,0.9999212846347607,6307,6397
12,12804,10,100,0.0001,0.01,0.988,0.9996094970321775,6358,6446
12,12904,10,100,0.0001,0.01,0.988,0.9996125232486051,6414,6490
12,13004,10,100,0.0001,0.01,0.986,0.999461704091049,6465,6539
12,13104,10,100,0.0001,0.01,0.984,0.9980921855921856,6521,6583
12,13204,10,100,0.0001,0.01,0.982,0.9975007573462588,6569,6635
12,13304,10,100,0.0001,0.01,0.984,0.9955652435357787,6620,6684
12,13404,10,100,0.0001,0.01,0.984,0.993509400179051,6670,6734
12,13504,10,100,0.0001,0.01,0.986,0.9965195497630331,6716,6788
12,13604,10,100,0.0001,0.01,0.988,0.9958100558659218,6770,6834
12,13704,10,100,0.0001,0.01,0.978,0.9956217162872154,6818,6886
12,13804,10,100,0.0001,0.01,0.986,0.9980440452042886,6867,6937
12,13904,10,100,0.0001,0.01,0.99,0.9996403912543153,6916,6988
12,14004,10,100,0.0001,0.01,0.984,0.9968580405598401,6969,7035
12,14104,10,100,0.0001,0.01,0.984,0.999503686897334,7026,7078
12,14204,10,100,0.0001,0.01,0.988,0.9996479864826809,7081,7123
12,14304,10,100,0.0001,0.01,0.99,0.9990212527964206,7137,7167
12,14404,10,100,0.0001,0.01,0.984,0.9975006942515968,7188,7216
12,14504,10,100,0.0001,0.01,0.956,0.9797297297297297,7242,7262
12,14604,10,100,0.0001,0.01,0.988,0.9947274719254998,7287,7317
12,14704,10,100,0.0001,0.01,0.992,0.9948313384113167,7332,7372
12,14804,10,100,0.0001,0.01,0.99,0.9961496892731694,7388,7416
12,14904,10,100,0.0001,0.01,0.986,0.9986580783682233,7446,7458
12,15004,10,100,0.0001,0.01,0.99,0.9988003199146894,7505,7499
13,104,10,100,0.0001,0.01,0.486,0.47115384615384615,47,57
13,204,10,100,0.0001,0.01,0.506,0.553921568627451,108,96
13,304,10,100,0.0001,0.01,0.49,0.5953947368421053,157,147
13,404,10,100,0.0001,0.01,0.51,0.5915841584158416,208,196
13,504,10,100,0.0001,0.01,0.502,0.5972222222222222,259,245
13,604,10,100,0.0001,0.01,0.516,0.5811258278145696,311,293
13,704,10,100,0.0001,0.01,0.502,0.5482954545454546,369,335
13,804,10,100,0.0001,0.01,0.528,0.6181592039800995,418,386
13,904,10,100,0.0001,0.01,0.498,0.6084070796460177,470,434
13,1004,10,100,0.0001,0.01,0.526,0.6264940239043825,523,481
13,1104,10,100,0.0001,0.01,0.5,0.677536231884058,571,533
13,1204,10,100,0.0001,0.01,0.482,0.7043189368770764,616,588
13,1304,10,100,0.0001,0.01,0.52,0.6779141104294478,656,648
13,1404,10,100,0.0001,0.01,0.5,0.6887464387464387,703,701
13,1504,10,100,0.0001,0.01,0.48,0.6781914893617021,749,755
13,1604,10,100,0.0001,0.01,0.502,0.7169576059850374,806,798
13,1704,10,100,0.0001,0.01,0.492,0.7300469483568075,856,848
13,1804,10,100,0.0001,0.01,0.496,0.746119733924612,911,893
13,1904,10,100,0.0001,0.01,0.508,0.7531512605042017,960,944
13,2004,10,100,0.0001,0.01,0.504,0.7125748502994012,1020,984
13,2104,10,100,0.0001,0.01,0.552,0.7447718631178707,1068,1036
13,2204,10,100,0.0001,0.01,0.542,0.8021778584392014,1120,1084
13,2304,10,100,0.0001,0.01,0.572,0.7725694444444444,1173,1131
13,2404,10,100,0.0001,0.01,0.602,0.8182196339434277,1225,1179
13,2504,10,100,0.0001,0.01,0.574,0.8186900958466453,1278,1226
13,2604,10,100,0.0001,0.01,0.586,0.8317972350230415,1328,1276
13,2704,10,100,0.0001,0.01,0.596,0.8125,1381,1323
13,2804,10,100,0.0001,0.01,0.628,0.7778174037089871,1428,1376
13,2904,10,100,0.0001,0.01,0.614,0.8233471074380165,1484,1420
13,3004,10,100,0.0001,0.01,0.648,0.8515312916111851,1531,1473
13,3104,10,100,0.0001,0.01,0.658,0.8743556701030928,1589,1515
13,3204,10,100,0.0001,0.01,0.684,0.8760923845193508,1632,1572
13,3304,10,100,0.0001,0.01,0.638,0.840496368038741,1685,1619
13,3404,10,100,0.0001,0.01,0.69,0.8989424206815512,1736,1668
13,3504,10,100,0.0001,0.01,0.728,0.9118150684931506,1780,1724
13,3604,10,100,0.0001,0.01,0.738,0.9125971143174251,1830,1774
13,3704,10,100,0.0001,0.01,0.76,0.9187365010799136,1883,1821
13,3804,10,100,0.0001,0.01,0.788,0.9190325972660357,1932,1872
13,3904,10,100,0.0001,0.01,0.73,0.9036885245901639,1982,1922
13,4004,10,100,0.0001,0.01,0.778,0.938061938061938,2025,1979
13,4104,10,100,0.0001,0.01,0.776,0.9108187134502924,2084,2020
13,4204,10,100,0.0001,0.01,0.814,0.9307802093244529,2140,2064
13,4304,10,100,0.0001,0.01,0.824,0.9491171003717472,2187,2117
13,4404,10,100,0.0001,0.01,0.852,0.9693460490463215,2246,2158
13,4504,10,100,0.0001,0.01,0.856,0.9782415630550622,2296,2208
13,4604,10,100,0.0001,0.01,0.84,0.9811033883579496,2348,2256
13,4704,10,100,0.0001,0.01,0.856,0.9889455782312925,2399,2305
13,4804,10,100,0.0001,0.01,0.87,0.9891756869275604,2446,2358
13,4904,10,100,0.0001,0.01,0.864,0.9951060358890701,2487,2417
13,5004,10,100,0.0001,0.01,0.878,0.9974020783373302,2531,2473
13,5104,10,100,0.0001,0.01,0.88,0.9931426332288401,2586,2518
13,5204,10,100,0.0001,0.01,0.88,0.9882782475019216,2623,2581
13,5304,10,100,0.0001,0.01,0.866,0.9683257918552036,2673,2631
13,5404,10,100,0.0001,0.01,0.9,0.980940044411547,2730,2674
13,5504,10,100,0.0001,0.01,0.898,0.9903706395348837,2773,2731
13,5604,10,100,0.0001,0.01,0.898,0.9737687366167024,2835,2769
13,5704,10,100,0.0001,0.01,0.884,0.9857994389901823,2890,2814
13,5804,10,100,0.0001,0.01,0.894,0.983631977946244,2934,2870
13,5904,10,100,0.0001,0.01,0.912,0.9691734417344173,2990,2914
13,6004,10,100,0.0001,0.01,0.934,0.9901732178547635,3043,2961
13,6104,10,100,0.0001,0.01,0.94,0.9942660550458715,3091,3013
13,6204,10,100,0.0001,0.01,0.938,0.9953255963894262,3144,3060
13,6304,10,100,0.0001,0.01,0.948,0.9971446700507615,3194,3110
13,6404,10,100,0.0001,0.01,0.948,0.9982823235477827,3247,3157
13,6504,10,100,0.0001,0.01,0.942,0.9989237392373924,3304,3200
13,6604,10,100,0.0001,0.01,0.94,0.9989400363416111,3352,3252
13,6704,10,100,0.0001,0.01,0.948,0.9989558472553699,3395,3309
13,6804,10,100,0.0001,0.01,0.958,0.9988242210464433,3433,3371
13,6904,10,100,0.0001,0.01,0.94,0.9942062572421785,3481,3423
13,7004,10,100,0.0001,0.01,0.932,0.9940034266133638,3519,3485
13,7104,10,100,0.0001,0.01,0.952,0.9963400900900901,3570,3534
13,7204,10,100,0.0001,0.01,0.954,0.9936146585230428,3611,3593
13,7304,10,100,0.0001,0.01,0.952,0.9824753559693319,3651,3653
13,7404,10,100,0.0001,0.01,0.942,0.9841977309562399,3692,3712
13,7504,10,100,0.0001,0.01,0.952,0.990271855010661,3741,3763
13,7604,10,100,0.0001,0.01,0.954,0.9951341399263546,3789,3815
13,7704,10,100,0.0001,0.01,0.97,0.9954569055036345,3840,3864
13,7804,10,100,0.0001,0.01,0.97,0.9971809328549461,3898,3906
13,7904,10,100,0.0001,0.01,0.97,0.9986082995951417,3943,3961
13,8004,10,100,0.0001,0.01,0.96,0.9975012493753124,3990,4014
13,8104,10,100,0.0001,0.01,0.976,0.9991362290227048,4040,4064
13,8204,10,100,0.0001,0.01,0.974,0.9963432471964895,4093,4111
13,8304,10,100,0.0001,0.01,0.98,0.9992774566473989,4146,4158
13,8404,10,100,0.0001,0.01,0.976,0.9994050452165636,4195,4209
13,8504,10,100,0.0001,0.01,0.978,0.9995296331138288,4249,4255
13,8604,10,100,0.0001,0.01,0.954,0.9947698744769874,4286,4318
13,8704,10,100,0.0001,0.01,0.97,0.9964384191176471,4333,4371
13,8804,10,100,0.0001,0.01,0.974,0.9977283053157655,4378,4426
13,8904,10,100,0.0001,0.01,0.962,0.9985399820305481,4425,4479
13,9004,10,100,0.0001,0.01,0.966,0.9935584184806753,4480,4524
13,9104,10,100,0.0001,0.01,0.968,0.9974736379613357,4525,4579
13,9204,10,100,0.0001,0.01,0.968,0.9958713602781399,4571,4633
13,9304,10,100,0.0001,0.01,0.976,0.9966680997420464,4617,4687
13,9404,10,100,0.0001,0.01,0.964,0.9903232666950234,4673,4731
13,9504,10,100,0.0001,0.01,0.96,0.9890572390572391,4725,4779
13,9604,10,100,0.0001,0.01,0.974,0.9940649729279467,4784,4820
13,9704,10,100,0.0001,0.01,0.976,0.9969084913437758,4849,4855
13,9804,10,100,0.0001,0.01,0.984,0.9983680130558955,4893,4911
13,9904,10,100,0.0001,0.01,0.98,0.9987883683360258,4943,4961
13,10004,10,100,0.0001,0.01,0.98,0.999500199920032,4993,5011
13,10104,10,100,0.0001,0.01,0.982,0.9996041171813144,5035,5069
13,10204,10,100,0.0001,0.01,0.98,0.9993139945119561,5078,5126
13,10304,10,100,0.0001,0.01,0.98,0.9989324534161491,5120,5184
13,10404,10,100,0.0001,0.01,0.974,0.9949058054594386,5169,5235
13,10504,10,100,0.0001,0.01,0.974,0.998000761614623,5212,5292
13,10604,10,100,0.0001,0.01,0.984,0.9950018860807243,5257,5347
13,10704,10,100,0.0001,0.01,0.982,0.9957025411061285,5308,5396
13,10804,10,100,0.0001,0.01,0.968,0.9834320621991854,5359,5445
13,10904,10,100,0.0001,0.01,0.98,0.9924798239178283,5405,5499
13,11004,10,100,0.0001,0.01,0.98,0.9968193384223919,5453,5551
13,11104,10,100,0.0001,0.01,0.984,0.997928674351585,5501,5603
13,11204,10,100,0.0001,0.01,0.984,0.9990182077829347,5561,5643
13,11304,10,100,0.0001,0.01,0.98,0.9992038216560509,5622,5682
13,11404,10,100,0.0001,0.01,0.984,0.9993861802876184,5667,5737
13,11504,10,100,0.0001,0.01,0.986,0.9997392211404729,5712,5792
13,11604,10,100,0.0001,0.01,0.986,0.9999138228197173,5764,5840
13,11704,10,100,0.0001,0.01,0.984,0.9993164730006835,5812,5892
13,11804,10,100,0.0001,0.01,0.984,0.9977973568281938,5866,5938
13,11904,10,100,0.0001,0.01,0.982,0.9992439516129032,5912,5992
13,12004,10,100,0.0001,0.01,0.984,0.9983338887037654,5958,6046
13,12104,10,100,0.0001,0.01,0.98,0.9930601454064772,6007,6097
13,12204,10,100,0.0001,0.01,0.978,0.9907407407407407,6067,6137
13,12304,10,100,0.0001,0.01,0.964,0.9800877763328999,6120,6184
13,12404,10,100,0.0001,0.01,0.99,0.9965333763302161,6170,6234
13,12504,10,100,0.0001,0.01,0.99,0.9976007677543186,6211,6293
13,12604,10,100,0.0001,0.01,0.986,0.9994446207553158,6259,6345
13,12704,10,100,0.0001,0.01,0.986,0.9977172544080605,6317,6387
13,12804,10,100,0.0001,0.01,0.988,0.9989846922836614,6365,6439
13,12904,10,100,0.0001,0.01,0.988,0.9984500929944203,6416,6488
13,13004,10,100,0.0001,0.01,0.98,0.991464164872347,6469,6535
13,13104,10,100,0.0001,0.01,0.99,0.9979395604395604,6525,6579
13,13204,10,100,0.0001,0.01,0.982,0.9949257800666464,6565,6639
13,13304,10,100,0.0001,0.01,0.984,0.9953397474443776,6624,6680
13,13404,10,100,0.0001,0.01,0.984,0.9973888391524918,6677,6727
13,13504,10,100,0.0001,0.01,0.988,0.9974822274881516,6732,6772
13,13604,10,100,0.0001,0.01,0.99,0.9985298441634813,6780,6824
13,13704,10,100,0.0001,0.01,0.986,0.99905137186223,6828,6876
13,13804,10,100,0.0001,0.01,0.986,0.9980440452042886,6881,6923
13,13904,10,100,0.0001,0.01,0.99,0.9991369390103567,6933,6971
13,14004,10,100,0.0001,0.01,0.984,0.9996429591545273,6979,7025
13,14104,10,100,0.0001,0.01,0.986,0.9999290981281905,7030,7074
13,14204,10,100,0.0001,0.01,0.988,0.9999295972965362,7078,7126
13,14304,10,100,0.0001,0.01,0.99,0.9988115212527964,7142,7162
13,14404,10,100,0.0001,0.01,0.986,0.9959039155790058,7197,7207
13,14504,10,100,0.0001,0.01,0.982,0.991657473800331,7253,7251
13,14604,10,100,0.0001,0.01,0.988,0.9964393316899479,7298,7306
13,14704,10,100,0.0001,0.01,0.982,0.9918389553862894,7349,7355
13,14804,10,100,0.0001,0.01,0.988,0.9943258578762496,7398,7406
13,14904,10,100,0.0001,0.01,0.992,0.9986580783682233,7454,7450
13,15004,10,100,0.0001,0.01,0.992,0.9992002132764596,7504,7500
14,104,10,100,0.0001,0.01,0.484,0.5,52,52
14,204,10,100,0.0001,0.01,0.512,0.6715686274509803,102,102
14,304,10,100,0.0001,0.01,0.504,0.6151315789473685,152,152
14,404,10,100,0.0001,0.01,0.462,0.6188118811881188,206,198
14,504,10,100,0.0001,0.01,0.486,0.6190476190476191,252,252
14,604,10,100,0.0001,0.01,0.51,0.6125827814569537,306,298
14,704,10,100,0.0001,0.01,0.526,0.6363636363636364,348,356
14,804,10,100,0.0001,0.01,0.512,0.6380597014925373,390,414
14,904,10,100,0.0001,0.01,0.554,0.6139380530973452,443,461
14,1004,10,100,0.0001,0.01,0.512,0.6404382470119522,490,514
14,1104,10,100,0.0001,0.01,0.51,0.644927536231884,541,563
14,1204,10,100,0.0001,0.01,0.49,0.6669435215946844,587,617
14,1304,10,100,0.0001,0.01,0.48,0.6671779141104295,640,664
14,1404,10,100,0.0001,0.01,0.498,0.6937321937321937,687,717
14,1504,10,100,0.0001,0.01,0.5,0.6808510638297872,740,764
14,1604,10,100,0.0001,0.01,0.508,0.7213216957605985,794,810
14,1704,10,100,0.0001,0.01,0.49,0.6936619718309859,845,859
14,1804,10,100,0.0001,0.01,0.526,0.7361419068736141,893,911
14,1904,10,100,0.0001,0.01,0.522,0.7526260504201681,942,962
14,2004,10,100,0.0001,0.01,0.56,0.7704590818363274,992,1012
14,2104,10,100,0.0001,0.01,0.54,0.783745247148289,1034,1070
14,2204,10,100,0.0001,0.01,0.56,0.8062613430127041,1084,1120
14,2304,10,100,0.0001,0.01,0.578,0.8459201388888888,1132,1172
14,2404,10,100,0.0001,0.01,0.586,0.8435940099833611,1182,1222
14,2504,10,100,0.0001,0.01,0.596,0.8634185303514377,1234,1270
14,2604,10,100,0.0001,0.01,0.556,0.8529185867895546,1274,1330
14,2704,10,100,0.0001,0.01,0.63,0.8768491124260355,1330,1374
14,2804,10,100,0.0001,0.01,0.678,0.9147646219686163,1378,1426
14,2904,10,100,0.0001,0.01,0.706,0.9359504132231405,1423,1481
14,3004,10,100,0.0001,0.01,0.726,0.9370838881491345,1469,1535
14,3104,10,100,0.0001,0.01,0.726,0.9542525773195877,1516,1588
14,3204,10,100,0.0001,0.01,0.744,0.9603620474406991,1567,1637
14,3304,10,100,0.0001,0.01,0.758,0.9518765133171913,1616,1688
14,3404,10,100,0.0001,0.01,0.774,0.9770857814336075,1666,1738
14,3504,10,100,0.0001,0.01,0.772,0.9777397260273972,1711,1793
14,3604,10,100,0.0001,0.01,0.81,0.9725305216426193,1760,1844
14,3704,10,100,0.0001,0.01,0.816,0.9724622030237581,1810,1894
14,3804,10,100,0.0001,0.01,0.82,0.9789695057833859,1861,1943
14,3904,10,100,0.0001,0.01,0.848,0.9861680327868853,1919,1985
14,4004,10,100,0.0001,0.01,0.854,0.9867632367632367,1966,2038
14,4104,10,100,0.0001,0.01,0.838,0.9583333333333334,2018,2086
14,4204,10,100,0.0001,0.01,0.866,0.980732635585157,2071,2133
14,4304,10,100,0.0001,0.01,0.868,0.9753717472118959,2118,2186
14,4404,10,100,0.0001,0.01,0.886,0.9879654859218892,2161,2243
14,4504,10,100,0.0001,0.01,0.898,0.9924511545293073,2211,2293
14,4604,10,100,0.0001,0.01,0.894,0.9928323197219809,2265,2339
14,4704,10,100,0.0001,0.01,0.906,0.9923469387755102,2318,2386
14,4804,10,100,0.0001,0.01,0.886,0.9933388842631141,2365,2439
14,4904,10,100,0.0001,0.01,0.898,0.9977569331158238,2417,2487
14,5004,10,100,0.0001,0.01,0.908,0.9958033573141487,2455,2549
14,5104,10,100,0.0001,0.01,0.928,0.9974529780564263,2506,2598
14,5204,10,100,0.0001,0.01,0.914,0.9959646425826287,2551,2653
14,5304,10,100,0.0001,0.01,0.916,0.995475113122172,2595,2709
14,5404,10,100,0.0001,0.01,0.902,0.9792746113989638,2646,2758
14,5504,10,100,0.0001,0.01,0.914,0.9834665697674418,2695,2809
14,5604,10,100,0.0001,0.01,0.88,0.958779443254818,2740,2864
14,5704,10,100,0.0001,0.01,0.91,0.958976157082749,2786,2918
14,5804,10,100,0.0001,0.01,0.924,0.9867332873880083,2838,2966
14,5904,10,100,0.0001,0.01,0.948,0.9923780487804879,2887,3017
14,6004,10,100,0.0001,0.01,0.964,0.9951698867421719,2943,3061
14,6104,10,100,0.0001,0.01,0.958,0.9962319790301442,2996,3108
14,6204,10,100,0.0001,0.01,0.966,0.9977433913604127,3039,3165
14,6304,10,100,0.0001,0.01,0.96,0.9958756345177665,3089,3215
14,6404,10,100,0.0001,0.01,0.96,0.9964084946908183,3139,3265
14,6504,10,100,0.0001,0.01,0.964,0.9992312423124231,3192,3312
14,6604,10,100,0.0001,0.01,0.976,0.9992428831011508,3246,3358
14,6704,10,100,0.0001,0.01,0.972,0.9997016706443914,3293,3411
14,6804,10,100,0.0001,0.01,0.972,0.9995590828924162,3343,3461
14,6904,10,100,0.0001,0.01,0.966,0.9968134414831982,3393,3511
14,7004,10,100,0.0001,0.01,0.958,0.99785836664763,3450,3554
14,7104,10,100,0.0001,0.01,0.954,0.9978885135135135,3497,3607
14,7204,10,100,0.0001,0.01,0.968,0.9977790116601888,3548,3656
14,7304,10,100,0.0001,0.01,0.972,0.9972617743702081,3598,3706
14,7404,10,100,0.0001,0.01,0.974,0.9995948136142626,3653,3751
14,7504,10,100,0.0001,0.01,0.964,0.9997334754797441,3703,3801
14,7604,10,100,0.0001,0.01,0.974,1.0,3747,3857
14,7704,10,100,0.0001,0.01,0.97,1.0,3796,3908
14,7804,10,100,0.0001,0.01,0.972,1.0,3845,3959
14,7904,10,100,0.0001,0.01,0.976,1.0,3900,4004
14,8004,10,100,0.0001,0.01,0.972,0.9992503748125937,3957,4047
14,8104,10,100,0.0001,0.01,0.966,0.9992596248766041,4009,4095
14,8204,10,100,0.0001,0.01,0.97,0.9948805460750854,4062,4142
14,8304,10,100,0.0001,0.01,0.972,0.9945809248554913,4117,4187
14,8404,10,100,0.0001,0.01,0.956,0.9813184198000952,4173,4231
14,8504,10,100,0.0001,0.01,0.956,0.9871825023518345,4223,4281
14,8604,10,100,0.0001,0.01,0.946,0.9829149232914923,4272,4332
14,8704,10,100,0.0001,0.01,0.982,0.9940257352941176,4318,4386
14,8804,10,100,0.0001,0.01,0.974,0.9961381190368015,4374,4430
14,8904,10,100,0.0001,0.01,0.972,0.9957322551662174,4419,4485
14,9004,10,100,0.0001,0.01,0.974,0.9976677032430031,4468,4536
14,9104,10,100,0.0001,0.01,0.968,0.9970342706502636,4523,4581
14,9204,10,100,0.0001,0.01,0.982,0.9992394611038679,4581,4623
14,9304,10,100,0.0001,0.01,0.97,0.9984952708512468,4631,4673
14,9404,10,100,0.0001,0.01,0.982,0.9975542322415993,4671,4733
14,9504,10,100,0.0001,0.01,0.976,0.9974747474747475,4719,4785
14,9604,10,100,0.0001,0.01,0.978,0.9973969179508538,4776,4828
14,9704,10,100,0.0001,0.01,0.976,0.9984542456718879,4833,4871
14,9804,10,100,0.0001,0.01,0.98,0.9990820073439413,4876,4928
14,9904,10,100,0.0001,0.01,0.976,0.9997980613893377,4929,4975
14,10004,10,100,0.0001,0.01,0.978,0.9957017193122751,4985,5019
14,10104,10,100,0.0001,0.01,0.984,0.9958432304038005,5035,5069
14,10204,10,100,0.0001,0.01,0.954,0.9947079576636613,5090,5114
14,10304,10,100,0.0001,0.01,0.97,0.9967973602484472,5147,5157
14,10404,10,100,0.0001,0.01,0.966,0.9973087274125336,5202,5202
14,10504,10,100,0.0001,0.01,0.968,0.9905750190403656,5258,5246
14,10604,10,100,0.0001,0.01,0.978,0.9956620143342135,5315,5289
14,10704,10,100,0.0001,0.01,0.974,0.9951420029895366,5368,5336
14,10804,10,100,0.0001,0.01,0.974,0.9947241762310255,5419,5385
14,10904,10,100,0.0001,0.01,0.964,0.9933052090975789,5468,5436
14,11004,10,100,0.0001,0.01,0.974,0.9867320974191203,5518,5486
14,11104,10,100,0.0001,0.01,0.974,0.9975684438040345,5569,5535
14,11204,10,100,0.0001,0.01,0.986,0.9983934309175294,5616,5588
14,11304,10,100,0.0001,0.01,0.994,0.9996461429582448,5666,5638
14,11404,10,100,0.0001,0.01,0.99,0.9986846720448965,5713,5691
14,11504,10,100,0.0001,0.01,0.99,0.9987830319888734,5760,5744
14,11604,10,100,0.0001,0.01,0.978,0.9993105825577387,5808,5796
14,11704,10,100,0.0001,0.01,0.992,0.9996582365003418,5852,5852
14,11804,10,100,0.0001,0.01,0.988,0.9996611318197222,5905,5899
14,11904,10,100,0.0001,0.01,0.992,0.9993279569892473,5957,5947
14,12004,10,100,0.0001,0.01,0.98,0.998750416527824,6008,5996
14,12104,10,100,0.0001,0.01,0.986,0.9968605419695968,6055,6049
14,12204,10,100,0.0001,0.01,0.99,0.9968862667977713,6109,6095
14,12304,10,100,0.0001,0.01,0.978,0.9930104031209362,6158,6146
14,12404,10,100,0.0001,0.01,0.98,0.9925830377297646,6204,6200
14,12504,10,100,0.0001,0.01,0.986,0.9956813819577736,6252,6252
14,12604,10,100,0.0001,0.01,0.992,0.9974611234528721,6305,6299
14,12704,10,100,0.0001,0.01,0.99,0.9992128463476071,6354,6350
14,12804,10,100,0.0001,0.01,0.988,0.9997656982193065,6402,6402
14,12904,10,100,0.0001,0.01,0.992,1.0,6455,6449
14,13004,10,100,0.0001,0.01,0.986,0.9993848046754845,6503,6501
14,13104,10,100,0.0001,0.01,0.992,0.9999236874236874,6557,6547
14,13204,10,100,0.0001,0.01,0.992,1.0,6600,6604
14,13304,10,100,0.0001,0.01,0.992,0.9998496692723993,6653,6651
14,13404,10,100,0.0001,0.01,0.99,0.9998507908087139,6700,6704
14,13504,10,100,0.0001,0.01,0.992,0.9998518957345972,6761,6743
14,13604,10,100,0.0001,0.01,0.99,0.9995589532490444,6813,6791
14,13704,10,100,0.0001,0.01,0.992,0.9987594862813777,6862,6842
14,13804,10,100,0.0001,0.01,0.978,0.9903651115618661,6909,6895
14,13904,10,100,0.0001,0.01,0.982,0.990506329113924,6961,6943
14,14004,10,100,0.0001,0.01,0.99,0.9965009997143673,7007,6997
14,14104,10,100,0.0001,0.01,0.992,0.9994327850255247,7057,7047
14,14204,10,100,0.0001,0.01,0.992,0.9997887918896086,7102,7102
14,14304,10,100,0.0001,0.01,0.992,1.0,7152,7152
14,14404,10,100,0.0001,0.01,0.992,0.9999305748403221,7203,7201
14,14504,10,100,0.0001,0.01,0.992,1.0,7256,7248
14,14604,10,100,0.0001,0.01,0.992,1.0,7303,7301
14,14704,10,100,0.0001,0.01,0.992,1.0,7349,7355
14,14804,10,100,0.0001,0.01,0.99,0.9931099702783032,7405,7399
14,14904,10,100,0.0001,0.01,0.986,0.9916129898013956,7457,7447
14,15004,10,100,0.0001,0.01,0.982,0.9903359104238869,7510,7494
15,104,10,100,0.0001,0.01,0.508,0.49038461538461536,53,51
15,204,10,100,0.0001,0.01,0.5,0.5490196078431373,106,98
15,304,10,100,0.0001,0.01,0.542,0.6052631578947368,159,145
15,404,10,100,0.0001,0.01,0.52,0.6014851485148515,210,194
15,504,10,100,0.0001,0.01,0.504,0.6051587301587301,259,245
15,604,10,100,0.0001,0.01,0.504,0.6258278145695364,309,295
15,704,10,100,0.0001,0.01,0.518,0.6633522727272727,359,345
15,804,10,100,0.0001,0.01,0.492,0.6579601990049752,407,397
15,904,10,100,0.0001,0.01,0.502,0.6526548672566371,455,449
15,1004,10,100,0.0001,0.01,0.504,0.7061752988047809,501,503
15,1104,10,100,0.0001,0.01,0.508,0.6657608695652174,546,558
15,1204,10,100,0.0001,0.01,0.5,0.707641196013289,597,607
15,1304,10,100,0.0001,0.01,0.516,0.6687116564417178,645,659
15,1404,10,100,0.0001,0.01,0.516,0.7186609686609686,694,710
15,1504,10,100,0.0001,0.01,0.51,0.6655585106382979,748,756
15,1604,10,100,0.0001,0.01,0.528,0.7175810473815462,794,810
15,1704,10,100,0.0001,0.01,0.514,0.6960093896713615,842,862
15,1804,10,100,0.0001,0.01,0.552,0.7355875831485588,886,918
15,1904,10,100,0.0001,0.01,0.56,0.7242647058823529,937,967
15,2004,10,100,0.0001,0.01,0.542,0.7485029940119761,994,1010
15,2104,10,100,0.0001,0.01,0.516,0.7319391634980988,1042,1062
15,2204,10,100,0.0001,0.01,0.538,0.8035390199637024,1090,1114
15,2304,10,100,0.0001,0.01,0.574,0.8081597222222222,1145,1159
15,2404,10,100,0.0001,0.01,0.578,0.8265391014975042,1186,1218
15,2504,10,100,0.0001,0.01,0.584,0.8170926517571885,1245,1259
15,2604,10,100,0.0001,0.01,0.582,0.8367895545314901,1290,1314
15,2704,10,100,0.0001,0.01,0.632,0.852810650887574,1339,1365
15,2804,10,100,0.0001,0.01,0.658,0.8780313837375179,1385,1419
15,2904,10,100,0.0001,0.01,0.666,0.8536501377410468,1437,1467
15,3004,10,100,0.0001,0.01,0.708,0.872503328894807,1491,1513
15,3104,10,100,0.0001,0.01,0.722,0.8820876288659794,1547,1557
15,3204,10,100,0.0001,0.01,0.768,0.9169787765293383,1595,1609
15,3304,10,100,0.0001,0.01,0.728,0.9285714285714286,1654,1650
15,3404,10,100,0.0001,0.01,0.732,0.9430082256169212,1706,1698
15,3504,10,100,0.0001,0.01,0.79,0.920662100456621,1754,1750
15,3604,10,100,0.0001,0.01,0.78,0.9270255271920089,1798,1806
15,3704,10,100,0.0001,0.01,0.756,0.9225161987041036,1847,1857
15,3804,10,100,0.0001,0.01,0.82,0.9566246056782335,1893,1911
15,3904,10,100,0.0001,0.01,0.82,0.9649077868852459,1938,1966
15,4004,10,100,0.0001,0.01,0.838,0.9790209790209791,1990,2014
15,4104,10,100,0.0001,0.01,0.844,0.979775828460039,2043,2061
15,4204,10,100,0.0001,0.01,0.848,0.975023786869648,2094,2110
15,4304,10,100,0.0001,0.01,0.852,0.9779275092936803,2139,2165
15,4404,10,100,0.0001,0.01,0.838,0.9834241598546776,2186,2218
15,4504,10,100,0.0001,0.01,0.848,0.9911190053285968,2247,2257
15,4604,10,100,0.0001,0.01,0.852,0.9921807124239791,2299,2305
15,4704,10,100,0.0001,0.01,0.86,0.9912840136054422,2346,2358
15,4804,10,100,0.0001,0.01,0.872,0.9902164862614488,2393,2411
15,4904,10,100,0.0001,0.01,0.878,0.9946982055464927,2448,2456
15,5004,10,100,0.0001,0.01,0.878,0.9820143884892086,2493,2511
15,5104,10,100,0.0001,0.01,0.86,0.9939263322884012,2548,2556
15,5204,10,100,0.0001,0.01,0.876,0.9875096079938509,2597,2607
15,5304,10,100,0.0001,0.01,0.876,0.9788838612368024,2649,2655
15,5404,10,100,0.0001,0.01,0.86,0.9678016284233901,2697,2707
15,5504,10,100,0.0001,0.01,0.876,0.9774709302325582,2746,2758
15,5604,10,100,0.0001,0.01,0.88,0.9869735902926481,2801,2803
15,5704,10,100,0.0001,0.01,0.914,0.9873772791023843,2849,2855
15,5804,10,100,0.0001,0.01,0.876,0.9774293590627153,2897,2907
15,5904,10,100,0.0001,0.01,0.906,0.9876355013550135,2956,2948
15,6004,10,100,0.0001,0.01,0.912,0.9900066622251832,2998,3006
15,6104,10,100,0.0001,0.01,0.9,0.9898427260812582,3042,3062
15,6204,10,100,0.0001,0.01,0.896,0.9925854287556415,3091,3113
15,6304,10,100,0.0001,0.01,0.892,0.9822335025380711,3142,3162
15,6404,10,100,0.0001,0.01,0.914,0.985633978763273,3191,3213
15,6504,10,100,0.0001,0.01,0.904,0.9857011070110702,3240,3264
15,6604,10,100,0.0001,0.01,0.904,0.9789521502119928,3293,3311
15,6704,10,100,0.0001,0.01,0.92,0.9898568019093079,3334,3370
15,6804,10,100,0.0001,0.01,0.89,0.9656084656084656,3386,3418
15,6904,10,100,0.0001,0.01,0.894,0.9703070683661645,3438,3466
15,7004,10,100,0.0001,0.01,0.91,0.9862935465448315,3486,3518
15,7104,10,100,0.0001,0.01,0.934,0.9940878378378378,3548,3556
15,7204,10,100,0.0001,0.01,0.916,0.9926429761243754,3604,3600
15,7304,10,100,0.0001,0.01,0.928,0.9950711938663745,3642,3662
15,7404,10,100,0.0001,0.01,0.93,0.9896002160994057,3683,3721
15,7504,10,100,0.0001,0.01,0.934,0.9930703624733476,3736,3768
15,7604,10,100,0.0001,0.01,0.93,0.996449237243556,3795,3809
15,7704,10,100,0.0001,0.01,0.942,0.9945482866043613,3840,3864
15,7804,10,100,0.0001,0.01,0.936,0.9925679138903126,3888,3916
15,7904,10,100,0.0001,0.01,0.924,0.9964574898785425,3939,3965
15,8004,10,100,0.0001,0.01,0.938,0.9980009995002499,3989,4015
15,8104,10,100,0.0001,0.01,0.932,0.9962981243830207,4033,4071
15,8204,10,100,0.0001,0.01,0.94,0.9973183812774257,4084,4120
15,8304,10,100,0.0001,0.01,0.944,0.9979527938342967,4137,4167
15,8404,10,100,0.0001,0.01,0.938,0.9940504521656354,4181,4223
15,8504,10,100,0.0001,0.01,0.932,0.9910630291627469,4235,4269
15,8604,10,100,0.0001,0.01,0.926,0.9858205485820548,4287,4317
15,8704,10,100,0.0001,0.01,0.932,0.9856387867647058,4335,4369
15,8804,10,100,0.0001,0.01,0.942,0.9803498409813721,4388,4416
15,8904,10,100,0.0001,0.01,0.894,0.9547394429469901,4442,4462
15,9004,10,100,0.0001,0.01,0.936,0.9785650821856953,4490,4514
15,9104,10,100,0.0001,0.01,0.926,0.9829745166959578,4539,4565
15,9204,10,100,0.0001,0.01,0.932,0.9863102998696219,4585,4619
15,9304,10,100,0.0001,0.01,0.932,0.99365864144454,4637,4667
15,9404,10,100,0.0001,0.01,0.942,0.9942577626541897,4675,4729
15,9504,10,100,0.0001,0.01,0.942,0.9938973063973064,4728,4776
15,9604,10,100,0.0001,0.01,0.886,0.9297167846730529,4780,4824
15,9704,10,100,0.0001,0.01,0.922,0.9563066776586975,4832,4872
15,9804,10,100,0.0001,0.01,0.928,0.9746022031823746,4882,4922
15,9904,10,100,0.0001,0.01,0.946,0.9844507269789984,4932,4972
15,10004,10,100,0.0001,0.01,0.936,0.9850059976009596,4976,5028
15,10104,10,100,0.0001,0.01,0.95,0.9937648456057007,5023,5081
15,10204,10,100,0.0001,0.01,0.946,0.9931399451195609,5071,5133
15,10304,10,100,0.0001,0.01,0.952,0.9942740683229814,5121,5183
15,10404,10,100,0.0001,0.01,0.948,0.995674740484429,5172,5232
15,10504,10,100,0.0001,0.01,0.942,0.993907083015994,5219,5285
15,10604,10,100,0.0001,0.01,0.95,0.993964541682384,5266,5338
15,10704,10,100,0.0001,0.01,0.952,0.992432735426009,5309,5395
15,10804,10,100,0.0001,0.01,0.954,0.9909292854498334,5365,5439
15,10904,10,100,0.0001,0.01,0.962,0.9956896551724138,5427,5477
15,11004,10,100,0.0001,0.01,0.956,0.9980007270083606,5473,5531
15,11104,10,100,0.0001,0.01,0.956,0.9978386167146974,5533,5571
15,11204,10,100,0.0001,0.01,0.952,0.9961620849696537,5580,5624
15,11304,10,100,0.0001,0.01,0.954,0.997169143665959,5621,5683
15,11404,10,100,0.0001,0.01,0.958,0.9949140652402666,5669,5735
15,11504,10,100,0.0001,0.01,0.952,0.9924374130737135,5728,5776
15,11604,10,100,0.0001,0.01,0.954,0.9950017235436056,5789,5815
15,11704,10,100,0.0001,0.01,0.946,0.9875256322624744,5833,5871
15,11804,10,100,0.0001,0.01,0.956,0.9905116909522196,5882,5922
15,11904,10,100,0.0001,0.01,0.948,0.9922715053763441,5940,5964
15,12004,10,100,0.0001,0.01,0.966,0.996334555148284,5989,6015
15,12104,10,100,0.0001,0.01,0.96,0.9974388631857237,6042,6062
15,12204,10,100,0.0001,0.01,0.966,0.9985250737463127,6092,6112
15,12304,10,100,0.0001,0.01,0.962,0.9980494148244473,6146,6158
15,12404,10,100,0.0001,0.01,0.964,0.9966139954853274,6197,6207
15,12504,10,100,0.0001,0.01,0.956,0.9965611004478567,6237,6267
15,12604,10,100,0.0001,0.01,0.964,0.9958743256109172,6293,6311
15,12704,10,100,0.0001,0.01,0.956,0.9951196473551638,6347,6357
15,12804,10,100,0.0001,0.01,0.964,0.9950015620118713,6397,6407
15,12904,10,100,0.0001,0.01,0.962,0.9886856788592684,6445,6459
15,13004,10,100,0.0001,0.01,0.936,0.9788526607197785,6492,6512
15,13104,10,100,0.0001,0.01,0.966,0.9942765567765568,6541,6563
15,13204,10,100,0.0001,0.01,0.968,0.9979551651014844,6592,6612
15,13304,10,100,0.0001,0.01,0.966,0.9964672279013831,6638,6666
15,13404,10,100,0.0001,0.01,0.972,0.9977618621307073,6689,6715
15,13504,10,100,0.0001,0.01,0.972,0.9973341232227488,6739,6765
15,13604,10,100,0.0001,0.01,0.972,0.9967656571596589,6795,6809
15,13704,10,100,0.0001,0.01,0.962,0.9976649153531816,6844,6860
15,13804,10,100,0.0001,0.01,0.968,0.9942770211532889,6891,6913
15,13904,10,100,0.0001,0.01,0.97,0.9972669735327964,6943,6961
15,14004,10,100,0.0001,0.01,0.964,0.99528706083976,6995,7009
15,14104,10,100,0.0001,0.01,0.97,0.9939024390243902,7052,7052
15,14204,10,100,0.0001,0.01,0.956,0.9635313996057449,7097,7107
15,14304,10,100,0.0001,0.01,0.942,0.9784675615212528,7148,7156
15,14404,10,100,0.0001,0.01,0.966,0.9935434601499583,7199,7205
15,14504,10,100,0.0001,0.01,0.97,0.9966216216216216,7260,7244
15,14604,10,100,0.0001,0.01,0.976,0.9959600109559025,7313,7291
15,14704,10,100,0.0001,0.01,0.978,0.9978237214363439,7364,7340
15,14804,10,100,0.0001,0.01,0.972,0.9957443934071872,7416,7388
15,14904,10,100,0.0001,0.01,0.982,0.9969806763285024,7459,7445
15,15004,10,100,0.0001,0.01,0.982,0.994001599573447,7506,7498
16,104,10,100,0.0001,0.01,0.482,0.4807692307692308,50,54
16,204,10,100,0.0001,0.01,0.498,0.6421568627450981,99,105
16,304,10,100,0.0001,0.01,0.524,0.5921052631578947,156,148
16,404,10,100,0.0001,0.01,0.496,0.6485148514851485,202,202
16,504,10,100,0.0001,0.01,0.48,0.5376984126984127,248,256
16,604,10,100,0.0001,0.01,0.516,0.6672185430463576,299,305
16,704,10,100,0.0001,0.01,0.506,0.6434659090909091,346,358
16,804,10,100,0.0001,0.01,0.508,0.6579601990049752,396,408
16,904,10,100,0.0001,0.01,0.512,0.6537610619469026,442,462
16,1004,10,100,0.0001,0.01,0.512,0.6663346613545816,487,517
16,1104,10,100,0.0001,0.01,0.498,0.6403985507246377,541,563
16,1204,10,100,0.0001,0.01,0.518,0.6976744186046512,587,617
16,1304,10,100,0.0001,0.01,0.502,0.6970858895705522,636,668
16,1404,10,100,0.0001,0.01,0.516,0.7257834757834758,683,721
16,1504,10,100,0.0001,0.01,0.5,0.7101063829787234,734,770
16,1604,10,100,0.0001,0.01,0.508,0.7699501246882793,779,825
16,1704,10,100,0.0001,0.01,0.508,0.7676056338028169,831,873
16,1804,10,100,0.0001,0.01,0.494,0.7694013303769401,889,915
16,1904,10,100,0.0001,0.01,0.514,0.7526260504201681,937,967
16,2004,10,100,0.0001,0.01,0.524,0.7849301397205589,982,1022
16,2104,10,100,0.0001,0.01,0.546,0.7713878326996197,1037,1067
16,2204,10,100,0.0001,0.01,0.552,0.8076225045372051,1082,1122
16,2304,10,100,0.0001,0.01,0.558,0.8359375,1129,1175
16,2404,10,100,0.0001,0.01,0.568,0.8660565723793677,1180,1224
16,2504,10,100,0.0001,0.01,0.576,0.8246805111821086,1226,1278
16,2604,10,100,0.0001,0.01,0.602,0.8536866359447005,1279,1325
16,2704,10,100,0.0001,0.01,0.566,0.8317307692307693,1333,1371
16,2804,10,100,0.0001,0.01,0.594,0.8587731811697575,1377,1427
16,2904,10,100,0.0001,0.01,0.62,0.9015151515151515,1423,1481
16,3004,10,100,0.0001,0.01,0.616,0.9174434087882823,1478,1526
16,3104,10,100,0.0001,0.01,0.632,0.895618556701031,1520,1584
16,3204,10,100,0.0001,0.01,0.636,0.8966916354556804,1580,1624
16,3304,10,100,0.0001,0.01,0.658,0.9213075060532687,1630,1674
16,3404,10,100,0.0001,0.01,0.65,0.931551116333725,1675,1729
16,3504,10,100,0.0001,0.01,0.668,0.942351598173516,1725,1779
16,3604,10,100,0.0001,0.01,0.67,0.9642064372918979,1779,1825
16,3704,10,100,0.0001,0.01,0.686,0.9705723542116631,1832,1872
16,3804,10,100,0.0001,0.01,0.684,0.9655625657202944,1887,1917
16,3904,10,100,0.0001,0.01,0.682,0.8980532786885246,1929,1975
16,4004,10,100,0.0001,0.01,0.7,0.9093406593406593,1977,2027
16,4104,10,100,0.0001,0.01,0.706,0.939327485380117,2024,2080
16,4204,10,100,0.0001,0.01,0.74,0.9345861084681256,2075,2129
16,4304,10,100,0.0001,0.01,0.76,0.9586431226765799,2123,2181
16,4404,10,100,0.0001,0.01,0.764,0.971843778383288,2175,2229
16,4504,10,100,0.0001,0.01,0.768,0.9837921847246892,2227,2277
16,4604,10,100,0.0001,0.01,0.806,0.9787141615986099,2280,2324
16,4704,10,100,0.0001,0.01,0.792,0.9825680272108843,2327,2377
16,4804,10,100,0.0001,0.01,0.812,0.985428809325562,2387,2417
16,4904,10,100,0.0001,0.01,0.81,0.9820554649265906,2437,2467
16,5004,10,100,0.0001,0.01,0.812,0.9802158273381295,2485,2519
16,5104,10,100,0.0001,0.01,0.802,0.9657131661442007,2543,2561
16,5204,10,100,0.0001,0.01,0.828,0.9773251345119139,2598,2606
16,5304,10,100,0.0001,0.01,0.85,0.986236802413273,2650,2654
16,5404,10,100,0.0001,0.01,0.84,0.9916728349370837,2705,2699
16,5504,10,100,0.0001,0.01,0.866,0.9941860465116279,2755,2749
16,5604,10,100,0.0001,0.01,0.878,0.9946466809421841,2810,2794
16,5704,10,100,0.0001,0.01,0.89,0.9971949509116409,2856,2848
16,5804,10,100,0.0001,0.01,0.9,0.9970709855272226,2907,2897
16,5904,10,100,0.0001,0.01,0.904,0.9969512195121951,2954,2950
16,6004,10,100,0.0001,0.01,0.884,0.9815123251165889,3010,2994
16,6104,10,100,0.0001,0.01,0.856,0.9577326343381389,3065,3039
16,6204,10,100,0.0001,0.01,0.916,0.9893617021276596,3117,3087
16,6304,10,100,0.0001,0.01,0.926,0.9946065989847716,3166,3138
16,6404,10,100,0.0001,0.01,0.926,0.9943785134291068,3213,3191
16,6504,10,100,0.0001,0.01,0.93,0.9936961869618696,3263,3241
16,6604,10,100,0.0001,0.01,0.936,0.9978800726832223,3313,3291
16,6704,10,100,0.0001,0.01,0.932,0.9988066825775657,3364,3340
16,6804,10,100,0.0001,0.01,0.93,0.9992651381540271,3414,3390
16,6904,10,100,0.0001,0.01,0.938,0.9998551564310545,3458,3446
16,7004,10,100,0.0001,0.01,0.942,0.9997144488863506,3511,3493
16,7104,10,100,0.0001,0.01,0.948,0.9998592342342343,3565,3539
16,7204,10,100,0.0001,0.01,0.934,0.9976401998889506,3623,3581
16,7304,10,100,0.0001,0.01,0.938,0.9938389923329682,3674,3630
16,7404,10,100,0.0001,0.01,0.94,0.9962182603997839,3720,3684
16,7504,10,100,0.0001,0.01,0.942,0.998001066098081,3770,3734
16,7604,10,100,0.0001,0.01,0.938,0.9936875328774329,3817,3787
16,7704,10,100,0.0001,0.01,0.956,0.995846313603323,3863,3841
16,7804,10,100,0.0001,0.01,0.948,0.9964120963608406,3913,3891
16,7904,10,100,0.0001,0.01,0.964,0.9959514170040485,3966,3938
16,8004,10,100,0.0001,0.01,0.952,0.9980009995002499,4017,3987
16,8104,10,100,0.0001,0.01,0.956,0.9975320829220138,4062,4042
16,8204,10,100,0.0001,0.01,0.94,0.9958556801560214,4113,4091
16,8304,10,100,0.0001,0.01,0.948,0.9960260115606936,4158,4146
16,8404,10,100,0.0001,0.01,0.958,0.986554021894336,4211,4193
16,8504,10,100,0.0001,0.01,0.934,0.9709548447789276,4255,4249
16,8604,10,100,0.0001,0.01,0.96,0.9824500232450023,4303,4301
16,8704,10,100,0.0001,0.01,0.962,0.9959788602941176,4352,4352
16,8804,10,100,0.0001,0.01,0.974,0.9962517037710131,4404,4400
16,8904,10,100,0.0001,0.01,0.972,0.996967654986523,4456,4448
16,9004,10,100,0.0001,0.01,0.976,0.9986672589960017,4509,4495
16,9104,10,100,0.0001,0.01,0.976,0.99945079086116,4556,4548
16,9204,10,100,0.0001,0.01,0.976,0.9991308126901347,4599,4605
16,9304,10,100,0.0001,0.01,0.976,1.0,4639,4665
16,9404,10,100,0.0001,0.01,0.978,0.9991492981709911,4680,4724
16,9504,10,100,0.0001,0.01,0.976,0.9995791245791246,4721,4783
16,9604,10,100,0.0001,0.01,0.976,0.9995835068721366,4769,4835
16,9704,10,100,0.0001,0.01,0.974,0.999484748557296,4817,4887
16,9804,10,100,0.0001,0.01,0.978,0.9990820073439413,4867,4937
16,9904,10,100,0.0001,0.01,0.976,0.9984854604200323,4914,4990
16,10004,10,100,0.0001,0.01,0.976,0.9971011595361855,4953,5051
16,10104,10,100,0.0001,0.01,0.982,0.998812351543943,5008,5096
16,10204,10,100,0.0001,0.01,0.984,0.999607996863975,5060,5144
16,10304,10,100,0.0001,0.01,0.982,0.999611801242236,5116,5188
16,10404,10,100,0.0001,0.01,0.976,0.9987504805843906,5169,5235
16,10504,10,100,0.0001,0.01,0.978,0.9981911652703732,5221,5283
16,10604,10,100,0.0001,0.01,0.968,0.9934930215013202,5265,5339
16,10704,10,100,0.0001,0.01,0.972,0.9943011958146487,5316,5388
16,10804,10,100,0.0001,0.01,0.978,0.9962976675305443,5371,5433
16,10904,10,100,0.0001,0.01,0.982,0.9975238444607484,5418,5486
16,11004,10,100,0.0001,0.01,0.978,0.9938204289349327,5470,5534
16,11104,10,100,0.0001,0.01,0.982,0.9987391930835735,5517,5587
16,11204,10,100,0.0001,0.01,0.984,0.9984826847554444,5569,5635
16,11304,10,100,0.0001,0.01,0.986,0.9991153573956122,5622,5682
16,11404,10,100,0.0001,0.01,0.98,0.9994738688179586,5673,5731
16,11504,10,100,0.0001,0.01,0.986,0.9984353268428373,5725,5779
16,11604,10,100,0.0001,0.01,0.976,0.9983626335746294,5779,5825
16,11704,10,100,0.0001,0.01,0.984,0.9982057416267942,5823,5881
16,11804,10,100,0.0001,0.01,0.974,0.9962724500169434,5872,5932
16,11904,10,100,0.0001,0.01,0.976,0.9979838709677419,5922,5982
16,12004,10,100,0.0001,0.01,0.982,0.9975008330556481,5977,6027
16,12104,10,100,0.0001,0.01,0.978,0.9984302709847984,6030,6074
16,12204,10,100,0.0001,0.01,0.964,0.9914782038675845,6077,6127
16,12304,10,100,0.0001,0.01,0.978,0.9975617685305592,6132,6172
16,12404,10,100,0.0001,0.01,0.988,0.9992744276039988,6178,6226
16,12504,10,100,0.0001,0.01,0.974,0.9981605886116443,6226,6278
16,12604,10,100,0.0001,0.01,0.976,0.9983338622659473,6276,6328
16,12704,10,100,0.0001,0.01,0.976,0.9977959697732998,6328,6376
16,12804,10,100,0.0001,0.01,0.984,0.9991408934707904,6376,6428
16,12904,10,100,0.0001,0.01,0.976,0.9983725976441413,6423,6481
16,13004,10,100,0.0001,0.01,0.978,0.9967702245462935,6483,6521
16,13104,10,100,0.0001,0.01,0.978,0.9972527472527473,6535,6569
16,13204,10,100,0.0001,0.01,0.98,0.9987882459860649,6583,6621
16,13304,10,100,0.0001,0.01,0.98,0.9999248346361996,6626,6678
16,13404,10,100,0.0001,0.01,0.982,0.9988809310653536,6679,6725
16,13504,10,100,0.0001,0.01,0.978,1.0,6732,6772
16,13604,10,100,0.0001,0.01,0.98,1.0,6786,6818
16,13704,10,100,0.0001,0.01,0.982,0.9999270286047869,6844,6860
16,13804,10,100,0.0001,0.01,0.976,0.9972471747319618,6902,6902
16,13904,10,100,0.0001,0.01,0.986,0.9994965477560415,6953,6951
16,14004,10,100,0.0001,0.01,0.982,0.9995001428163381,6999,7005
16,14104,10,100,0.0001,0.01,0.984,0.9981565513329552,7048,7056
16,14204,10,100,0.0001,0.01,0.972,0.9899324134046747,7102,7102
16,14304,10,100,0.0001,0.01,0.978,0.9942673378076062,7158,7146
16,14404,10,100,0.0001,0.01,0.982,0.9986114968064427,7209,7195
16,14504,10,100,0.0001,0.01,0.988,0.9986210700496415,7254,7250
16,14604,10,100,0.0001,0.01,0.984,0.9994522048753766,7308,7296
16,14704,10,100,0.0001,0.01,0.986,0.999455930359086,7366,7338
16,14804,10,100,0.0001,0.01,0.986,0.9996622534450149,7411,7393
16,14904,10,100,0.0001,0.01,0.982,0.9996645195920558,7458,7446
16,15004,10,100,0.0001,0.01,0.984,0.9998000533191149,7511,7493
17,104,10,100,0.0001,0.01,0.486,0.6826923076923077,47,57
17,204,10,100,0.0001,0.01,0.512,0.6813725490196079,90,114
17,304,10,100,0.0001,0.01,0.498,0.6217105263157895,150,154
17,404,10,100,0.0001,0.01,0.504,0.6955445544554455,193,211
17,504,10,100,0.0001,0.01,0.504,0.6666666666666666,248,256
17,604,10,100,0.0001,0.01,0.494,0.6423841059602649,296,308
17,704,10,100,0.0001,0.01,0.466,0.6548295454545454,348,356
17,804,10,100,0.0001,0.01,0.504,0.722636815920398,403,401
17,904,10,100,0.0001,0.01,0.492,0.7212389380530974,453,451
17,1004,10,100,0.0001,0.01,0.536,0.75,503,501
17,1104,10,100,0.0001,0.01,0.516,0.7219202898550725,555,549
17,1204,10,100,0.0001,0.01,0.49,0.7458471760797342,605,599
17,1304,10,100,0.0001,0.01,0.508,0.6855828220858896,653,651
17,1404,10,100,0.0001,0.01,0.522,0.7428774928774928,698,706
17,1504,10,100,0.0001,0.01,0.522,0.7460106382978723,748,756
17,1604,10,100,0.0001,0.01,0.544,0.7836658354114713,799,805
17,1704,10,100,0.0001,0.01,0.512,0.7570422535211268,846,858
17,1804,10,100,0.0001,0.01,0.54,0.7810421286031042,894,910
17,1904,10,100,0.0001,0.01,0.518,0.7809873949579832,935,969
17,2004,10,100,0.0001,0.01,0.542,0.8038922155688623,989,1015
17,2104,10,100,0.0001,0.01,0.546,0.7908745247148289,1049,1055
17,2204,10,100,0.0001,0.01,0.532,0.7903811252268602,1107,1097
17,2304,10,100,0.0001,0.01,0.552,0.8138020833333334,1154,1150
17,2404,10,100,0.0001,0.01,0.54,0.8394342762063228,1211,1193
17,2504,10,100,0.0001,0.01,0.566,0.8091054313099042,1262,1242
17,2604,10,100,0.0001,0.01,0.55,0.8717357910906298,1309,1295
17,2704,10,100,0.0001,0.01,0.59,0.882396449704142,1366,1338
17,2804,10,100,0.0001,0.01,0.612,0.9176176890156919,1405,1399
17,2904,10,100,0.0001,0.01,0.612,0.90599173553719,1450,1454
17,3004,10,100,0.0001,0.01,0.604,0.9007989347536618,1493,1511
17,3104,10,100,0.0001,0.01,0.622,0.8711340206185567,1536,1568
17,3204,10,100,0.0001,0.01,0.672,0.9166666666666666,1587,1617
17,3304,10,100,0.0001,0.01,0.672,0.9319007263922519,1635,1669
17,3404,10,100,0.0001,0.01,0.698,0.954171562867215,1690,1714
17,3504,10,100,0.0001,0.01,0.728,0.9671803652968036,1745,1759
17,3604,10,100,0.0001,0.01,0.71,0.9481132075471698,1787,1817
17,3704,10,100,0.0001,0.01,0.698,0.9036177105831533,1842,1862
17,3804,10,100,0.0001,0.01,0.744,0.9511041009463722,1895,1909
17,3904,10,100,0.0001,0.01,0.774,0.9649077868852459,1935,1969
17,4004,10,100,0.0001,0.01,0.784,0.971028971028971,1981,2023
17,4104,10,100,0.0001,0.01,0.786,0.9736842105263158,2032,2072
17,4204,10,100,0.0001,0.01,0.798,0.9790675547098002,2084,2120
17,4304,10,100,0.0001,0.01,0.792,0.9728159851301115,2130,2174
17,4404,10,100,0.0001,0.01,0.768,0.9709355131698456,2185,2219
17,4504,10,100,0.0001,0.01,0.806,0.969582593250444,2242,2262
17,4604,10,100,0.0001,0.01,0.786,0.9439617723718505,2297,2307
17,4704,10,100,0.0001,0.01,0.794,0.9026360544217688,2345,2359
17,4804,10,100,0.0001,0.01,0.806,0.9450457951706911,2384,2420
17,4904,10,100,0.0001,0.01,0.836,0.9690048939641109,2429,2475
17,5004,10,100,0.0001,0.01,0.846,0.9804156674660272,2471,2533
17,5104,10,100,0.0001,0.01,0.836,0.9766849529780565,2525,2579
17,5204,10,100,0.0001,0.01,0.852,0.9882782475019216,2575,2629
17,5304,10,100,0.0001,0.01,0.848,0.9864253393665159,2628,2676
17,5404,10,100,0.0001,0.01,0.864,0.9903774981495189,2671,2733
17,5504,10,100,0.0001,0.01,0.866,0.9889171511627907,2730,2774
17,5604,10,100,0.0001,0.01,0.828,0.9468236973590293,2791,2813
17,5704,10,100,0.0001,0.01,0.768,0.870617110799439,2838,2866
17,5804,10,100,0.0001,0.01,0.786,0.9135079255685734,2890,2914
17,5904,10,100,0.0001,0.01,0.858,0.9336043360433605,2941,2963
17,6004,10,100,0.0001,0.01,0.838,0.9576948700866089,2991,3013
17,6104,10,100,0.0001,0.01,0.844,0.9513433813892529,3044,3060
17,6204,10,100,0.0001,0.01,0.864,0.9698581560283688,3106,3098
17,6304,10,100,0.0001,0.01,0.878,0.9765228426395939,3156,3148
17,6404,10,100,0.0001,0.01,0.888,0.9853216739537789,3213,3191
17,6504,10,100,0.0001,0.01,0.898,0.984009840098401,3262,3242
17,6604,10,100,0.0001,0.01,0.91,0.9894003634161115,3313,3291
17,6704,10,100,0.0001,0.01,0.908,0.9932875894988067,3368,3336
17,6804,10,100,0.0001,0.01,0.894,0.9951499118165785,3412,3392
17,6904,10,100,0.0001,0.01,0.928,0.9963789107763615,3461,3443
17,7004,10,100,0.0001,0.01,0.902,0.9948600799543118,3511,3493
17,7104,10,100,0.0001,0.01,0.908,0.9925394144144144,3555,3549
17,7204,10,100,0.0001,0.01,0.908,0.9882009994447529,3601,3603
17,7304,10,100,0.0001,0.01,0.922,0.9908269441401971,3660,3644
17,7404,10,100,0.0001,0.01,0.902,0.9648838465694219,3712,3692
17,7504,10,100,0.0001,0.01,0.912,0.9664179104477612,3769,3735
17,7604,10,100,0.0001,0.01,0.922,0.9818516570226197,3821,3783
17,7704,10,100,0.0001,0.01,0.918,0.9913032191069574,3868,3836
17,7804,10,100,0.0001,0.01,0.934,0.9951307022039979,3920,3884
17,7904,10,100,0.0001,0.01,0.934,0.9948127530364372,3965,3939
17,8004,10,100,0.0001,0.01,0.944,0.9958770614692654,4013,3991
17,8104,10,100,0.0001,0.01,0.938,0.9933366238894373,4056,4048
17,8204,10,100,0.0001,0.01,0.936,0.9958556801560214,4110,4094
17,8304,10,100,0.0001,0.01,0.942,0.9960260115606936,4164,4140
17,8404,10,100,0.0001,0.01,0.94,0.9938124702522608,4208,4196
17,8504,10,100,0.0001,0.01,0.932,0.9920037629350894,4261,4243
17,8604,10,100,0.0001,0.01,0.932,0.9922129242212924,4314,4290
17,8704,10,100,0.0001,0.01,0.94,0.9919577205882353,4362,4342
17,8804,10,100,0.0001,0.01,0.918,0.9888686960472512,4406,4398
17,8904,10,100,0.0001,0.01,0.944,0.9951707097933513,4455,4449
17,9004,10,100,0.0001,0.01,0.948,0.998223011994669,4506,4498
17,9104,10,100,0.0001,0.01,0.96,0.9958260105448155,4562,4542
17,9204,10,100,0.0001,0.01,0.954,0.9950021729682746,4617,4587
17,9304,10,100,0.0001,0.01,0.956,0.9957007738607051,4664,4640
17,9404,10,100,0.0001,0.01,0.946,0.9902169289663972,4719,4685
17,9504,10,100,0.0001,0.01,0.938,0.9866372053872053,4760,4744
17,9604,10,100,0.0001,0.01,0.96,0.995210329029571,4813,4791
17,9704,10,100,0.0001,0.01,0.954,0.9937139323990107,4863,4841
17,9804,10,100,0.0001,0.01,0.954,0.9906160750713995,4917,4887
17,9904,10,100,0.0001,0.01,0.938,0.9886914378029079,4969,4935
17,10004,10,100,0.0001,0.01,0.956,0.9941023590563774,5006,4998
17,10104,10,100,0.0001,0.01,0.956,0.995744259699129,5062,5042
17,10204,10,100,0.0001,0.01,0.97,0.9953939631517053,5116,5088
17,10304,10,100,0.0001,0.01,0.958,0.9949534161490683,5165,5139
17,10404,10,100,0.0001,0.01,0.974,0.9957708573625529,5222,5182
17,10504,10,100,0.0001,0.01,0.972,0.9955255140898706,5273,5231
17,10604,10,100,0.0001,0.01,0.972,0.995850622406639,5312,5292
17,10704,10,100,0.0001,0.01,0.966,0.9900971599402093,5358,5346
17,10804,10,100,0.0001,0.01,0.962,0.985190670122177,5414,5390
17,10904,10,100,0.0001,0.01,0.946,0.980465884079237,5466,5438
17,11004,10,100,0.0001,0.01,0.976,0.9935478007997092,5518,5486
17,11104,10,100,0.0001,0.01,0.976,0.996307636887608,5568,5536
17,11204,10,100,0.0001,0.01,0.988,0.9985719385933595,5609,5595
17,11304,10,100,0.0001,0.01,0.982,0.9990268931351733,5660,5644
17,11404,10,100,0.0001,0.01,0.986,0.9997369344089793,5708,5696
17,11504,10,100,0.0001,0.01,0.982,0.9980876216968011,5752,5752
17,11604,10,100,0.0001,0.01,0.972,0.9942261289210617,5807,5797
17,11704,10,100,0.0001,0.01,0.978,0.9943609022556391,5853,5851
17,11804,10,100,0.0001,0.01,0.988,0.994916977295832,5896,5908
17,11904,10,100,0.0001,0.01,0.97,0.9903393817204301,5942,5962
17,12004,10,100,0.0001,0.01,0.97,0.9915861379540153,5999,6005
17,12104,10,100,0.0001,0.01,0.972,0.9933079973562459,6050,6054
17,12204,10,100,0.0001,0.01,0.992,0.9928711897738446,6102,6102
17,12304,10,100,0.0001,0.01,0.986,0.9942295188556567,6158,6146
17,12404,10,100,0.0001,0.01,0.986,0.9959690422444373,6209,6195
17,12504,10,100,0.0001,0.01,0.982,0.9972008957133717,6258,6246
17,12604,10,100,0.0001,0.01,0.986,0.9955569660425262,6305,6299
17,12704,10,100,0.0001,0.01,0.992,0.9944112090680101,6353,6351
17,12804,10,100,0.0001,0.01,0.992,0.9960949703217744,6410,6394
17,12904,10,100,0.0001,0.01,0.986,0.995195288282703,6463,6441
17,13004,10,100,0.0001,0.01,0.976,0.9957705321439557,6517,6487
17,13104,10,100,0.0001,0.01,0.986,0.9982448107448108,6569,6535
17,13204,10,100,0.0001,0.01,0.99,0.9993183883671615,6621,6583
17,13304,10,100,0.0001,0.01,0.996,0.9993235117257967,6665,6639
17,13404,10,100,0.0001,0.01,0.986,0.9959713518352731,6712,6692
17,13504,10,100,0.0001,0.01,0.99,0.9985189573459715,6764,6740
17,13604,10,100,0.0001,0.01,0.992,0.9969126727433107,6819,6785
17,13704,10,100,0.0001,0.01,0.99,0.9944541739638062,6868,6836
17,13804,10,100,0.0001,0.01,0.98,0.9960880904085773,6919,6885
17,13904,10,100,0.0001,0.01,0.984,0.992807825086306,6968,6936
17,14004,10,100,0.0001,0.01,0.968,0.9937160811196801,7015,6989
17,14104,10,100,0.0001,0.01,0.982,0.9941860465116279,7062,7042
17,14204,10,100,0.0001,0.01,0.982,0.995494226978316,7121,7083
17,14304,10,100,0.0001,0.01,0.992,0.9949664429530202,7164,7140
17,14404,10,100,0.0001,0.01,0.988,0.9981949458483754,7207,7197
17,14504,10,100,0.0001,0.01,0.992,0.9996552675124104,7262,7242
17,14604,10,100,0.0001,0.01,0.988,0.997329498767461,7313,7291
17,14704,10,100,0.0001,0.01,0.998,0.9993199129488575,7363,7341
17,14804,10,100,0.0001,0.01,0.996,0.999864901378006,7412,7392
17,14904,10,100,0.0001,0.01,0.996,0.9999329039184112,7458,7446
17,15004,10,100,0.0001,0.01,0.994,0.9997334044254865,7505,7499
18,104,10,100,0.0001,0.01,0.494,0.7307692307692307,54,50
18,204,10,100,0.0001,0.01,0.492,0.5392156862745098,100,104
18,304,10,100,0.0001,0.01,0.532,0.6052631578947368,147,157
18,404,10,100,0.0001,0.01,0.536,0.599009900990099,203,201
18,504,10,100,0.0001,0.01,0.498,0.5833333333333334,242,262
18,604,10,100,0.0001,0.01,0.512,0.6009933774834437,304,300
18,704,10,100,0.0001,0.01,0.508,0.59375,360,344
18,804,10,100,0.0001,0.01,0.49,0.6305970149253731,413,391
18,904,10,100,0.0001,0.01,0.488,0.5851769911504425,463,441
18,1004,10,100,0.0001,0.01,0.5,0.6354581673306773,518,486
18,1104,10,100,0.0001,0.01,0.51,0.6195652173913043,573,531
18,1204,10,100,0.0001,0.01,0.528,0.6453488372093024,626,578
18,1304,10,100,0.0001,0.01,0.54,0.6648773006134969,669,635
18,1404,10,100,0.0001,0.01,0.546,0.6965811965811965,719,685
18,1504,10,100,0.0001,0.01,0.546,0.7167553191489362,769,735
18,1604,10,100,0.0001,0.01,0.552,0.6889027431421446,816,788
18,1704,10,100,0.0001,0.01,0.566,0.7406103286384976,862,842
18,1804,10,100,0.0001,0.01,0.582,0.7627494456762749,912,892
18,1904,10,100,0.0001,0.01,0.634,0.7773109243697479,963,941
18,2004,10,100,0.0001,0.01,0.606,0.7954091816367266,1008,996
18,2104,10,100,0.0001,0.01,0.628,0.7984790874524715,1049,1055
18,2204,10,100,0.0001,0.01,0.642,0.8262250453720508,1098,1106
18,2304,10,100,0.0001,0.01,0.668,0.8190104166666666,1144,1160
18,2404,10,100,0.0001,0.01,0.692,0.8760399334442596,1189,1215
18,2504,10,100,0.0001,0.01,0.694,0.8793929712460063,1246,1258
18,2604,10,100,0.0001,0.01,0.726,0.8963133640552995,1295,1309
18,2704,10,100,0.0001,0.01,0.756,0.9101331360946746,1343,1361
18,2804,10,100,0.0001,0.01,0.766,0.9286733238231099,1391,1413
18,2904,10,100,0.0001,0.01,0.794,0.9338842975206612,1435,1469
18,3004,10,100,0.0001,0.01,0.748,0.9067909454061251,1488,1516
18,3104,10,100,0.0001,0.01,0.766,0.8885309278350515,1539,1565
18,3204,10,100,0.0001,0.01,0.798,0.9282147315855181,1589,1615
18,3304,10,100,0.0001,0.01,0.776,0.9358353510895884,1631,1673
18,3404,10,100,0.0001,0.01,0.806,0.9524089306698003,1681,1723
18,3504,10,100,0.0001,0.01,0.84,0.9731735159817352,1722,1782
18,3604,10,100,0.0001,0.01,0.834,0.9747502774694784,1777,1827
18,3704,10,100,0.0001,0.01,0.812,0.9605831533477321,1832,1872
18,3804,10,100,0.0001,0.01,0.866,0.9713459516298633,1882,1922
18,3904,10,100,0.0001,0.01,0.862,0.9859118852459017,1925,1979
18,4004,10,100,0.0001,0.01,0.864,0.9790209790209791,1982,2022
18,4104,10,100,0.0001,0.01,0.882,0.9707602339181286,2035,2069
18,4204,10,100,0.0001,0.01,0.828,0.9393434823977165,2090,2114
18,4304,10,100,0.0001,0.01,0.826,0.9330855018587361,2135,2169
18,4404,10,100,0.0001,0.01,0.846,0.9584468664850136,2182,2222
18,4504,10,100,0.0001,0.01,0.87,0.9813499111900533,2237,2267
18,4604,10,100,0.0001,0.01,0.88,0.9776281494352737,2286,2318
18,4704,10,100,0.0001,0.01,0.89,0.9893707482993197,2337,2367
18,4804,10,100,0.0001,0.01,0.896,0.9870940882597835,2382,2422
18,4904,10,100,0.0001,0.01,0.874,0.9828711256117455,2435,2469
18,5004,10,100,0.0001,0.01,0.868,0.9704236610711431,2486,2518
18,5104,10,100,0.0001,0.01,0.91,0.9900078369905956,2545,2559
18,5204,10,100,0.0001,0.01,0.878,0.9759800153727901,2599,2605
18,5304,10,100,0.0001,0.01,0.904,0.9903846153846154,2644,2660
18,5404,10,100,0.0001,0.01,0.914,0.9927831236121392,2691,2713
18,5504,10,100,0.0001,0.01,0.908,0.997093023255814,2735,2769
18,5604,10,100,0.0001,0.01,0.918,0.9926837972876517,2780,2824
18,5704,10,100,0.0001,0.01,0.906,0.9903576437587658,2833,2871
18,5804,10,100,0.0001,0.01,0.916,0.9937973811164714,2891,2913
18,5904,10,100,0.0001,0.01,0.924,0.989159891598916,2941,2963
18,6004,10,100,0.0001,0.01,0.884,0.9635243171219188,2990,3014
18,6104,10,100,0.0001,0.01,0.932,0.9927916120576671,3041,3063
18,6204,10,100,0.0001,0.01,0.924,0.9916183107672469,3090,3114
18,6304,10,100,0.0001,0.01,0.914,0.9950824873096447,3139,3165
18,6404,10,100,0.0001,0.01,0.922,0.9940662086196127,3194,3210
18,6504,10,100,0.0001,0.01,0.916,0.9843173431734318,3246,3258
18,6604,10,100,0.0001,0.01,0.922,0.9839491217443973,3298,3306
18,6704,10,100,0.0001,0.01,0.914,0.9706145584725537,3351,3353
18,6804,10,100,0.0001,0.01,0.906,0.9707524985302763,3402,3402
18,6904,10,100,0.0001,0.01,0.934,0.9772595596755504,3454,3450
18,7004,10,100,0.0001,0.01,0.924,0.9874357509994289,3501,3503
18,7104,10,100,0.0001,0.01,0.944,0.9938063063063063,3545,3559
18,7204,10,100,0.0001,0.01,0.944,0.9962520821765686,3589,3615
18,7304,10,100,0.0001,0.01,0.95,0.9938389923329682,3631,3673
18,7404,10,100,0.0001,0.01,0.946,0.9928417071853053,3671,3733
18,7504,10,100,0.0001,0.01,0.948,0.9945362473347548,3720,3784
18,7604,10,100,0.0001,0.01,0.956,0.9969752761704366,3771,3833
18,7704,10,100,0.0001,0.01,0.96,0.9981827622014537,3828,3876
18,7804,10,100,0.0001,0.01,0.964,0.996155817529472,3883,3921
18,7904,10,100,0.0001,0.01,0.948,0.9864625506072875,3930,3974
18,8004,10,100,0.0001,0.01,0.938,0.9868815592203898,3978,4026
18,8104,10,100,0.0001,0.01,0.956,0.9890177690029615,4026,4078
18,8204,10,100,0.0001,0.01,0.958,0.9912237932715748,4080,4124
18,8304,10,100,0.0001,0.01,0.938,0.9857899807321773,4132,4172
18,8404,10,100,0.0001,0.01,0.964,0.9935744883388863,4175,4229
18,8504,10,100,0.0001,0.01,0.97,0.9951787394167451,4235,4269
18,8604,10,100,0.0001,0.01,0.96,0.996048349604835,4284,4320
18,8704,10,100,0.0001,0.01,0.964,0.9970128676470589,4331,4373
18,8804,10,100,0.0001,0.01,0.968,0.9973875511131304,4374,4430
18,8904,10,100,0.0001,0.01,0.96,0.9852875112309074,4420,4484
18,9004,10,100,0.0001,0.01,0.968,0.9913371834740116,4467,4537
18,9104,10,100,0.0001,0.01,0.97,0.9950571177504394,4525,4579
18,9204,10,100,0.0001,0.01,0.966,0.9956540634506736,4579,4625
18,9304,10,100,0.0001,0.01,0.98,0.9969905417024936,4636,4668
18,9404,10,100,0.0001,0.01,0.974,0.9984049340706083,4684,4720
18,9504,10,100,0.0001,0.01,0.974,0.9982112794612794,4732,4772
18,9604,10,100,0.0001,0.01,0.97,0.9976051645147855,4782,4822
18,9704,10,100,0.0001,0.01,0.97,0.997320692497939,4826,4878
18,9804,10,100,0.0001,0.01,0.964,0.9908200734394125,4873,4931
18,9904,10,100,0.0001,0.01,0.972,0.9939418416801292,4917,4987
18,10004,10,100,0.0001,0.01,0.972,0.9954018392642943,4970,5034
18,10104,10,100,0.0001,0.01,0.974,0.9969319081551861,5024,5080
18,10204,10,100,0.0001,0.01,0.976,0.9950999607996864,5076,5128
18,10304,10,100,0.0001,0.01,0.976,0.9969914596273292,5125,5179
18,10404,10,100,0.0001,0.01,0.962,0.9926951172625913,5171,5233
18,10504,10,100,0.0001,0.01,0.966,0.9929550647372429,5219,5285
18,10604,10,100,0.0001,0.01,0.972,0.9960392304790645,5266,5338
18,10704,10,100,0.0001,0.01,0.97,0.991685351270553,5321,5383
18,10804,10,100,0.0001,0.01,0.964,0.9875046279155868,5364,5440
18,10904,10,100,0.0001,0.01,0.98,0.9944974321349963,5411,5493
18,11004,10,100,0.0001,0.01,0.974,0.9963649581970193,5458,5546
18,11104,10,100,0.0001,0.01,0.98,0.9960374639769453,5509,5595
18,11204,10,100,0.0001,0.01,0.962,0.985540878257765,5563,5641
18,11304,10,100,0.0001,0.01,0.968,0.9961075725406936,5620,5684
18,11404,10,100,0.0001,0.01,0.978,0.9977200982111539,5671,5733
18,11504,10,100,0.0001,0.01,0.976,0.993480528511822,5730,5774
18,11604,10,100,0.0001,0.01,0.982,0.9979317476732161,5776,5828
18,11704,10,100,0.0001,0.01,0.964,0.9923957621326043,5829,5875
18,11804,10,100,0.0001,0.01,0.972,0.9955099966113182,5874,5930
18,11904,10,100,0.0001,0.01,0.972,0.9950436827956989,5926,5978
18,12004,10,100,0.0001,0.01,0.968,0.9882539153615462,5980,6024
18,12104,10,100,0.0001,0.01,0.972,0.9911599471249174,6029,6075
18,12204,10,100,0.0001,0.01,0.976,0.9952474598492298,6068,6136
18,12304,10,100,0.0001,0.01,0.968,0.996261378413524,6118,6186
18,12404,10,100,0.0001,0.01,0.986,0.9984682360528861,6165,6239
18,12504,10,100,0.0001,0.01,0.99,0.9987204094689699,6211,6293
18,12604,10,100,0.0001,0.01,0.992,0.9996033005395113,6258,6346
18,12704,10,100,0.0001,0.01,0.99,0.9989767002518891,6307,6397
18,12804,10,100,0.0001,0.01,0.99,0.999687597625742,6355,6449
18,12904,10,100,0.0001,0.01,0.99,0.9993025418474891,6405,6499
18,13004,10,100,0.0001,0.01,0.988,0.9997693017533067,6457,6547
18,13104,10,100,0.0001,0.01,0.982,0.9978632478632479,6506,6598
18,13204,10,100,0.0001,0.01,0.986,0.9981066343532263,6564,6640
18,13304,10,100,0.0001,0.01,0.98,0.9931599518941672,6617,6687
18,13404,10,100,0.0001,0.01,0.962,0.9856759176365264,6666,6738
18,13504,10,100,0.0001,0.01,0.978,0.9921504739336493,6715,6789
18,13604,10,100,0.0001,0.01,0.986,0.9983828285798294,6768,6836
18,13704,10,100,0.0001,0.01,0.99,0.9993432574430823,6830,6874
18,13804,10,100,0.0001,0.01,0.99,0.9999275572297884,6881,6923
18,13904,10,100,0.0001,0.01,0.99,1.0,6918,6986
18,14004,10,100,0.0001,0.01,0.988,1.0,6965,7039
18,14104,10,100,0.0001,0.01,0.99,1.0,7025,7079
18,14204,10,100,0.0001,0.01,0.986,0.9990143621515066,7074,7130
18,14304,10,100,0.0001,0.01,0.986,0.9967841163310962,7130,7174
18,14404,10,100,0.0001,0.01,0.93,0.9470286031657873,7181,7223
18,14504,10,100,0.0001,0.01,0.984,0.992484831770546,7234,7270
18,14604,10,100,0.0001,0.01,0.988,0.997329498767461,7288,7316
18,14704,10,100,0.0001,0.01,0.99,0.9984357997823722,7346,7358
18,14804,10,100,0.0001,0.01,0.99,0.9994596055120237,7393,7411
18,14904,10,100,0.0001,0.01,0.99,0.9998658078368223,7450,7454
18,15004,10,100,0.0001,0.01,0.99,0.9996667555318581,7499,7505
19,104,10,100,0.0001,0.01,0.528,0.5384615384615384,56,48
19,204,10,100,0.0001,0.01,0.472,0.5343137254901961,101,103
19,304,10,100,0.0001,0.01,0.468,0.5361842105263158,156,148
19,404,10,100,0.0001,0.01,0.526,0.5866336633663366,207,197
19,504,10,100,0.0001,0.01,0.518,0.6111111111111112,248,256
19,604,10,100,0.0001,0.01,0.504,0.6109271523178808,303,301
19,704,10,100,0.0001,0.01,0.508,0.6051136363636364,353,351
19,804,10,100,0.0001,0.01,0.502,0.6467661691542289,405,399
19,904,10,100,0.0001,0.01,0.488,0.6316371681415929,448,456
19,1004,10,100,0.0001,0.01,0.498,0.648406374501992,496,508
19,1104,10,100,0.0001,0.01,0.498,0.6639492753623188,547,557
19,1204,10,100,0.0001,0.01,0.486,0.6677740863787376,597,607
19,1304,10,100,0.0001,0.01,0.494,0.6503067484662577,649,655
19,1404,10,100,0.0001,0.01,0.476,0.6695156695156695,696,708
19,1504,10,100,0.0001,0.01,0.5,0.6602393617021277,742,762
19,1604,10,100,0.0001,0.01,0.486,0.6882793017456359,788,816
19,1704,10,100,0.0001,0.01,0.49,0.6795774647887324,836,868
19,1804,10,100,0.0001,0.01,0.516,0.7039911308203991,887,917
19,1904,10,100,0.0001,0.01,0.52,0.7090336134453782,939,965
19,2004,10,100,0.0001,0.01,0.522,0.7460079840319361,988,1016
19,2104,10,100,0.0001,0.01,0.5,0.7480988593155894,1042,1062
19,2204,10,100,0.0001,0.01,0.522,0.7509074410163339,1087,1117
19,2304,10,100,0.0001,0.01,0.5,0.7287326388888888,1138,1166
19,2404,10,100,0.0001,0.01,0.558,0.7920133111480865,1184,1220
19,2504,10,100,0.0001,0.01,0.528,0.7643769968051118,1241,1263
19,2604,10,100,0.0001,0.01,0.548,0.7707373271889401,1291,1313
19,2704,10,100,0.0001,0.01,0.612,0.7843934911242604,1341,1363
19,2804,10,100,0.0001,0.01,0.542,0.8084878744650499,1396,1408
19,2904,10,100,0.0001,0.01,0.594,0.8443526170798898,1443,1461
19,3004,10,100,0.0001,0.01,0.59,0.8485352862849534,1495,1509
19,3104,10,100,0.0001,0.01,0.594,0.7638530927835051,1540,1564
19,3204,10,100,0.0001,0.01,0.598,0.8121098626716604,1592,1612
19,3304,10,100,0.0001,0.01,0.608,0.8241525423728814,1643,1661
19,3404,10,100,0.0001,0.01,0.666,0.8199177438307873,1690,1714
19,3504,10,100,0.0001,0.01,0.66,0.8301940639269406,1745,1759
19,3604,10,100,0.0001,0.01,0.676,0.8670921198668147,1798,1806
19,3704,10,100,0.0001,0.01,0.69,0.8776997840172787,1856,1848
19,3804,10,100,0.0001,0.01,0.706,0.8943217665615142,1903,1901
19,3904,10,100,0.0001,0.01,0.7,0.8957479508196722,1949,1955
19,4004,10,100,0.0001,0.01,0.714,0.9065934065934066,1991,2013
19,4104,10,100,0.0001,0.01,0.696,0.8754873294346979,2050,2054
19,4204,10,100,0.0001,0.01,0.716,0.8939105613701237,2101,2103
19,4304,10,100,0.0001,0.01,0.706,0.9012546468401487,2150,2154
19,4404,10,100,0.0001,0.01,0.724,0.9182561307901907,2199,2205
19,4504,10,100,0.0001,0.01,0.758,0.9302841918294849,2251,2253
19,4604,10,100,0.0001,0.01,0.73,0.9220243266724587,2299,2305
19,4704,10,100,0.0001,0.01,0.778,0.9124149659863946,2352,2352
19,4804,10,100,0.0001,0.01,0.752,0.9171523730224813,2396,2408
19,4904,10,100,0.0001,0.01,0.776,0.9396411092985318,2442,2462
19,5004,10,100,0.0001,0.01,0.748,0.9320543565147882,2489,2515
19,5104,10,100,0.0001,0.01,0.756,0.9139890282131662,2545,2559
19,5204,10,100,0.0001,0.01,0.748,0.9385088393543428,2588,2616
19,5304,10,100,0.0001,0.01,0.778,0.9551282051282052,2645,2659
19,5404,10,100,0.0001,0.01,0.794,0.9631754256106587,2697,2707
19,5504,10,100,0.0001,0.01,0.788,0.9662063953488372,2754,2750
19,5604,10,100,0.0001,0.01,0.774,0.9566381156316917,2801,2803
19,5704,10,100,0.0001,0.01,0.79,0.9526647966339411,2852,2852
19,5804,10,100,0.0001,0.01,0.766,0.9508959338387319,2904,2900
19,5904,10,100,0.0001,0.01,0.756,0.9258130081300813,2965,2939
19,6004,10,100,0.0001,0.01,0.796,0.9475349766822119,3015,2989
19,6104,10,100,0.0001,0.01,0.816,0.9608453473132372,3072,3032
19,6204,10,100,0.0001,0.01,0.834,0.9690522243713733,3124,3080
19,6304,10,100,0.0001,0.01,0.85,0.9746192893401016,3175,3129
19,6404,10,100,0.0001,0.01,0.836,0.9761086820737039,3213,3191
19,6504,10,100,0.0001,0.01,0.838,0.9709409594095941,3264,3240
19,6604,10,100,0.0001,0.01,0.85,0.9800121138703816,3322,3282
19,6704,10,100,0.0001,0.01,0.838,0.9694212410501193,3368,3336
19,6804,10,100,0.0001,0.01,0.818,0.9698706643151087,3417,3387
19,6904,10,100,0.0001,0.01,0.828,0.9630648899188876,3475,3429
19,7004,10,100,0.0001,0.01,0.84,0.9623072529982867,3523,3481
19,7104,10,100,0.0001,0.01,0.83,0.9625563063063063,3569,3535
19,7204,10,100,0.0001,0.01,0.866,0.9784841754580789,3622,3582
19,7304,10,100,0.0001,0.01,0.846,0.973986856516977,3674,3630
19,7404,10,100,0.0001,0.01,0.85,0.9747433819556997,3726,3678
19,7504,10,100,0.0001,0.01,0.856,0.9800106609808102,3775,3729
19,7604,10,100,0.0001,0.01,0.87,0.9775118358758548,3830,3774
19,7704,10,100,0.0001,0.01,0.878,0.9775441329179647,3885,3819
19,7804,10,100,0.0001,0.01,0.864,0.9774474628395694,3929,3875
19,7904,10,100,0.0001,0.01,0.878,0.9806427125506073,3977,3927
19,8004,10,100,0.0001,0.01,0.87,0.9780109945027486,4026,3978
19,8104,10,100,0.0001,0.01,0.874,0.9761846001974334,4076,4028
19,8204,10,100,0.0001,0.01,0.852,0.9712335446123842,4118,4086
19,8304,10,100,0.0001,0.01,0.854,0.9726637764932563,4162,4142
19,8404,10,100,0.0001,0.01,0.892,0.9826273203236554,4221,4183
19,8504,10,100,0.0001,0.01,0.85,0.952140169332079,4270,4234
19,8604,10,100,0.0001,0.01,0.874,0.9730357973035797,4318,4286
19,8704,10,100,0.0001,0.01,0.892,0.9788602941176471,4367,4337
19,8804,10,100,0.0001,0.01,0.898,0.9863698318945934,4419,4385
19,8904,10,100,0.0001,0.01,0.926,0.9898921832884097,4463,4441
19,9004,10,100,0.0001,0.01,0.91,0.9840071079520213,4513,4491
19,9104,10,100,0.0001,0.01,0.896,0.9537565905096661,4570,4534
19,9204,10,100,0.0001,0.01,0.906,0.9709908735332464,4615,4589
19,9304,10,100,0.0001,0.01,0.886,0.94701203783319,4661,4643
19,9404,10,100,0.0001,0.01,0.914,0.9737345810293492,4706,4698
19,9504,10,100,0.0001,0.01,0.924,0.9789562289562289,4752,4752
19,9604,10,100,0.0001,0.01,0.93,0.9758433985839233,4808,4796
19,9704,10,100,0.0001,0.01,0.934,0.9918590272052762,4858,4846
19,9804,10,100,0.0001,0.01,0.934,0.9883720930232558,4905,4899
19,9904,10,100,0.0001,0.01,0.92,0.9831381260096931,4955,4949
19,10004,10,100,0.0001,0.01,0.936,0.9926029588164734,5009,4995
19,10104,10,100,0.0001,0.01,0.918,0.9860451306413301,5051,5053
19,10204,10,100,0.0001,0.01,0.936,0.9898079184633477,5100,5104
19,10304,10,100,0.0001,0.01,0.934,0.9940799689440993,5154,5150
19,10404,10,100,0.0001,0.01,0.936,0.9934640522875817,5200,5204
19,10504,10,100,0.0001,0.01,0.948,0.9959063214013709,5253,5251
19,10604,10,100,0.0001,0.01,0.934,0.9876461712561297,5304,5300
19,10704,10,100,0.0001,0.01,0.932,0.9914050822122571,5352,5352
19,10804,10,100,0.0001,0.01,0.926,0.9901888189559422,5402,5402
19,10904,10,100,0.0001,0.01,0.938,0.9897285399853265,5454,5450
19,11004,10,100,0.0001,0.01,0.936,0.990003635041803,5509,5495
19,11104,10,100,0.0001,0.01,0.94,0.9813580691642652,5562,5542
19,11204,10,100,0.0001,0.01,0.946,0.9866119243127455,5614,5590
19,11304,10,100,0.0001,0.01,0.96,0.9920382165605095,5650,5654
19,11404,10,100,0.0001,0.01,0.958,0.9934233602244826,5698,5706
19,11504,10,100,0.0001,0.01,0.952,0.9951321279554938,5749,5755
19,11604,10,100,0.0001,0.01,0.954,0.9974146845915202,5804,5800
19,11704,10,100,0.0001,0.01,0.96,0.994958988380041,5856,5848
19,11804,10,100,0.0001,0.01,0.944,0.9899186716367333,5918,5886
19,11904,10,100,0.0001,0.01,0.96,0.9925235215053764,5971,5933
19,12004,10,100,0.0001,0.01,0.95,0.9908363878707097,6017,5987
19,12104,10,100,0.0001,0.01,0.94,0.9846331791143423,6061,6043
19,12204,10,100,0.0001,0.01,0.942,0.9818092428711898,6106,6098
19,12304,10,100,0.0001,0.01,0.96,0.9949609882964889,6159,6145
19,12404,10,100,0.0001,0.01,0.958,0.9941148016768784,6205,6199
19,12504,10,100,0.0001,0.01,0.96,0.9895233525271913,6253,6251
19,12604,10,100,0.0001,0.01,0.966,0.9942875277689622,6306,6298
19,12704,10,100,0.0001,0.01,0.964,0.9950409319899244,6359,6345
19,12804,10,100,0.0001,0.01,0.97,0.996641674476726,6409,6395
19,12904,10,100,0.0001,0.01,0.958,0.9942653440793552,6467,6437
19,13004,10,100,0.0001,0.01,0.964,0.9972316210396801,6511,6493
19,13104,10,100,0.0001,0.01,0.968,0.9983974358974359,6556,6548
19,13204,10,100,0.0001,0.01,0.956,0.9952287185701303,6605,6599
19,13304,10,100,0.0001,0.01,0.948,0.9853427540589297,6664,6640
19,13404,10,100,0.0001,0.01,0.97,0.9936586093703372,6717,6687
19,13504,10,100,0.0001,0.01,0.968,0.9948904028436019,6765,6739
19,13604,10,100,0.0001,0.01,0.968,0.9968391649514848,6806,6798
19,13704,10,100,0.0001,0.01,0.98,0.9981757151196731,6859,6845
19,13804,10,100,0.0001,0.01,0.976,0.997681831353231,6907,6897
19,13904,10,100,0.0001,0.01,0.972,0.9982019562715765,6963,6941
19,14004,10,100,0.0001,0.01,0.972,0.9977863467580691,7006,6998
19,14104,10,100,0.0001,0.01,0.972,0.9971639251276234,7056,7048
19,14204,10,100,0.0001,0.01,0.966,0.9890171782596452,7105,7099
19,14304,10,100,0.0001,0.01,0.956,0.9886744966442953,7150,7154
19,14404,10,100,0.0001,0.01,0.956,0.9876423215773397,7190,7214
19,14504,10,100,0.0001,0.01,0.968,0.9955874241588527,7238,7266
19,14604,10,100,0.0001,0.01,0.978,0.9966447548616817,7292,7312
19,14704,10,100,0.0001,0.01,0.974,0.9964635473340587,7339,7365
19,14804,10,100,0.0001,0.01,0.972,0.9966225344501486,7388,7416
19,14904,10,100,0.0001,0.01,0.98,0.996309715512614,7439,7465
19,15004,10,100,0.0001,0.01,0.976,0.9948680351906158,7486,7518
20,104,10,100,0.0001,0.01,0.468,0.5096153846153846,53,51
20,204,10,100,0.0001,0.01,0.472,0.6470588235294118,101,103
20,304,10,100,0.0001,0.01,0.496,0.5986842105263158,153,151
20,404,10,100,0.0001,0.01,0.48,0.6039603960396039,217,187
20,504,10,100,0.0001,0.01,0.482,0.5714285714285714,263,241
20,604,10,100,0.0001,0.01,0.478,0.6241721854304636,314,290
20,704,10,100,0.0001,0.01,0.482,0.6349431818181818,358,346
20,804,10,100,0.0001,0.01,0.486,0.6380597014925373,402,402
20,904,10,100,0.0001,0.01,0.506,0.6415929203539823,451,453
20,1004,10,100,0.0001,0.01,0.464,0.6822709163346613,504,500
20,1104,10,100,0.0001,0.01,0.502,0.667572463768116,554,550
20,1204,10,100,0.0001,0.01,0.498,0.6794019933554817,596,608
20,1304,10,100,0.0001,0.01,0.484,0.6940184049079755,643,661
20,1404,10,100,0.0001,0.01,0.54,0.6937321937321937,688,716
20,1504,10,100,0.0001,0.01,0.5,0.6615691489361702,725,779
20,1604,10,100,0.0001,0.01,0.534,0.7300498753117207,776,828
20,1704,10,100,0.0001,0.01,0.536,0.7083333333333334,830,874
20,1804,10,100,0.0001,0.01,0.556,0.7400221729490022,877,927
20,1904,10,100,0.0001,0.01,0.528,0.7542016806722689,926,978
20,2004,10,100,0.0001,0.01,0.534,0.7475049900199601,974,1030
20,2104,10,100,0.0001,0.01,0.532,0.7637832699619772,1029,1075
20,2204,10,100,0.0001,0.01,0.57,0.7627041742286751,1074,1130
20,2304,10,100,0.0001,0.01,0.552,0.7439236111111112,1119,1185
20,2404,10,100,0.0001,0.01,0.6,0.8019966722129783,1173,1231
20,2504,10,100,0.0001,0.01,0.596,0.8166932907348243,1228,1276
20,2604,10,100,0.0001,0.01,0.618,0.8394777265745008,1282,1322
20,2704,10,100,0.0001,0.01,0.616,0.8579881656804734,1333,1371
20,2804,10,100,0.0001,0.01,0.628,0.8676890156918687,1381,1423
20,2904,10,100,0.0001,0.01,0.646,0.8891184573002755,1432,1472
20,3004,10,100,0.0001,0.01,0.638,0.8794940079893475,1484,1520
20,3104,10,100,0.0001,0.01,0.692,0.9049613402061856,1530,1574
20,3204,10,100,0.0001,0.01,0.674,0.8845193508114857,1588,1616
20,3304,10,100,0.0001,0.01,0.68,0.8734866828087167,1637,1667
20,3404,10,100,0.0001,0.01,0.662,0.9077555816686251,1696,1708
20,3504,10,100,0.0001,0.01,0.72,0.9346461187214612,1745,1759
20,3604,10,100,0.0001,0.01,0.724,0.9109322974472808,1797,1807
20,3704,10,100,0.0001,0.01,0.754,0.9406047516198704,1848,1856
20,3804,10,100,0.0001,0.01,0.736,0.9192954784437434,1893,1911
20,3904,10,100,0.0001,0.01,0.754,0.9336577868852459,1942,1962
20,4004,10,100,0.0001,0.01,0.748,0.939060939060939,1991,2013
20,4104,10,100,0.0001,0.01,0.782,0.9534600389863548,2038,2066
20,4204,10,100,0.0001,0.01,0.794,0.9467174119885823,2087,2117
20,4304,10,100,0.0001,0.01,0.772,0.9642193308550185,2138,2166
20,4404,10,100,0.0001,0.01,0.766,0.9130336058128974,2190,2214
20,4504,10,100,0.0001,0.01,0.742,0.8510213143872114,2241,2263
20,4604,10,100,0.0001,0.01,0.764,0.9083405734144222,2295,2309
20,4704,10,100,0.0001,0.01,0.786,0.907312925170068,2343,2361
20,4804,10,100,0.0001,0.01,0.81,0.9333888426311407,2390,2414
20,4904,10,100,0.0001,0.01,0.814,0.9494290375203915,2439,2465
20,5004,10,100,0.0001,0.01,0.81,0.9508393285371702,2487,2517
20,5104,10,100,0.0001,0.01,0.828,0.9606191222570533,2541,2563
20,5204,10,100,0.0001,0.01,0.806,0.9461952344350499,2583,2621
20,5304,10,100,0.0001,0.01,0.786,0.9389140271493213,2632,2672
20,5404,10,100,0.0001,0.01,0.82,0.9548482605477424,2688,2716
20,5504,10,100,0.0001,0.01,0.848,0.9498546511627907,2738,2766
20,5604,10,100,0.0001,0.01,0.818,0.9603854389721628,2794,2810
20,5704,10,100,0.0001,0.01,0.84,0.960203366058906,2848,2856
20,5804,10,100,0.0001,0.01,0.83,0.9650241212956582,2901,2903
20,5904,10,100,0.0001,0.01,0.82,0.9735772357723578,2959,2945
20,6004,10,100,0.0001,0.01,0.836,0.9743504330446369,3007,2997
20,6104,10,100,0.0001,0.01,0.852,0.9819790301441678,3053,3051
20,6204,10,100,0.0001,0.01,0.846,0.9822695035460993,3097,3107
20,6304,10,100,0.0001,0.01,0.85,0.9750951776649747,3146,3158
20,6404,10,100,0.0001,0.01,0.836,0.9740787008119925,3202,3202
20,6504,10,100,0.0001,0.01,0.834,0.9572570725707257,3250,3254
20,6604,10,100,0.0001,0.01,0.854,0.976832222895215,3299,3305
20,6704,10,100,0.0001,0.01,0.852,0.9800119331742243,3350,3354
20,6804,10,100,0.0001,0.01,0.87,0.9779541446208113,3410,3394
20,6904,10,100,0.0001,0.01,0.85,0.9556778679026651,3451,3453
20,7004,10,100,0.0001,0.01,0.874,0.9714448886350657,3496,3508
20,7104,10,100,0.0001,0.01,0.878,0.9724099099099099,3548,3556
20,7204,10,100,0.0001,0.01,0.856,0.9802887284841755,3594,3610
20,7304,10,100,0.0001,0.01,0.882,0.981106243154436,3643,3661
20,7404,10,100,0.0001,0.01,0.89,0.9805510534846029,3688,3716
20,7504,10,100,0.0001,0.01,0.9,0.9850746268656716,3739,3765
20,7604,10,100,0.0001,0.01,0.9,0.9903997895844292,3800,3804
20,7704,10,100,0.0001,0.01,0.894,0.9846832814122534,3859,3845
20,7804,10,100,0.0001,0.01,0.898,0.975781650435674,3902,3902
20,7904,10,100,0.0001,0.01,0.888,0.9874746963562753,3961,3943
20,8004,10,100,0.0001,0.01,0.898,0.9857571214392804,4014,3990
20,8104,10,100,0.0001,0.01,0.912,0.9917324777887463,4063,4041
20,8204,10,100,0.0001,0.01,0.902,0.9781813749390541,4107,4097
20,8304,10,100,0.0001,0.01,0.906,0.9872350674373795,4149,4155
20,8404,10,100,0.0001,0.01,0.902,0.973465016658734,4196,4208
20,8504,10,100,0.0001,0.01,0.9,0.9800094073377235,4246,4258
20,8604,10,100,0.0001,0.01,0.896,0.9696652719665272,4297,4307
20,8704,10,100,0.0001,0.01,0.906,0.9775965073529411,4347,4357
20,8804,10,100,0.0001,0.01,0.898,0.9776238073602908,4398,4406
20,8904,10,100,0.0001,0.01,0.924,0.9900044923629829,4456,4448
20,9004,10,100,0.0001,0.01,0.924,0.9856730342070191,4499,4505
20,9104,10,100,0.0001,0.01,0.902,0.9892355008787346,4551,4553
20,9204,10,100,0.0001,0.01,0.918,0.9880486744893524,4614,4590
20,9304,10,100,0.0001,0.01,0.928,0.9862424763542562,4663,4641
20,9404,10,100,0.0001,0.01,0.926,0.9907486176095278,4713,4691
20,9504,10,100,0.0001,0.01,0.926,0.9877946127946128,4765,4739
20,9604,10,100,0.0001,0.01,0.93,0.9886505622657226,4811,4793
20,9704,10,100,0.0001,0.01,0.936,0.9893858202802968,4864,4840
20,9804,10,100,0.0001,0.01,0.924,0.988984088127295,4907,4897
20,9904,10,100,0.0001,0.01,0.948,0.9888933764135702,4953,4951
20,10004,10,100,0.0001,0.01,0.952,0.9945021991203519,5011,4993
20,10104,10,100,0.0001,0.01,0.932,0.9828780680918449,5052,5052
20,10204,10,100,0.0001,0.01,0.938,0.976577812622501,5098,5106
20,10304,10,100,0.0001,0.01,0.912,0.9740877329192547,5146,5158
20,10404,10,100,0.0001,0.01,0.95,0.9874086889657824,5200,5204
20,10504,10,100,0.0001,0.01,0.944,0.9922886519421172,5251,5253
20,10604,10,100,0.0001,0.01,0.954,0.9912297246322143,5297,5307
20,10704,10,100,0.0001,0.01,0.954,0.9892563527653214,5349,5355
20,10804,10,100,0.0001,0.01,0.952,0.9921325435024065,5402,5402
20,10904,10,100,0.0001,0.01,0.95,0.992571533382245,5450,5454
20,11004,10,100,0.0001,0.01,0.968,0.995456197746274,5495,5509
20,11104,10,100,0.0001,0.01,0.952,0.9962175792507204,5543,5561
20,11204,10,100,0.0001,0.01,0.96,0.9936629775080329,5590,5614
20,11304,10,100,0.0001,0.01,0.962,0.9969037508846426,5642,5662
20,11404,10,100,0.0001,0.01,0.954,0.9864959663276044,5692,5712
20,11504,10,100,0.0001,0.01,0.96,0.9940020862308763,5757,5747
20,11604,10,100,0.0001,0.01,0.962,0.9899172699069286,5808,5796
20,11704,10,100,0.0001,0.01,0.972,0.9943609022556391,5857,5847
20,11804,10,100,0.0001,0.01,0.956,0.9811928159945781,5909,5895
20,11904,10,100,0.0001,0.01,0.964,0.9932795698924731,5961,5943
20,12004,10,100,0.0001,0.01,0.968,0.9936687770743086,6008,5996
20,12104,10,100,0.0001,0.01,0.97,0.9973562458691342,6066,6038
20,12204,10,100,0.0001,0.01,0.956,0.985414618157981,6112,6092
20,12304,10,100,0.0001,0.01,0.962,0.9748049414824448,6161,6143
20,12404,10,100,0.0001,0.01,0.968,0.9899226056110932,6216,6188
20,12504,10,100,0.0001,0.01,0.974,0.994321817018554,6267,6237
20,12604,10,100,0.0001,0.01,0.982,0.9975404633449698,6317,6287
20,12704,10,100,0.0001,0.01,0.982,0.9992915617128464,6368,6336
20,12804,10,100,0.0001,0.01,0.986,0.9995313964386129,6415,6389
20,12904,10,100,0.0001,0.01,0.984,0.9993800371977681,6469,6435
20,13004,10,100,0.0001,0.01,0.992,0.9999231005844356,6517,6487
20,13104,10,100,0.0001,0.01,0.992,0.9998473748473748,6570,6534
20,13204,10,100,0.0001,0.01,0.99,0.9993183883671615,6622,6582
20,13304,10,100,0.0001,0.01,0.988,0.9990228502705953,6669,6635
20,13404,10,100,0.0001,0.01,0.98,0.9970904207699194,6720,6684
20,13504,10,100,0.0001,0.01,0.966,0.9953347156398105,6766,6738
20,13604,10,100,0.0001,0.01,0.982,0.9940458688620993,6812,6792
20,13704,10,100,0.0001,0.01,0.972,0.9871570344424986,6856,6848
20,13804,10,100,0.0001,0.01,0.988,0.9948565633149812,6907,6897
20,13904,10,100,0.0001,0.01,0.982,0.9937428078250863,6961,6943
20,14004,10,100,0.0001,0.01,0.976,0.9935018566123964,7008,6996
20,14104,10,100,0.0001,0.01,0.988,0.9978020419739081,7058,7046
20,14204,10,100,0.0001,0.01,0.988,0.9957758377921713,7106,7098
20,14304,10,100,0.0001,0.01,0.99,0.9969938478747203,7161,7143
20,14404,10,100,0.0001,0.01,0.988,0.9917384059983338,7205,7199
20,14504,10,100,0.0001,0.01,0.978,0.9914506343077771,7262,7242
20,14604,10,100,0.0001,0.01,0.976,0.9948644207066557,7313,7291
20,14704,10,100,0.0001,0.01,0.988,0.9967355821545157,7369,7335
20,14804,10,100,0.0001,0.01,0.988,0.9980410699810862,7417,7387
20,14904,10,100,0.0001,0.01,0.99,0.999194847020934,7467,7437
20,15004,10,100,0.0001,0.01,0.986,0.9922687283391096,7518,7486
1,104,10,100,0.001,0.01,0.506,0.4519230769230769,47,57
1,204,10,100,0.001,0.01,0.5,0.7107843137254902,100,104
1,304,10,100,0.001,0.01,0.488,0.5822368421052632,146,158
1,404,10,100,0.001,0.01,0.504,0.6188118811881188,202,202
1,504,10,100,0.001,0.01,0.494,0.5734126984126984,258,246
1,604,10,100,0.001,0.01,0.49,0.640728476821192,305,299
1,704,10,100,0.001,0.01,0.51,0.5951704545454546,357,347
1,804,10,100,0.001,0.01,0.508,0.6131840796019901,411,393
1,904,10,100,0.001,0.01,0.488,0.6548672566371682,466,438
1,1004,10,100,0.001,0.01,0.472,0.651394422310757,518,486
1,1104,10,100,0.001,0.01,0.494,0.654891304347826,570,534
1,1204,10,100,0.001,0.01,0.482,0.6843853820598007,617,587
1,1304,10,100,0.001,0.01,0.512,0.6825153374233128,670,634
1,1404,10,100,0.001,0.01,0.53,0.698005698005698,717,687
1,1504,10,100,0.001,0.01,0.538,0.7021276595744681,779,725
1,1604,10,100,0.001,0.01,0.524,0.7175810473815462,833,771
1,1704,10,100,0.001,0.01,0.542,0.715962441314554,881,823
1,1804,10,100,0.001,0.01,0.578,0.7416851441241685,927,877
1,1904,10,100,0.001,0.01,0.576,0.7563025210084033,978,926
1,2004,10,100,0.001,0.01,0.588,0.7864271457085829,1016,988
1,2104,10,100,0.001,0.01,0.594,0.752851711026616,1063,1041
1,2204,10,100,0.001,0.01,0.582,0.7840290381125227,1117,1087
1,2304,10,100,0.001,0.01,0.612,0.7894965277777778,1177,1127
1,2404,10,100,0.001,0.01,0.646,0.8128119800332779,1232,1172
1,2504,10,100,0.001,0.01,0.608,0.7907348242811502,1286,1218
1,2604,10,100,0.001,0.01,0.628,0.8033794162826421,1341,1263
1,2704,10,100,0.001,0.01,0.668,0.8028846153846154,1395,1309
1,2804,10,100,0.001,0.01,0.69,0.8288159771754636,1438,1366
1,2904,10,100,0.001,0.01,0.7,0.8495179063360881,1490,1414
1,3004,10,100,0.001,0.01,0.694,0.8661784287616512,1538,1466
1,3104,10,100,0.001,0.01,0.714,0.854381443298969,1580,1524
1,3204,10,100,0.001,0.01,0.726,0.883270911360799,1626,1578
1,3304,10,100,0.001,0.01,0.73,0.8701573849878934,1668,1636
1,3404,10,100,0.001,0.01,0.77,0.9242068155111633,1724,1680
1,3504,10,100,0.001,0.01,0.784,0.930079908675799,1775,1729
1,3604,10,100,0.001,0.01,0.804,0.9353496115427303,1824,1780
1,3704,10,100,0.001,0.01,0.814,0.937634989200864,1874,1830
1,3804,10,100,0.001,0.01,0.816,0.9471608832807571,1927,1877
1,3904,10,100,0.001,0.01,0.828,0.9390368852459017,1979,1925
1,4004,10,100,0.001,0.01,0.858,0.9662837162837162,2034,1970
1,4104,10,100,0.001,0.01,0.886,0.97953216374269,2084,2020
1,4204,10,100,0.001,0.01,0.888,0.9833491912464319,2137,2067
1,4304,10,100,0.001,0.01,0.92,0.9911710037174721,2185,2119
1,4404,10,100,0.001,0.01,0.922,0.991371480472298,2237,2167
1,4504,10,100,0.001,0.01,0.93,0.9940053285968028,2276,2228
1,4604,10,100,0.001,0.01,0.928,0.9958731537793223,2319,2285
1,4704,10,100,0.001,0.01,0.916,0.9942602040816326,2370,2334
1,4804,10,100,0.001,0.01,0.934,0.9968776019983348,2408,2396
1,4904,10,100,0.001,0.01,0.912,0.9910277324632952,2453,2451
1,5004,10,100,0.001,0.01,0.938,0.9964028776978417,2507,2497
1,5104,10,100,0.001,0.01,0.938,0.997257053291536,2562,2542
1,5204,10,100,0.001,0.01,0.93,0.9934665641813989,2611,2593
1,5304,10,100,0.001,0.01,0.948,0.9947209653092006,2667,2637
1,5404,10,100,0.001,0.01,0.932,0.9909326424870466,2702,2702
1,5504,10,100,0.001,0.01,0.942,0.993640988372093,2753,2751
1,5604,10,100,0.001,0.01,0.916,0.9746609564596717,2800,2804
1,5704,10,100,0.001,0.01,0.936,0.9831697054698457,2851,2853
1,5804,10,100,0.001,0.01,0.916,0.9622674017918676,2909,2895
1,5904,10,100,0.001,0.01,0.922,0.9725609756097561,2959,2945
1,6004,10,100,0.001,0.01,0.946,0.9836775483011326,3011,2993
1,6104,10,100,0.001,0.01,0.958,0.9937745740498034,3057,3047
1,6204,10,100,0.001,0.01,0.97,0.9962927143778207,3106,3098
1,6304,10,100,0.001,0.01,0.962,0.9979378172588832,3163,3141
1,6404,10,100,0.001,0.01,0.97,0.9992192379762649,3216,3188
1,6504,10,100,0.001,0.01,0.97,0.9995387453874539,3271,3233
1,6604,10,100,0.001,0.01,0.976,0.9993943064809206,3321,3283
1,6704,10,100,0.001,0.01,0.97,0.9994033412887828,3372,3332
1,6804,10,100,0.001,0.01,0.976,0.9995590828924162,3426,3378
1,6904,10,100,0.001,0.01,0.97,0.9998551564310545,3476,3428
1,7004,10,100,0.001,0.01,0.972,0.9998572244431754,3524,3480
1,7104,10,100,0.001,0.01,0.974,1.0,3556,3548
1,7204,10,100,0.001,0.01,0.974,0.9998611882287618,3605,3599
1,7304,10,100,0.001,0.01,0.976,1.0,3650,3654
1,7404,10,100,0.001,0.01,0.978,0.998109130199892,3697,3707
1,7504,10,100,0.001,0.01,0.974,0.9984008528784648,3751,3753
1,7604,10,100,0.001,0.01,0.962,0.9951341399263546,3807,3797
1,7704,10,100,0.001,0.01,0.962,0.9896157840083074,3860,3844
1,7804,10,100,0.001,0.01,0.954,0.9873141978472578,3908,3896
1,7904,10,100,0.001,0.01,0.97,0.989245951417004,3965,3939
1,8004,10,100,0.001,0.01,0.978,0.9963768115942029,4008,3996
1,8104,10,100,0.001,0.01,0.976,0.9986426456071076,4067,4037
1,8204,10,100,0.001,0.01,0.972,0.9990248659190639,4110,4094
1,8304,10,100,0.001,0.01,0.98,0.9986753371868978,4162,4142
1,8404,10,100,0.001,0.01,0.98,0.9996430271299381,4211,4193
1,8504,10,100,0.001,0.01,0.986,0.9997648165569144,4258,4246
1,8604,10,100,0.001,0.01,0.98,0.998372849837285,4309,4295
1,8704,10,100,0.001,0.01,0.98,0.9996553308823529,4363,4341
1,8804,10,100,0.001,0.01,0.972,0.9975011358473421,4415,4389
1,8904,10,100,0.001,0.01,0.974,0.9943845462713388,4471,4433
1,9004,10,100,0.001,0.01,0.924,0.956796979120391,4518,4486
1,9104,10,100,0.001,0.01,0.934,0.9484841827768014,4571,4533
1,9204,10,100,0.001,0.01,0.958,0.9670795306388527,4620,4584
1,9304,10,100,0.001,0.01,0.974,0.9923688736027515,4672,4632
1,9404,10,100,0.001,0.01,0.976,0.9960655040408337,4729,4675
1,9504,10,100,0.001,0.01,0.982,0.9967382154882155,4777,4727
1,9604,10,100,0.001,0.01,0.98,0.9983340274885465,4836,4768
1,9704,10,100,0.001,0.01,0.984,0.9975267930750206,4878,4826
1,9804,10,100,0.001,0.01,0.986,0.9989800081599347,4917,4887
1,9904,10,100,0.001,0.01,0.988,0.9990912762520194,4965,4939
1,10004,10,100,0.001,0.01,0.986,0.9986005597760895,5018,4986
1,10104,10,100,0.001,0.01,0.988,0.9963380839271576,5066,5038
1,10204,10,100,0.001,0.01,0.982,0.9966679733437868,5105,5099
1,10304,10,100,0.001,0.01,0.97,0.9924301242236024,5149,5155
1,10404,10,100,0.001,0.01,0.98,0.9986543637062668,5197,5207
1,10504,10,100,0.001,0.01,0.986,0.9993335872048743,5249,5255
1,10604,10,100,0.001,0.01,0.982,0.9971708789136176,5297,5307
1,10704,10,100,0.001,0.01,0.98,0.9978512705530643,5354,5350
1,10804,10,100,0.001,0.01,0.974,0.9914846353202518,5403,5401
1,10904,10,100,0.001,0.01,0.984,0.9965150403521643,5461,5443
1,11004,10,100,0.001,0.01,0.988,0.9980007270083606,5504,5500
1,11104,10,100,0.001,0.01,0.982,0.9990994236311239,5550,5554
1,11204,10,100,0.001,0.01,0.986,0.9983041770796144,5600,5604
1,11304,10,100,0.001,0.01,0.986,0.9992922859164898,5652,5652
1,11404,10,100,0.001,0.01,0.994,0.9984216064538758,5706,5698
1,11504,10,100,0.001,0.01,0.986,0.9960013908205841,5749,5755
1,11604,10,100,0.001,0.01,0.986,0.9982764563943468,5794,5810
1,11704,10,100,0.001,0.01,0.976,0.992822966507177,5844,5860
1,11804,10,100,0.001,0.01,0.978,0.9830565909861064,5891,5913
1,11904,10,100,0.001,0.01,0.984,0.9963037634408602,5941,5963
1,12004,10,100,0.001,0.01,0.984,0.9931689436854382,5994,6010
1,12104,10,100,0.001,0.01,0.988,0.9973562458691342,6051,6053
1,12204,10,100,0.001,0.01,0.984,0.9975417895771878,6099,6105
1,12304,10,100,0.001,0.01,0.988,0.9979681404421327,6139,6165
1,12404,10,100,0.001,0.01,0.984,0.991454369558207,6181,6223
1,12504,10,100,0.001,0.01,0.988,0.9964811260396673,6239,6265
1,12604,10,100,0.001,0.01,0.982,0.992780069819105,6295,6309
1,12704,10,100,0.001,0.01,0.984,0.9977172544080605,6353,6351
1,12804,10,100,0.001,0.01,0.986,0.9976569821930646,6410,6394
1,12904,10,100,0.001,0.01,0.988,0.9980626162430254,6461,6443
1,13004,10,100,0.001,0.01,0.99,0.99930790525992,6504,6500
1,13104,10,100,0.001,0.01,0.99,0.9999236874236874,6550,6554
1,13204,10,100,0.001,0.01,0.988,0.9991669191154195,6603,6601
1,13304,10,100,0.001,0.01,0.99,0.9994738424533974,6657,6647
1,13404,10,100,0.001,0.01,0.99,0.9996269770217845,6706,6698
1,13504,10,100,0.001,0.01,0.984,0.9986670616113744,6759,6745
1,13604,10,100,0.001,0.01,0.982,0.986695089679506,6816,6788
1,13704,10,100,0.001,0.01,0.982,0.9881056625802686,6870,6834
1,13804,10,100,0.001,0.01,0.984,0.9955809910170965,6909,6895
1,13904,10,100,0.001,0.01,0.982,0.9982019562715765,6952,6952
1,14004,10,100,0.001,0.01,0.988,0.9980719794344473,7004,7000
1,14104,10,100,0.001,0.01,0.988,0.9986528644356211,7054,7050
1,14204,10,100,0.001,0.01,0.988,0.9997887918896086,7102,7102
1,14304,10,100,0.001,0.01,0.992,0.9993708053691275,7156,7148
1,14404,10,100,0.001,0.01,0.988,0.9991668980838656,7199,7205
1,14504,10,100,0.001,0.01,0.986,0.9995173745173745,7243,7261
1,14604,10,100,0.001,0.01,0.988,0.9995206792659546,7295,7309
1,14704,10,100,0.001,0.01,0.99,0.9974156692056583,7344,7360
1,14804,10,100,0.001,0.01,0.984,0.9964198865171575,7399,7405
1,14904,10,100,0.001,0.01,0.99,0.9980542136339238,7445,7459
1,15004,10,100,0.001,0.01,0.988,0.9968675019994668,7499,7505
2,104,10,100,0.001,0.01,0.456,0.5769230769230769,60,44
2,204,10,100,0.001,0.01,0.476,0.6862745098039216,110,94
2,304,10,100,0.001,0.01,0.516,0.5328947368421053,160,144
2,404,10,100,0.001,0.01,0.502,0.6064356435643564,207,197
2,504,10,100,0.001,0.01,0.484,0.6726190476190477,266,238
2,604,10,100,0.001,0.01,0.446,0.6307947019867549,314,290
2,704,10,100,0.001,0.01,0.486,0.6164772727272727,362,342
2,804,10,100,0.001,0.01,0.492,0.6393034825870647,418,386
2,904,10,100,0.001,0.01,0.492,0.6415929203539823,468,436
2,1004,10,100,0.001,0.01,0.48,0.6603585657370518,520,484
2,1104,10,100,0.001,0.01,0.504,0.6721014492753623,565,539
2,1204,10,100,0.001,0.01,0.478,0.670265780730897,620,584
2,1304,10,100,0.001,0.01,0.504,0.6679447852760736,669,635
2,1404,10,100,0.001,0.01,0.478,0.7186609686609686,718,686
2,1504,10,100,0.001,0.01,0.476,0.7021276595744681,767,737
2,1604,10,100,0.001,0.01,0.498,0.7219451371571073,818,786
2,1704,10,100,0.001,0.01,0.516,0.721244131455399,868,836
2,1804,10,100,0.001,0.01,0.55,0.7533259423503326,924,880
2,1904,10,100,0.001,0.01,0.51,0.7326680672268907,971,933
2,2004,10,100,0.001,0.01,0.6,0.7564870259481038,1027,977
2,2104,10,100,0.001,0.01,0.56,0.7637832699619772,1084,1020
2,2204,10,100,0.001,0.01,0.566,0.7295825771324864,1136,1068
2,2304,10,100,0.001,0.01,0.602,0.7604166666666666,1189,1115
2,2404,10,100,0.001,0.01,0.604,0.7978369384359401,1238,1166
2,2504,10,100,0.001,0.01,0.588,0.8186900958466453,1287,1217
2,2604,10,100,0.001,0.01,0.618,0.825652841781874,1342,1262
2,2704,10,100,0.001,0.01,0.634,0.8483727810650887,1384,1320
2,2804,10,100,0.001,0.01,0.638,0.8466476462196861,1428,1376
2,2904,10,100,0.001,0.01,0.602,0.828168044077135,1475,1429
2,3004,10,100,0.001,0.01,0.616,0.8545272969374168,1524,1480
2,3104,10,100,0.001,0.01,0.64,0.8411726804123711,1574,1530
2,3204,10,100,0.001,0.01,0.646,0.8592384519350812,1624,1580
2,3304,10,100,0.001,0.01,0.71,0.8898305084745762,1673,1631
2,3404,10,100,0.001,0.01,0.688,0.9101057579318449,1728,1676
2,3504,10,100,0.001,0.01,0.688,0.9121004566210046,1776,1728
2,3604,10,100,0.001,0.01,0.724,0.9148168701442841,1814,1790
2,3704,10,100,0.001,0.01,0.698,0.9195464362850972,1859,1845
2,3804,10,100,0.001,0.01,0.722,0.9229758149316509,1907,1897
2,3904,10,100,0.001,0.01,0.718,0.9321209016393442,1965,1939
2,4004,10,100,0.001,0.01,0.718,0.9233266733266733,2024,1980
2,4104,10,100,0.001,0.01,0.704,0.919103313840156,2075,2029
2,4204,10,100,0.001,0.01,0.746,0.9027117031398668,2133,2071
2,4304,10,100,0.001,0.01,0.762,0.9131040892193308,2174,2130
2,4404,10,100,0.001,0.01,0.77,0.9432334241598547,2224,2180
2,4504,10,100,0.001,0.01,0.776,0.9522646536412078,2276,2228
2,4604,10,100,0.001,0.01,0.762,0.9298436142484796,2321,2283
2,4704,10,100,0.001,0.01,0.778,0.9445153061224489,2364,2340
2,4804,10,100,0.001,0.01,0.766,0.9531640299750208,2411,2393
2,4904,10,100,0.001,0.01,0.772,0.9272022838499184,2465,2439
2,5004,10,100,0.001,0.01,0.774,0.9318545163868905,2508,2496
2,5104,10,100,0.001,0.01,0.8,0.9294670846394985,2557,2547
2,5204,10,100,0.001,0.01,0.74,0.9093005380476556,2605,2599
2,5304,10,100,0.001,0.01,0.782,0.9223227752639518,2661,2643
2,5404,10,100,0.001,0.01,0.782,0.9193190229459659,2711,2693
2,5504,10,100,0.001,0.01,0.782,0.9411337209302325,2750,2754
2,5604,10,100,0.001,0.01,0.81,0.9555674518201285,2799,2805
2,5704,10,100,0.001,0.01,0.804,0.9740532959326789,2845,2859
2,5804,10,100,0.001,0.01,0.834,0.9664024810475534,2901,2903
2,5904,10,100,0.001,0.01,0.792,0.9417344173441734,2949,2955
2,6004,10,100,0.001,0.01,0.834,0.9611925383077948,3000,3004
2,6104,10,100,0.001,0.01,0.84,0.9687090432503277,3048,3056
2,6204,10,100,0.001,0.01,0.84,0.973404255319149,3105,3099
2,6304,10,100,0.001,0.01,0.858,0.9789022842639594,3158,3146
2,6404,10,100,0.001,0.01,0.85,0.976420986883198,3211,3193
2,6504,10,100,0.001,0.01,0.846,0.9812423124231242,3260,3244
2,6604,10,100,0.001,0.01,0.834,0.9716838279830405,3304,3300
2,6704,10,100,0.001,0.01,0.854,0.9664379474940334,3355,3349
2,6804,10,100,0.001,0.01,0.872,0.9691358024691358,3403,3401
2,6904,10,100,0.001,0.01,0.856,0.9813151796060255,3449,3455
2,7004,10,100,0.001,0.01,0.872,0.9697315819531697,3505,3499
2,7104,10,100,0.001,0.01,0.88,0.9818412162162162,3552,3552
2,7204,10,100,0.001,0.01,0.866,0.9843142698500833,3593,3611
2,7304,10,100,0.001,0.01,0.872,0.9869934282584885,3646,3658
2,7404,10,100,0.001,0.01,0.87,0.986223662884927,3698,3706
2,7504,10,100,0.001,0.01,0.88,0.9829424307036247,3756,3748
2,7604,10,100,0.001,0.01,0.862,0.9798790110468175,3803,3801
2,7704,10,100,0.001,0.01,0.878,0.982736240913811,3851,3853
2,7804,10,100,0.001,0.01,0.876,0.9789851358277806,3896,3908
2,7904,10,100,0.001,0.01,0.892,0.9735576923076923,3945,3959
2,8004,10,100,0.001,0.01,0.876,0.9776361819090454,3992,4012
2,8104,10,100,0.001,0.01,0.908,0.9751974333662389,4036,4068
2,8204,10,100,0.001,0.01,0.894,0.984641638225256,4090,4114
2,8304,10,100,0.001,0.01,0.896,0.9872350674373795,4149,4155
2,8404,10,100,0.001,0.01,0.898,0.9878629224178962,4204,4200
2,8504,10,100,0.001,0.01,0.914,0.9908278457196613,4259,4245
2,8604,10,100,0.001,0.01,0.918,0.9965132496513249,4317,4287
2,8704,10,100,0.001,0.01,0.904,0.9851792279411765,4364,4340
2,8804,10,100,0.001,0.01,0.902,0.9862562471603816,4415,4389
2,8904,10,100,0.001,0.01,0.92,0.9838274932614556,4465,4439
2,9004,10,100,0.001,0.01,0.896,0.9852287872056864,4526,4478
2,9104,10,100,0.001,0.01,0.92,0.9905536028119508,4577,4527
2,9204,10,100,0.001,0.01,0.936,0.9856584093872229,4629,4575
2,9304,10,100,0.001,0.01,0.926,0.9915090283748925,4676,4628
2,9404,10,100,0.001,0.01,0.934,0.99096129306678,4730,4674
2,9504,10,100,0.001,0.01,0.94,0.9961069023569024,4791,4713
2,9604,10,100,0.001,0.01,0.928,0.9917742607246981,4848,4756
2,9704,10,100,0.001,0.01,0.936,0.9899010717230008,4893,4811
2,9804,10,100,0.001,0.01,0.942,0.993064055487556,4944,4860
2,9904,10,100,0.001,0.01,0.93,0.9924273021001615,5006,4898
2,10004,10,100,0.001,0.01,0.932,0.9923030787684926,5060,4944
2,10104,10,100,0.001,0.01,0.946,0.9903008709422011,5104,5000
2,10204,10,100,0.001,0.01,0.928,0.9902979223833791,5145,5059
2,10304,10,100,0.001,0.01,0.94,0.9920419254658385,5195,5109
2,10404,10,100,0.001,0.01,0.938,0.9943291041906959,5251,5153
2,10504,10,100,0.001,0.01,0.942,0.9916222391469917,5303,5201
2,10604,10,100,0.001,0.01,0.958,0.9965107506601283,5357,5247
2,10704,10,100,0.001,0.01,0.958,0.9961696562032885,5405,5299
2,10804,10,100,0.001,0.01,0.956,0.9975934838948538,5445,5359
2,10904,10,100,0.001,0.01,0.964,0.9988994864269992,5494,5410
2,11004,10,100,0.001,0.01,0.96,0.999818247909851,5542,5462
2,11104,10,100,0.001,0.01,0.966,0.9998198847262247,5582,5522
2,11204,10,100,0.001,0.01,0.962,0.999910746162085,5626,5578
2,11304,10,100,0.001,0.01,0.962,0.9992038216560509,5676,5628
2,11404,10,100,0.001,0.01,0.956,0.9958786390740091,5723,5681
2,11504,10,100,0.001,0.01,0.938,0.9840924895688457,5766,5738
2,11604,10,100,0.001,0.01,0.918,0.9696656325405033,5816,5788
2,11704,10,100,0.001,0.01,0.952,0.9816302118933697,5859,5845
2,11804,10,100,0.001,0.01,0.962,0.9939003727549983,5918,5886
2,11904,10,100,0.001,0.01,0.97,0.9994119623655914,5969,5935
2,12004,10,100,0.001,0.01,0.972,0.998750416527824,6025,5979
2,12104,10,100,0.001,0.01,0.972,0.9998347653668209,6081,6023
2,12204,10,100,0.001,0.01,0.972,0.9997541789577188,6128,6076
2,12304,10,100,0.001,0.01,0.978,1.0,6179,6125
2,12404,10,100,0.001,0.01,0.978,0.9999193808448887,6235,6169
2,12504,10,100,0.001,0.01,0.98,1.0,6289,6215
2,12604,10,100,0.001,0.01,0.98,0.9999206601079023,6346,6258
2,12704,10,100,0.001,0.01,0.984,0.9996064231738035,6385,6319
2,12804,10,100,0.001,0.01,0.972,0.9973445798188066,6432,6372
2,12904,10,100,0.001,0.01,0.96,0.9893056416615003,6477,6427
2,13004,10,100,0.001,0.01,0.952,0.9788526607197785,6528,6476
2,13104,10,100,0.001,0.01,0.96,0.9920634920634921,6581,6523
2,13204,10,100,0.001,0.01,0.978,0.9958345955770979,6623,6581
2,13304,10,100,0.001,0.01,0.978,0.9985718580877931,6673,6631
2,13404,10,100,0.001,0.01,0.982,0.9990301402566398,6726,6678
2,13504,10,100,0.001,0.01,0.982,0.99948163507109,6785,6719
2,13604,10,100,0.001,0.01,0.986,0.9993384298735666,6826,6778
2,13704,10,100,0.001,0.01,0.984,0.9998540572095739,6875,6829
2,13804,10,100,0.001,0.01,0.986,0.9994929006085193,6936,6868
2,13904,10,100,0.001,0.01,0.978,0.9962600690448792,6988,6916
2,14004,10,100,0.001,0.01,0.974,0.9923593259068837,7044,6960
2,14104,10,100,0.001,0.01,0.962,0.9833380601247873,7098,7006
2,14204,10,100,0.001,0.01,0.976,0.9949310053506054,7149,7055
2,14304,10,100,0.001,0.01,0.982,0.9969239373601789,7198,7106
2,14404,10,100,0.001,0.01,0.988,0.9975701194112746,7243,7161
2,14504,10,100,0.001,0.01,0.98,0.9982763375620518,7281,7223
2,14604,10,100,0.001,0.01,0.986,0.9997261024376883,7333,7271
2,14704,10,100,0.001,0.01,0.992,0.9995919477693145,7382,7322
2,14804,10,100,0.001,0.01,0.988,0.9994596055120237,7430,7374
2,14904,10,100,0.001,0.01,0.982,0.9997987117552335,7485,7419
2,15004,10,100,0.001,0.01,0.986,0.9995334577446015,7524,7480
3,104,10,100,0.001,0.01,0.528,0.6057692307692307,45,59
3,204,10,100,0.001,0.01,0.494,0.6323529411764706,98,106
3,304,10,100,0.001,0.01,0.496,0.6447368421052632,141,163
3,404,10,100,0.001,0.01,0.532,0.6410891089108911,187,217
3,504,10,100,0.001,0.01,0.512,0.6825396825396826,240,264
3,604,10,100,0.001,0.01,0.49,0.6622516556291391,291,313
3,704,10,100,0.001,0.01,0.486,0.6704545454545454,341,363
3,804,10,100,0.001,0.01,0.526,0.7052238805970149,385,419
3,904,10,100,0.001,0.01,0.502,0.6581858407079646,442,462
3,1004,10,100,0.001,0.01,0.49,0.6892430278884463,493,511
3,1104,10,100,0.001,0.01,0.498,0.6820652173913043,543,561
3,1204,10,100,0.001,0.01,0.532,0.7009966777408638,588,616
3,1304,10,100,0.001,0.01,0.51,0.7269938650306749,644,660
3,1404,10,100,0.001,0.01,0.55,0.7307692307692307,691,713
3,1504,10,100,0.001,0.01,0.524,0.761968085106383,742,762
3,1604,10,100,0.001,0.01,0.53,0.7793017456359103,793,811
3,1704,10,100,0.001,0.01,0.522,0.7805164319248826,850,854
3,1804,10,100,0.001,0.01,0.558,0.79490022172949,904,900
3,1904,10,100,0.001,0.01,0.536,0.7426470588235294,951,953
3,2004,10,100,0.001,0.01,0.568,0.8013972055888223,995,1009
3,2104,10,100,0.001,0.01,0.56,0.8170152091254753,1042,1062
3,2204,10,100,0.001,0.01,0.562,0.76497277676951,1088,1116
3,2304,10,100,0.001,0.01,0.594,0.8402777777777778,1135,1169
3,2404,10,100,0.001,0.01,0.592,0.8523294509151415,1188,1216
3,2504,10,100,0.001,0.01,0.618,0.8554313099041534,1239,1265
3,2604,10,100,0.001,0.01,0.656,0.8844086021505376,1284,1320
3,2704,10,100,0.001,0.01,0.666,0.875,1333,1371
3,2804,10,100,0.001,0.01,0.702,0.9022824536376605,1388,1416
3,2904,10,100,0.001,0.01,0.692,0.8770661157024794,1436,1468
3,3004,10,100,0.001,0.01,0.752,0.9157789613848203,1477,1527
3,3104,10,100,0.001,0.01,0.758,0.9297680412371134,1530,1574
3,3204,10,100,0.001,0.01,0.792,0.9497503121098627,1573,1631
3,3304,10,100,0.001,0.01,0.786,0.9561138014527845,1622,1682
3,3404,10,100,0.001,0.01,0.786,0.9391891891891891,1664,1740
3,3504,10,100,0.001,0.01,0.784,0.928082191780822,1720,1784
3,3604,10,100,0.001,0.01,0.804,0.9289678135405105,1772,1832
3,3704,10,100,0.001,0.01,0.816,0.9654427645788337,1820,1884
3,3804,10,100,0.001,0.01,0.85,0.9695057833859095,1871,1933
3,3904,10,100,0.001,0.01,0.81,0.9789959016393442,1920,1984
3,4004,10,100,0.001,0.01,0.85,0.97002997002997,1974,2030
3,4104,10,100,0.001,0.01,0.832,0.9724658869395711,2018,2086
3,4204,10,100,0.001,0.01,0.854,0.9686013320647003,2073,2131
3,4304,10,100,0.001,0.01,0.87,0.9858271375464684,2125,2179
3,4404,10,100,0.001,0.01,0.878,0.978882833787466,2178,2226
3,4504,10,100,0.001,0.01,0.878,0.9893428063943162,2225,2279
3,4604,10,100,0.001,0.01,0.864,0.9771937445699392,2280,2324
3,4704,10,100,0.001,0.01,0.862,0.9789540816326531,2323,2381
3,4804,10,100,0.001,0.01,0.884,0.9721065778517902,2377,2427
3,4904,10,100,0.001,0.01,0.88,0.9826672104404568,2434,2470
3,5004,10,100,0.001,0.01,0.884,0.9734212629896083,2487,2517
3,5104,10,100,0.001,0.01,0.898,0.9837382445141066,2544,2560
3,5204,10,100,0.001,0.01,0.884,0.9640661029976941,2590,2614
3,5304,10,100,0.001,0.01,0.898,0.9820889894419306,2633,2671
3,5404,10,100,0.001,0.01,0.892,0.9790895632864545,2682,2722
3,5504,10,100,0.001,0.01,0.92,0.989280523255814,2738,2766
3,5604,10,100,0.001,0.01,0.92,0.9921484653818701,2784,2820
3,5704,10,100,0.001,0.01,0.902,0.9926367461430575,2841,2863
3,5804,10,100,0.001,0.01,0.912,0.9794968986905582,2888,2916
3,5904,10,100,0.001,0.01,0.91,0.9925474254742548,2946,2958
3,6004,10,100,0.001,0.01,0.916,0.979180546302465,2995,3009
3,6104,10,100,0.001,0.01,0.906,0.9659239842726082,3052,3052
3,6204,10,100,0.001,0.01,0.932,0.9788845905867183,3105,3099
3,6304,10,100,0.001,0.01,0.912,0.9538388324873096,3143,3161
3,6404,10,100,0.001,0.01,0.92,0.9706433479075578,3193,3211
3,6504,10,100,0.001,0.01,0.928,0.9723247232472325,3233,3271
3,6604,10,100,0.001,0.01,0.944,0.9844033918837068,3289,3315
3,6704,10,100,0.001,0.01,0.952,0.991945107398568,3332,3372
3,6804,10,100,0.001,0.01,0.952,0.9976484420928865,3377,3427
3,6904,10,100,0.001,0.01,0.952,0.9989860950173812,3419,3485
3,7004,10,100,0.001,0.01,0.958,0.9985722444317533,3465,3539
3,7104,10,100,0.001,0.01,0.964,0.9985923423423423,3524,3580
3,7204,10,100,0.001,0.01,0.952,0.9975013881177124,3585,3619
3,7304,10,100,0.001,0.01,0.956,0.9987677984665937,3633,3671
3,7404,10,100,0.001,0.01,0.96,0.9962182603997839,3690,3714
3,7504,10,100,0.001,0.01,0.958,0.9928038379530917,3734,3770
3,7604,10,100,0.001,0.01,0.954,0.9917148869016307,3782,3822
3,7704,10,100,0.001,0.01,0.966,0.9898753894080997,3836,3868
3,7804,10,100,0.001,0.01,0.942,0.9871860584315736,3882,3922
3,7904,10,100,0.001,0.01,0.956,0.9912702429149798,3938,3966
3,8004,10,100,0.001,0.01,0.962,0.9906296851574213,3987,4017
3,8104,10,100,0.001,0.01,0.954,0.9961747285291214,4033,4071
3,8204,10,100,0.001,0.01,0.962,0.9953681131155534,4086,4118
3,8304,10,100,0.001,0.01,0.968,0.9959055876685935,4138,4166
3,8404,10,100,0.001,0.01,0.976,0.9982151356496907,4194,4210
3,8504,10,100,0.001,0.01,0.974,0.9949435559736595,4242,4262
3,8604,10,100,0.001,0.01,0.968,0.9933751743375174,4287,4317
3,8704,10,100,0.001,0.01,0.966,0.9957490808823529,4336,4368
3,8804,10,100,0.001,0.01,0.956,0.9917083144025443,4385,4419
3,8904,10,100,0.001,0.01,0.962,0.9964061096136568,4437,4467
3,9004,10,100,0.001,0.01,0.96,0.9943358507330076,4494,4510
3,9104,10,100,0.001,0.01,0.952,0.9898945518453427,4548,4556
3,9204,10,100,0.001,0.01,0.946,0.9726205997392438,4596,4608
3,9304,10,100,0.001,0.01,0.922,0.9606620808254515,4651,4653
3,9404,10,100,0.001,0.01,0.954,0.9867077839217354,4696,4708
3,9504,10,100,0.001,0.01,0.966,0.9953703703703703,4750,4754
3,9604,10,100,0.001,0.01,0.97,0.9968763015410246,4804,4800
3,9704,10,100,0.001,0.01,0.97,0.9987633965375103,4855,4849
3,9804,10,100,0.001,0.01,0.972,0.9985720114239086,4906,4898
3,9904,10,100,0.001,0.01,0.97,0.9990912762520194,4959,4945
3,10004,10,100,0.001,0.01,0.974,0.999000399840064,5009,4995
3,10104,10,100,0.001,0.01,0.972,0.9971298495645289,5061,5043
3,10204,10,100,0.001,0.01,0.968,0.9921599372794982,5111,5093
3,10304,10,100,0.001,0.01,0.97,0.9973796583850931,5159,5145
3,10404,10,100,0.001,0.01,0.974,0.9984621299500193,5213,5191
3,10504,10,100,0.001,0.01,0.972,0.9952399086062452,5253,5251
3,10604,10,100,0.001,0.01,0.978,0.9980196152395322,5304,5300
3,10704,10,100,0.001,0.01,0.982,0.9987855007473841,5344,5360
3,10804,10,100,0.001,0.01,0.98,0.9958348759718623,5394,5410
3,10904,10,100,0.001,0.01,0.97,0.9943140132061629,5449,5455
3,11004,10,100,0.001,0.01,0.978,0.9919120319883679,5492,5512
3,11104,10,100,0.001,0.01,0.97,0.9924351585014409,5545,5559
3,11204,10,100,0.001,0.01,0.972,0.9914316315601571,5598,5606
3,11304,10,100,0.001,0.01,0.978,0.997523000707714,5648,5656
3,11404,10,100,0.001,0.01,0.982,0.9983339179235357,5694,5710
3,11504,10,100,0.001,0.01,0.982,0.999826147426982,5746,5758
3,11604,10,100,0.001,0.01,0.982,0.9987935194760428,5785,5819
3,11704,10,100,0.001,0.01,0.984,0.9994873547505126,5836,5868
3,11804,10,100,0.001,0.01,0.974,0.9939850898000677,5884,5920
3,11904,10,100,0.001,0.01,0.97,0.9919354838709677,5927,5977
3,12004,10,100,0.001,0.01,0.978,0.9942519160279907,5966,6038
3,12104,10,100,0.001,0.01,0.984,0.9982650363516193,6022,6082
3,12204,10,100,0.001,0.01,0.984,0.9972959685349065,6076,6128
3,12304,10,100,0.001,0.01,0.98,0.999756176853056,6129,6175
3,12404,10,100,0.001,0.01,0.98,0.9987907126733312,6184,6220
3,12504,10,100,0.001,0.01,0.982,0.9981605886116443,6238,6266
3,12604,10,100,0.001,0.01,0.974,0.982783243414789,6297,6307
3,12704,10,100,0.001,0.01,0.978,0.9944899244332494,6334,6370
3,12804,10,100,0.001,0.01,0.984,0.9978912839737581,6384,6420
3,12904,10,100,0.001,0.01,0.984,0.9982176069435834,6443,6461
3,13004,10,100,0.001,0.01,0.98,0.996001230390649,6486,6518
3,13104,10,100,0.001,0.01,0.98,0.9950396825396826,6534,6570
3,13204,10,100,0.001,0.01,0.992,0.9990154498636776,6579,6625
3,13304,10,100,0.001,0.01,0.988,0.9960914010823813,6635,6669
3,13404,10,100,0.001,0.01,0.988,0.9960459564309161,6683,6721
3,13504,10,100,0.001,0.01,0.986,0.9955568720379147,6731,6773
3,13604,10,100,0.001,0.01,0.994,0.9989708909144369,6780,6824
3,13704,10,100,0.001,0.01,0.984,0.9985405720957384,6830,6874
3,13804,10,100,0.001,0.01,0.988,0.9996377861489424,6884,6920
3,13904,10,100,0.001,0.01,0.99,1.0,6937,6967
3,14004,10,100,0.001,0.01,0.988,1.0,6987,7017
3,14104,10,100,0.001,0.01,0.988,0.9997872943845717,7042,7062
3,14204,10,100,0.001,0.01,0.986,0.9994367783722895,7089,7115
3,14304,10,100,0.001,0.01,0.984,0.9964345637583892,7141,7163
3,14404,10,100,0.001,0.01,0.988,0.9927797833935018,7197,7207
3,14504,10,100,0.001,0.01,0.976,0.9942084942084942,7243,7261
3,14604,10,100,0.001,0.01,0.988,0.9970556012051492,7302,7302
3,14704,10,100,0.001,0.01,0.984,0.9946273122959739,7358,7346
3,14804,10,100,0.001,0.01,0.984,0.9941907592542556,7411,7393
3,14904,10,100,0.001,0.01,0.988,0.9975174449812131,7464,7440
3,15004,10,100,0.001,0.01,0.992,0.9989336177019461,7513,7491
4,104,10,100,0.001,0.01,0.498,0.5673076923076923,45,59
4,204,10,100,0.001,0.01,0.502,0.6568627450980392,104,100
4,304,10,100,0.001,0.01,0.486,0.5394736842105263,160,144
4,404,10,100,0.001,0.01,0.466,0.5396039603960396,207,197
4,504,10,100,0.001,0.01,0.462,0.6130952380952381,258,246
4,604,10,100,0.001,0.01,0.46,0.5761589403973509,305,299
4,704,10,100,0.001,0.01,0.47,0.5809659090909091,359,345
4,804,10,100,0.001,0.01,0.49,0.5945273631840796,411,393
4,904,10,100,0.001,0.01,0.542,0.6238938053097345,465,439
4,1004,10,100,0.001,0.01,0.53,0.646414342629482,509,495
4,1104,10,100,0.001,0.01,0.526,0.6394927536231884,560,544
4,1204,10,100,0.001,0.01,0.496,0.6818936877076412,607,597
4,1304,10,100,0.001,0.01,0.514,0.6679447852760736,654,650
4,1404,10,100,0.001,0.01,0.514,0.6901709401709402,704,700
4,1504,10,100,0.001,0.01,0.538,0.682845744680851,752,752
4,1604,10,100,0.001,0.01,0.548,0.7094763092269327,804,800
4,1704,10,100,0.001,0.01,0.51,0.7165492957746479,856,848
4,1804,10,100,0.001,0.01,0.502,0.7405764966740577,909,895
4,1904,10,100,0.001,0.01,0.504,0.7442226890756303,962,942
4,2004,10,100,0.001,0.01,0.53,0.7829341317365269,1013,991
4,2104,10,100,0.001,0.01,0.536,0.7547528517110266,1062,1042
4,2204,10,100,0.001,0.01,0.538,0.7953720508166969,1114,1090
4,2304,10,100,0.001,0.01,0.576,0.8307291666666666,1165,1139
4,2404,10,100,0.001,0.01,0.566,0.8148918469217971,1210,1194
4,2504,10,100,0.001,0.01,0.602,0.8386581469648562,1250,1254
4,2604,10,100,0.001,0.01,0.622,0.8271889400921659,1299,1305
4,2704,10,100,0.001,0.01,0.64,0.834319526627219,1346,1358
4,2804,10,100,0.001,0.01,0.664,0.8855206847360912,1392,1412
4,2904,10,100,0.001,0.01,0.668,0.8722451790633609,1443,1461
4,3004,10,100,0.001,0.01,0.742,0.9224367509986684,1496,1508
4,3104,10,100,0.001,0.01,0.726,0.9471649484536082,1551,1553
4,3204,10,100,0.001,0.01,0.738,0.9416354556803995,1603,1601
4,3304,10,100,0.001,0.01,0.728,0.9424939467312349,1654,1650
4,3404,10,100,0.001,0.01,0.736,0.9606345475910694,1704,1700
4,3504,10,100,0.001,0.01,0.722,0.947203196347032,1753,1751
4,3604,10,100,0.001,0.01,0.742,0.9605993340732519,1806,1798
4,3704,10,100,0.001,0.01,0.754,0.9743520518358532,1850,1854
4,3804,10,100,0.001,0.01,0.758,0.9652996845425867,1910,1894
4,3904,10,100,0.001,0.01,0.776,0.914702868852459,1955,1949
4,4004,10,100,0.001,0.01,0.744,0.9293206793206793,2002,2002
4,4104,10,100,0.001,0.01,0.754,0.9127680311890838,2052,2052
4,4204,10,100,0.001,0.01,0.768,0.9293529971455756,2103,2101
4,4304,10,100,0.001,0.01,0.78,0.9149628252788105,2157,2147
4,4404,10,100,0.001,0.01,0.8,0.9489100817438693,2215,2189
4,4504,10,100,0.001,0.01,0.838,0.9658081705150977,2262,2242
4,4604,10,100,0.001,0.01,0.798,0.9691572545612511,2319,2285
4,4704,10,100,0.001,0.01,0.816,0.9634353741496599,2367,2337
4,4804,10,100,0.001,0.01,0.836,0.9641965029142381,2416,2388
4,4904,10,100,0.001,0.01,0.784,0.9296492659053833,2464,2440
4,5004,10,100,0.001,0.01,0.832,0.9570343725019984,2514,2490
4,5104,10,100,0.001,0.01,0.826,0.9596394984326019,2565,2539
4,5204,10,100,0.001,0.01,0.814,0.952152190622598,2610,2594
4,5304,10,100,0.001,0.01,0.838,0.946078431372549,2657,2647
4,5404,10,100,0.001,0.01,0.836,0.9653960029607698,2707,2697
4,5504,10,100,0.001,0.01,0.84,0.9643895348837209,2757,2747
4,5604,10,100,0.001,0.01,0.85,0.9835831548893648,2810,2794
4,5704,10,100,0.001,0.01,0.872,0.9850981767180925,2852,2852
4,5804,10,100,0.001,0.01,0.86,0.9848380427291523,2901,2903
4,5904,10,100,0.001,0.01,0.856,0.9874661246612466,2946,2958
4,6004,10,100,0.001,0.01,0.868,0.9876748834110592,2989,3015
4,6104,10,100,0.001,0.01,0.86,0.9932830930537353,3039,3065
4,6204,10,100,0.001,0.01,0.862,0.9911347517730497,3093,3111
4,6304,10,100,0.001,0.01,0.878,0.9944479695431472,3142,3162
4,6404,10,100,0.001,0.01,0.86,0.9886008744534666,3195,3209
4,6504,10,100,0.001,0.01,0.874,0.988929889298893,3256,3248
4,6604,10,100,0.001,0.01,0.902,0.9924288310115081,3306,3298
4,6704,10,100,0.001,0.01,0.876,0.9865751789976134,3360,3344
4,6804,10,100,0.001,0.01,0.886,0.9922104644326867,3402,3402
4,6904,10,100,0.001,0.01,0.876,0.9853707995365005,3460,3444
4,7004,10,100,0.001,0.01,0.882,0.9854368932038835,3506,3498
4,7104,10,100,0.001,0.01,0.884,0.9849380630630631,3555,3549
4,7204,10,100,0.001,0.01,0.892,0.9868128817323709,3607,3597
4,7304,10,100,0.001,0.01,0.886,0.9815169769989047,3667,3637
4,7404,10,100,0.001,0.01,0.87,0.9531334413830362,3719,3685
4,7504,10,100,0.001,0.01,0.864,0.9754797441364605,3778,3726
4,7604,10,100,0.001,0.01,0.868,0.9619936875328774,3820,3784
4,7704,10,100,0.001,0.01,0.828,0.932632398753894,3862,3842
4,7804,10,100,0.001,0.01,0.888,0.9752690927729369,3915,3889
4,7904,10,100,0.001,0.01,0.91,0.9801366396761133,3959,3945
4,8004,10,100,0.001,0.01,0.872,0.9857571214392804,4001,4003
4,8104,10,100,0.001,0.01,0.892,0.991238894373149,4054,4050
4,8204,10,100,0.001,0.01,0.89,0.9867137981472452,4113,4091
4,8304,10,100,0.001,0.01,0.87,0.9804913294797688,4171,4133
4,8404,10,100,0.001,0.01,0.91,0.9825083293669681,4214,4190
4,8504,10,100,0.001,0.01,0.892,0.9884760112888052,4263,4241
4,8604,10,100,0.001,0.01,0.902,0.9926778242677824,4316,4288
4,8704,10,100,0.001,0.01,0.882,0.9802389705882353,4370,4334
4,8804,10,100,0.001,0.01,0.884,0.9722853248523399,4416,4388
4,8904,10,100,0.001,0.01,0.894,0.9818059299191375,4463,4441
4,9004,10,100,0.001,0.01,0.916,0.9885606397156819,4513,4491
4,9104,10,100,0.001,0.01,0.922,0.9957161687170475,4569,4535
4,9204,10,100,0.001,0.01,0.902,0.9952194697957409,4620,4584
4,9304,10,100,0.001,0.01,0.906,0.9922613929492692,4661,4643
4,9404,10,100,0.001,0.01,0.914,0.9928753721820502,4715,4689
4,9504,10,100,0.001,0.01,0.888,0.9917929292929293,4769,4735
4,9604,10,100,0.001,0.01,0.9,0.9933361099541858,4822,4782
4,9704,10,100,0.001,0.01,0.904,0.9919620774938169,4868,4836
4,9804,10,100,0.001,0.01,0.914,0.9894940840473276,4915,4889
4,9904,10,100,0.001,0.01,0.908,0.9911147011308562,4960,4944
4,10004,10,100,0.001,0.01,0.91,0.987405037984806,5016,4988
4,10104,10,100,0.001,0.01,0.912,0.9863420427553444,5065,5039
4,10204,10,100,0.001,0.01,0.922,0.9915719325754606,5114,5090
4,10304,10,100,0.001,0.01,0.924,0.9874805900621118,5163,5141
4,10404,10,100,0.001,0.01,0.92,0.986159169550173,5218,5186
4,10504,10,100,0.001,0.01,0.892,0.9838156892612339,5268,5236
4,10604,10,100,0.001,0.01,0.918,0.9865145228215768,5320,5284
4,10704,10,100,0.001,0.01,0.916,0.9900971599402093,5372,5332
4,10804,10,100,0.001,0.01,0.922,0.9952795261014439,5419,5385
4,10904,10,100,0.001,0.01,0.932,0.9973404255319149,5468,5436
4,11004,10,100,0.001,0.01,0.922,0.9892766266812069,5511,5493
4,11104,10,100,0.001,0.01,0.918,0.9854106628242075,5556,5548
4,11204,10,100,0.001,0.01,0.928,0.9937522313459479,5601,5603
4,11304,10,100,0.001,0.01,0.908,0.9913305024769993,5648,5656
4,11404,10,100,0.001,0.01,0.918,0.9885128025254297,5697,5707
4,11504,10,100,0.001,0.01,0.916,0.9885257301808067,5746,5758
4,11604,10,100,0.001,0.01,0.918,0.9841433988279904,5801,5803
4,11704,10,100,0.001,0.01,0.928,0.9890635680109364,5846,5858
4,11804,10,100,0.001,0.01,0.91,0.9836496103015927,5892,5912
4,11904,10,100,0.001,0.01,0.926,0.9922715053763441,5938,5966
4,12004,10,100,0.001,0.01,0.94,0.9855881372875708,5989,6015
4,12104,10,100,0.001,0.01,0.926,0.9946298744216788,6033,6071
4,12204,10,100,0.001,0.01,0.934,0.9927892494264176,6081,6123
4,12304,10,100,0.001,0.01,0.932,0.9917100130039012,6135,6169
4,12404,10,100,0.001,0.01,0.914,0.9882296033537569,6186,6218
4,12504,10,100,0.001,0.01,0.928,0.988003838771593,6233,6271
4,12604,10,100,0.001,0.01,0.918,0.9905585528403681,6278,6326
4,12704,10,100,0.001,0.01,0.9,0.9814231738035264,6323,6381
4,12804,10,100,0.001,0.01,0.924,0.9927366447985004,6371,6433
4,12904,10,100,0.001,0.01,0.934,0.9925604463732176,6427,6477
4,13004,10,100,0.001,0.01,0.926,0.9930790525992003,6474,6530
4,13104,10,100,0.001,0.01,0.94,0.992979242979243,6528,6576
4,13204,10,100,0.001,0.01,0.938,0.9913662526507119,6582,6622
4,13304,10,100,0.001,0.01,0.926,0.9903788334335538,6630,6674
4,13404,10,100,0.001,0.01,0.928,0.9917934944792599,6690,6714
4,13504,10,100,0.001,0.01,0.944,0.9915580568720379,6746,6758
4,13604,10,100,0.001,0.01,0.93,0.9917671273154954,6795,6809
4,13704,10,100,0.001,0.01,0.94,0.9922650321074139,6846,6858
4,13804,10,100,0.001,0.01,0.94,0.9877571718342509,6893,6911
4,13904,10,100,0.001,0.01,0.942,0.991800920598389,6943,6961
4,14004,10,100,0.001,0.01,0.95,0.9948586118251928,6996,7008
4,14104,10,100,0.001,0.01,0.946,0.9909954622802042,7048,7056
4,14204,10,100,0.001,0.01,0.952,0.9907068431427767,7098,7106
4,14304,10,100,0.001,0.01,0.956,0.9926593959731543,7146,7158
4,14404,10,100,0.001,0.01,0.942,0.9933351846709247,7190,7214
4,14504,10,100,0.001,0.01,0.942,0.9833838940981798,7235,7269
4,14604,10,100,0.001,0.01,0.956,0.9911668036154478,7289,7315
4,14704,10,100,0.001,0.01,0.928,0.9880984766050055,7335,7369
4,14804,10,100,0.001,0.01,0.95,0.9918265333693597,7388,7416
4,14904,10,100,0.001,0.01,0.956,0.995101986044015,7452,7452
4,15004,10,100,0.001,0.01,0.958,0.996534257531325,7501,7503
5,104,10,100,0.001,0.01,0.496,0.4807692307692308,50,54
5,204,10,100,0.001,0.01,0.486,0.6470588235294118,88,116
5,304,10,100,0.001,0.01,0.5,0.5625,143,161
5,404,10,100,0.001,0.01,0.502,0.6237623762376238,196,208
5,504,10,100,0.001,0.01,0.48,0.6349206349206349,246,258
5,604,10,100,0.001,0.01,0.494,0.6241721854304636,302,302
5,704,10,100,0.001,0.01,0.464,0.6363636363636364,362,342
5,804,10,100,0.001,0.01,0.488,0.6417910447761194,409,395
5,904,10,100,0.001,0.01,0.512,0.6570796460176991,454,450
5,1004,10,100,0.001,0.01,0.508,0.6842629482071713,502,502
5,1104,10,100,0.001,0.01,0.506,0.6358695652173914,541,563
5,1204,10,100,0.001,0.01,0.5,0.6769102990033222,586,618
5,1304,10,100,0.001,0.01,0.47,0.6687116564417178,637,667
5,1404,10,100,0.001,0.01,0.5,0.7186609686609686,687,717
5,1504,10,100,0.001,0.01,0.5,0.7147606382978723,734,770
5,1604,10,100,0.001,0.01,0.514,0.7163341645885287,780,824
5,1704,10,100,0.001,0.01,0.518,0.7453051643192489,823,881
5,1804,10,100,0.001,0.01,0.49,0.7572062084257206,868,936
5,1904,10,100,0.001,0.01,0.502,0.7515756302521008,916,988
5,2004,10,100,0.001,0.01,0.516,0.780439121756487,962,1042
5,2104,10,100,0.001,0.01,0.486,0.7376425855513308,1010,1094
5,2204,10,100,0.001,0.01,0.492,0.7590744101633394,1060,1144
5,2304,10,100,0.001,0.01,0.53,0.7530381944444444,1102,1202
5,2404,10,100,0.001,0.01,0.506,0.7533277870216306,1154,1250
5,2504,10,100,0.001,0.01,0.486,0.8011182108626198,1210,1294
5,2604,10,100,0.001,0.01,0.5,0.815284178187404,1266,1338
5,2704,10,100,0.001,0.01,0.526,0.8117603550295858,1319,1385
5,2804,10,100,0.001,0.01,0.544,0.8216833095577746,1372,1432
5,2904,10,100,0.001,0.01,0.514,0.8257575757575758,1422,1482
5,3004,10,100,0.001,0.01,0.496,0.8355525965379494,1478,1526
5,3104,10,100,0.001,0.01,0.534,0.8102448453608248,1531,1573
5,3204,10,100,0.001,0.01,0.51,0.8161672908863921,1581,1623
5,3304,10,100,0.001,0.01,0.522,0.7953995157384988,1617,1687
5,3404,10,100,0.001,0.01,0.556,0.8425381903642774,1668,1736
5,3504,10,100,0.001,0.01,0.552,0.8624429223744292,1721,1783
5,3604,10,100,0.001,0.01,0.586,0.8693118756936737,1773,1831
5,3704,10,100,0.001,0.01,0.6,0.8763498920086393,1823,1881
5,3804,10,100,0.001,0.01,0.614,0.8809148264984227,1865,1939
5,3904,10,100,0.001,0.01,0.622,0.8639856557377049,1918,1986
5,4004,10,100,0.001,0.01,0.644,0.8878621378621379,1969,2035
5,4104,10,100,0.001,0.01,0.648,0.9200779727095516,2022,2082
5,4204,10,100,0.001,0.01,0.65,0.8950999048525214,2071,2133
5,4304,10,100,0.001,0.01,0.67,0.929135687732342,2118,2186
5,4404,10,100,0.001,0.01,0.652,0.9212079927338783,2184,2220
5,4504,10,100,0.001,0.01,0.67,0.9123001776198935,2244,2260
5,4604,10,100,0.001,0.01,0.684,0.9268027801911382,2295,2309
5,4704,10,100,0.001,0.01,0.664,0.9381377551020408,2349,2355
5,4804,10,100,0.001,0.01,0.678,0.95503746877602,2390,2414
5,4904,10,100,0.001,0.01,0.706,0.9634991843393148,2441,2463
5,5004,10,100,0.001,0.01,0.698,0.9592326139088729,2494,2510
5,5104,10,100,0.001,0.01,0.688,0.9610109717868338,2550,2554
5,5204,10,100,0.001,0.01,0.7,0.930630284396618,2600,2604
5,5304,10,100,0.001,0.01,0.698,0.8834841628959276,2644,2660
5,5404,10,100,0.001,0.01,0.708,0.9259807549962991,2687,2717
5,5504,10,100,0.001,0.01,0.67,0.8588299418604651,2735,2769
5,5604,10,100,0.001,0.01,0.722,0.913633119200571,2784,2820
5,5704,10,100,0.001,0.01,0.716,0.89726507713885,2833,2871
5,5804,10,100,0.001,0.01,0.752,0.9281529979324604,2888,2916
5,5904,10,100,0.001,0.01,0.768,0.9525745257452575,2946,2958
5,6004,10,100,0.001,0.01,0.788,0.9555296469020653,3001,3003
5,6104,10,100,0.001,0.01,0.78,0.959043250327654,3057,3047
5,6204,10,100,0.001,0.01,0.81,0.9677627337201805,3113,3091
5,6304,10,100,0.001,0.01,0.802,0.9733502538071066,3168,3136
5,6404,10,100,0.001,0.01,0.824,0.9494066208619613,3212,3192
5,6504,10,100,0.001,0.01,0.808,0.9637146371463715,3258,3246
5,6604,10,100,0.001,0.01,0.798,0.9609327680193822,3308,3296
5,6704,10,100,0.001,0.01,0.794,0.9473448687350835,3359,3345
5,6804,10,100,0.001,0.01,0.796,0.970164609053498,3408,3396
5,6904,10,100,0.001,0.01,0.822,0.9753765932792584,3458,3446
5,7004,10,100,0.001,0.01,0.804,0.9780125642490006,3507,3497
5,7104,10,100,0.001,0.01,0.83,0.9604448198198198,3554,3550
5,7204,10,100,0.001,0.01,0.85,0.9794558578567463,3597,3607
5,7304,10,100,0.001,0.01,0.844,0.9882256297918949,3648,3656
5,7404,10,100,0.001,0.01,0.854,0.9871690977849811,3693,3711
5,7504,10,100,0.001,0.01,0.87,0.9893390191897654,3750,3754
5,7604,10,100,0.001,0.01,0.852,0.9896107311941084,3795,3809
5,7704,10,100,0.001,0.01,0.85,0.9739096573208723,3842,3862
5,7804,10,100,0.001,0.01,0.852,0.9747565351101999,3894,3910
5,7904,10,100,0.001,0.01,0.862,0.9855769230769231,3940,3964
5,8004,10,100,0.001,0.01,0.874,0.9805097451274363,3985,4019
5,8104,10,100,0.001,0.01,0.884,0.9877838104639685,4025,4079
5,8204,10,100,0.001,0.01,0.872,0.9839102876645539,4069,4135
5,8304,10,100,0.001,0.01,0.862,0.9880780346820809,4123,4181
5,8404,10,100,0.001,0.01,0.888,0.9829842931937173,4175,4229
5,8504,10,100,0.001,0.01,0.882,0.9910630291627469,4224,4280
5,8604,10,100,0.001,0.01,0.866,0.958507670850767,4274,4330
5,8704,10,100,0.001,0.01,0.83,0.9366957720588235,4320,4384
5,8804,10,100,0.001,0.01,0.872,0.9647887323943662,4371,4433
5,8904,10,100,0.001,0.01,0.878,0.9778751123090745,4420,4484
5,9004,10,100,0.001,0.01,0.88,0.9843402932030209,4471,4533
5,9104,10,100,0.001,0.01,0.888,0.9881370826010545,4521,4583
5,9204,10,100,0.001,0.01,0.902,0.9919600173837462,4573,4631
5,9304,10,100,0.001,0.01,0.896,0.9935511607910577,4630,4674
5,9404,10,100,0.001,0.01,0.904,0.9861760952786048,4679,4725
5,9504,10,100,0.001,0.01,0.908,0.9922138047138047,4715,4789
5,9604,10,100,0.001,0.01,0.898,0.9932319866722199,4775,4829
5,9704,10,100,0.001,0.01,0.91,0.9872217642209398,4828,4876
5,9804,10,100,0.001,0.01,0.916,0.9859241126070991,4876,4928
5,9904,10,100,0.001,0.01,0.918,0.9974757673667205,4916,4988
5,10004,10,100,0.001,0.01,0.926,0.991703318672531,4971,5033
5,10104,10,100,0.001,0.01,0.93,0.9963380839271576,5017,5087
5,10204,10,100,0.001,0.01,0.922,0.9947079576636613,5072,5132
5,10304,10,100,0.001,0.01,0.934,0.9942740683229814,5122,5182
5,10404,10,100,0.001,0.01,0.93,0.9918300653594772,5176,5228
5,10504,10,100,0.001,0.01,0.904,0.9816260472201066,5220,5284
5,10604,10,100,0.001,0.01,0.906,0.9627499056959637,5278,5326
5,10704,10,100,0.001,0.01,0.92,0.984772047832586,5329,5375
5,10804,10,100,0.001,0.01,0.934,0.9922251018141429,5385,5419
5,10904,10,100,0.001,0.01,0.942,0.9974321349963317,5437,5467
5,11004,10,100,0.001,0.01,0.954,0.9970919665576155,5486,5518
5,11104,10,100,0.001,0.01,0.952,0.9990994236311239,5537,5567
5,11204,10,100,0.001,0.01,0.946,0.9979471617279543,5588,5616
5,11304,10,100,0.001,0.01,0.942,0.9925690021231423,5635,5669
5,11404,10,100,0.001,0.01,0.954,0.9959663276043493,5683,5721
5,11504,10,100,0.001,0.01,0.948,0.9931328233657858,5732,5772
5,11604,10,100,0.001,0.01,0.95,0.9883660806618407,5786,5818
5,11704,10,100,0.001,0.01,0.944,0.9929938482570062,5828,5876
5,11804,10,100,0.001,0.01,0.954,0.9955947136563876,5872,5932
5,11904,10,100,0.001,0.01,0.956,0.9972278225806451,5927,5977
5,12004,10,100,0.001,0.01,0.962,0.9959180273242253,5975,6029
5,12104,10,100,0.001,0.01,0.962,0.9983476536682089,6017,6087
5,12204,10,100,0.001,0.01,0.952,0.9946738774172402,6064,6140
5,12304,10,100,0.001,0.01,0.954,0.9925227568270482,6110,6194
5,12404,10,100,0.001,0.01,0.944,0.9966946146404385,6161,6243
5,12504,10,100,0.001,0.01,0.954,0.9944817658349329,6213,6291
5,12604,10,100,0.001,0.01,0.964,0.9926213900349096,6265,6339
5,12704,10,100,0.001,0.01,0.97,0.9949622166246851,6310,6394
5,12804,10,100,0.001,0.01,0.974,0.9949234614183068,6375,6429
5,12904,10,100,0.001,0.01,0.974,0.9984500929944203,6425,6479
5,13004,10,100,0.001,0.01,0.976,0.9970009227929868,6484,6520
5,13104,10,100,0.001,0.01,0.976,0.9967185592185592,6534,6570
5,13204,10,100,0.001,0.01,0.984,0.9984095728567101,6589,6615
5,13304,10,100,0.001,0.01,0.976,0.9936109440769694,6641,6663
5,13404,10,100,0.001,0.01,0.98,0.9965681886004177,6702,6702
5,13504,10,100,0.001,0.01,0.982,0.9988151658767772,6752,6752
5,13604,10,100,0.001,0.01,0.98,0.9987503675389592,6803,6801
5,13704,10,100,0.001,0.01,0.976,0.9983946293053123,6850,6854
5,13804,10,100,0.001,0.01,0.988,0.9993480150680962,6896,6908
5,13904,10,100,0.001,0.01,0.984,0.9962600690448792,6938,6966
5,14004,10,100,0.001,0.01,0.978,0.9985004284490145,6996,7008
5,14104,10,100,0.001,0.01,0.988,0.9985819625638117,7051,7053
5,14204,10,100,0.001,0.01,0.968,0.9947901999436778,7103,7101
5,14304,10,100,0.001,0.01,0.978,0.9871364653243848,7160,7144
5,14404,10,100,0.001,0.01,0.984,0.9891696750902527,7213,7191
5,14504,10,100,0.001,0.01,0.984,0.995380584666299,7266,7238
5,14604,10,100,0.001,0.01,0.984,0.9977403451109285,7316,7288
5,14704,10,100,0.001,0.01,0.99,0.9993199129488575,7365,7339
5,14804,10,100,0.001,0.01,0.99,0.9999324506890029,7412,7392
5,14904,10,100,0.001,0.01,0.99,0.9999329039184112,7458,7446
5,15004,10,100,0.001,0.01,0.99,0.9999333511063716,7504,7500
6,104,10,100,0.001,0.01,0.486,0.5673076923076923,45,59
6,204,10,100,0.001,0.01,0.476,0.6225490196078431,94,110
6,304,10,100,0.001,0.01,0.492,0.6282894736842105,149,155
6,404,10,100,0.001,0.01,0.5,0.6336633663366337,198,206
6,504,10,100,0.001,0.01,0.48,0.628968253968254,241,263
6,604,10,100,0.001,0.01,0.47,0.6374172185430463,295,309
6,704,10,100,0.001,0.01,0.482,0.6278409090909091,352,352
6,804,10,100,0.001,0.01,0.49,0.6629353233830846,408,396
6,904,10,100,0.001,0.01,0.478,0.6814159292035398,456,448
6,1004,10,100,0.001,0.01,0.492,0.7171314741035857,506,498
6,1104,10,100,0.001,0.01,0.484,0.7155797101449275,565,539
6,1204,10,100,0.001,0.01,0.494,0.7533222591362126,623,581
6,1304,10,100,0.001,0.01,0.52,0.7446319018404908,674,630
6,1404,10,100,0.001,0.01,0.506,0.7613960113960114,723,681
6,1504,10,100,0.001,0.01,0.54,0.7606382978723404,772,732
6,1604,10,100,0.001,0.01,0.552,0.7655860349127181,818,786
6,1704,10,100,0.001,0.01,0.518,0.7382629107981221,871,833
6,1804,10,100,0.001,0.01,0.534,0.7339246119733924,926,878
6,1904,10,100,0.001,0.01,0.572,0.7626050420168067,976,928
6,2004,10,100,0.001,0.01,0.57,0.8048902195608783,1028,976
6,2104,10,100,0.001,0.01,0.56,0.7875475285171103,1078,1026
6,2204,10,100,0.001,0.01,0.538,0.8212341197822142,1124,1080
6,2304,10,100,0.001,0.01,0.558,0.8250868055555556,1181,1123
6,2404,10,100,0.001,0.01,0.596,0.8781198003327787,1227,1177
6,2504,10,100,0.001,0.01,0.586,0.889776357827476,1269,1235
6,2604,10,100,0.001,0.01,0.632,0.9162826420890937,1323,1281
6,2704,10,100,0.001,0.01,0.58,0.834689349112426,1379,1325
6,2804,10,100,0.001,0.01,0.636,0.8890870185449358,1424,1380
6,2904,10,100,0.001,0.01,0.614,0.8808539944903582,1481,1423
6,3004,10,100,0.001,0.01,0.622,0.8768308921438083,1531,1473
6,3104,10,100,0.001,0.01,0.668,0.8814432989690721,1579,1525
6,3204,10,100,0.001,0.01,0.688,0.9269662921348315,1622,1582
6,3304,10,100,0.001,0.01,0.73,0.9440072639225182,1670,1634
6,3404,10,100,0.001,0.01,0.752,0.9638660399529965,1719,1685
6,3504,10,100,0.001,0.01,0.754,0.9680365296803652,1768,1736
6,3604,10,100,0.001,0.01,0.762,0.9414539400665927,1824,1780
6,3704,10,100,0.001,0.01,0.76,0.9460043196544277,1880,1824
6,3804,10,100,0.001,0.01,0.756,0.961093585699264,1940,1864
6,3904,10,100,0.001,0.01,0.758,0.9464651639344263,1986,1918
6,4004,10,100,0.001,0.01,0.81,0.9735264735264735,2030,1974
6,4104,10,100,0.001,0.01,0.832,0.9834307992202729,2074,2030
6,4204,10,100,0.001,0.01,0.818,0.9909609895337773,2122,2082
6,4304,10,100,0.001,0.01,0.826,0.9925650557620818,2166,2138
6,4404,10,100,0.001,0.01,0.842,0.9943233424159855,2217,2187
6,4504,10,100,0.001,0.01,0.84,0.9895648312611013,2263,2241
6,4604,10,100,0.001,0.01,0.854,0.9917463075586447,2307,2297
6,4704,10,100,0.001,0.01,0.852,0.9936224489795918,2362,2342
6,4804,10,100,0.001,0.01,0.86,0.9904246461282264,2421,2383
6,4904,10,100,0.001,0.01,0.858,0.9851141924959217,2472,2432
6,5004,10,100,0.001,0.01,0.858,0.9856115107913669,2531,2473
6,5104,10,100,0.001,0.01,0.846,0.9866771159874608,2578,2526
6,5204,10,100,0.001,0.01,0.872,0.9944273635664873,2624,2580
6,5304,10,100,0.001,0.01,0.868,0.9869909502262444,2666,2638
6,5404,10,100,0.001,0.01,0.872,0.9870466321243523,2718,2686
6,5504,10,100,0.001,0.01,0.828,0.928234011627907,2769,2735
6,5604,10,100,0.001,0.01,0.894,0.9757316202712348,2818,2786
6,5704,10,100,0.001,0.01,0.888,0.9821178120617111,2868,2836
6,5804,10,100,0.001,0.01,0.904,0.9893177119228118,2918,2886
6,5904,10,100,0.001,0.01,0.912,0.9933943089430894,2969,2935
6,6004,10,100,0.001,0.01,0.918,0.9945036642238507,3021,2983
6,6104,10,100,0.001,0.01,0.912,0.9962319790301442,3075,3029
6,6204,10,100,0.001,0.01,0.9,0.9961315280464217,3129,3075
6,6304,10,100,0.001,0.01,0.902,0.9955583756345178,3179,3125
6,6404,10,100,0.001,0.01,0.91,0.9932854465958776,3228,3176
6,6504,10,100,0.001,0.01,0.904,0.9907749077490775,3266,3238
6,6604,10,100,0.001,0.01,0.908,0.9915202907328892,3314,3290
6,6704,10,100,0.001,0.01,0.924,0.9929892601431981,3366,3338
6,6804,10,100,0.001,0.01,0.9,0.9631099353321576,3421,3383
6,6904,10,100,0.001,0.01,0.876,0.9427867902665121,3477,3427
6,7004,10,100,0.001,0.01,0.89,0.9727298686464877,3529,3475
6,7104,10,100,0.001,0.01,0.898,0.9894425675675675,3576,3528
6,7204,10,100,0.001,0.01,0.912,0.993753470294281,3634,3570
6,7304,10,100,0.001,0.01,0.912,0.9927437020810514,3680,3624
6,7404,10,100,0.001,0.01,0.908,0.9941923284710967,3731,3673
6,7504,10,100,0.001,0.01,0.926,0.997867803837953,3779,3725
6,7604,10,100,0.001,0.01,0.904,0.981325618095739,3826,3778
6,7704,10,100,0.001,0.01,0.914,0.9803997923156802,3880,3824
6,7804,10,100,0.001,0.01,0.93,0.9901332649923117,3925,3879
6,7904,10,100,0.001,0.01,0.896,0.965334008097166,3979,3925
6,8004,10,100,0.001,0.01,0.94,0.9808845577211395,4028,3976
6,8104,10,100,0.001,0.01,0.922,0.9727295162882527,4077,4027
6,8204,10,100,0.001,0.01,0.932,0.9882983910287665,4127,4077
6,8304,10,100,0.001,0.01,0.94,0.9903660886319846,4180,4124
6,8404,10,100,0.001,0.01,0.936,0.9938124702522608,4229,4175
6,8504,10,100,0.001,0.01,0.94,0.9974129821260583,4277,4227
6,8604,10,100,0.001,0.01,0.936,0.996048349604835,4324,4280
6,8704,10,100,0.001,0.01,0.934,0.9972426470588235,4370,4334
6,8804,10,100,0.001,0.01,0.94,0.993866424352567,4425,4379
6,8904,10,100,0.001,0.01,0.942,0.9943845462713388,4477,4427
6,9004,10,100,0.001,0.01,0.942,0.9974455797423367,4524,4480
6,9104,10,100,0.001,0.01,0.946,0.9984622144112478,4576,4528
6,9204,10,100,0.001,0.01,0.948,0.9965232507605389,4618,4586
6,9304,10,100,0.001,0.01,0.952,0.9979578675838349,4664,4640
6,9404,10,100,0.001,0.01,0.95,0.9988302849851127,4716,4688
6,9504,10,100,0.001,0.01,0.95,0.9976851851851852,4763,4741
6,9604,10,100,0.001,0.01,0.954,0.9927113702623906,4815,4789
6,9704,10,100,0.001,0.01,0.952,0.9910346248969497,4868,4836
6,9804,10,100,0.001,0.01,0.952,0.9928600571195431,4919,4885
6,9904,10,100,0.001,0.01,0.946,0.9926292407108239,4971,4933
6,10004,10,100,0.001,0.01,0.938,0.9918032786885246,5018,4986
6,10104,10,100,0.001,0.01,0.936,0.9907957244655582,5059,5045
6,10204,10,100,0.001,0.01,0.954,0.9948059584476676,5113,5091
6,10304,10,100,0.001,0.01,0.952,0.9952445652173914,5164,5140
6,10404,10,100,0.001,0.01,0.948,0.9948096885813149,5222,5182
6,10504,10,100,0.001,0.01,0.956,0.9962871287128713,5273,5231
6,10604,10,100,0.001,0.01,0.948,0.9938702376461712,5322,5282
6,10704,10,100,0.001,0.01,0.956,0.9909379671150972,5376,5328
6,10804,10,100,0.001,0.01,0.956,0.9947241762310255,5424,5380
6,10904,10,100,0.001,0.01,0.954,0.9960564930300807,5469,5435
6,11004,10,100,0.001,0.01,0.958,0.9945474372955289,5519,5485
6,11104,10,100,0.001,0.01,0.954,0.9900936599423631,5574,5530
6,11204,10,100,0.001,0.01,0.954,0.9903605855051767,5622,5582
6,11304,10,100,0.001,0.01,0.96,0.9952229299363057,5673,5631
6,11404,10,100,0.001,0.01,0.96,0.9912311469659768,5718,5686
6,11504,10,100,0.001,0.01,0.97,0.9967837273991655,5772,5732
6,11604,10,100,0.001,0.01,0.97,0.9985349879351948,5827,5777
6,11704,10,100,0.001,0.01,0.968,0.9988038277511961,5880,5824
6,11804,10,100,0.001,0.01,0.964,0.9980515079634023,5929,5875
6,11904,10,100,0.001,0.01,0.968,0.998991935483871,5980,5924
6,12004,10,100,0.001,0.01,0.972,0.9994168610463179,6027,5977
6,12104,10,100,0.001,0.01,0.98,0.9971083939193655,6076,6028
6,12204,10,100,0.001,0.01,0.978,0.9990167158308751,6124,6080
6,12304,10,100,0.001,0.01,0.964,0.9968302990897269,6175,6129
6,12404,10,100,0.001,0.01,0.956,0.9946791357626572,6224,6180
6,12504,10,100,0.001,0.01,0.956,0.993682021753039,6275,6229
6,12604,10,100,0.001,0.01,0.966,0.9898444938114884,6319,6285
6,12704,10,100,0.001,0.01,0.962,0.9934666246851386,6360,6344
6,12804,10,100,0.001,0.01,0.966,0.9919556388628553,6411,6393
6,12904,10,100,0.001,0.01,0.97,0.9933353998760074,6457,6447
6,13004,10,100,0.001,0.01,0.97,0.9956936327283913,6507,6497
6,13104,10,100,0.001,0.01,0.974,0.9971764346764347,6551,6553
6,13204,10,100,0.001,0.01,0.972,0.9983338382308391,6593,6611
6,13304,10,100,0.001,0.01,0.974,0.9990228502705953,6647,6657
6,13404,10,100,0.001,0.01,0.974,0.9993285586392122,6702,6702
6,13504,10,100,0.001,0.01,0.966,0.9997778436018957,6751,6753
6,13604,10,100,0.001,0.01,0.97,0.998897383122611,6801,6803
6,13704,10,100,0.001,0.01,0.972,0.9984676007005254,6843,6861
6,13804,10,100,0.001,0.01,0.966,0.9903651115618661,6895,6909
6,13904,10,100,0.001,0.01,0.958,0.9923762945914845,6944,6960
6,14004,10,100,0.001,0.01,0.968,0.992787774921451,7005,6999
6,14104,10,100,0.001,0.01,0.976,0.9972348269994328,7051,7053
6,14204,10,100,0.001,0.01,0.964,0.996268656716418,7102,7102
6,14304,10,100,0.001,0.01,0.964,0.9969239373601789,7151,7153
6,14404,10,100,0.001,0.01,0.968,0.9947236878644821,7196,7208
6,14504,10,100,0.001,0.01,0.948,0.9877964699393271,7247,7257
6,14604,10,100,0.001,0.01,0.964,0.9924678170364284,7292,7312
6,14704,10,100,0.001,0.01,0.972,0.9974836779107725,7335,7369
6,14804,10,100,0.001,0.01,0.962,0.9953390975412051,7382,7422
6,14904,10,100,0.001,0.01,0.966,0.9965110037573806,7435,7469
6,15004,10,100,0.001,0.01,0.972,0.9968008531058384,7495,7509
7,104,10,100,0.001,0.01,0.542,0.5096153846153846,51,53
7,204,10,100,0.001,0.01,0.548,0.5245098039215687,101,103
7,304,10,100,0.001,0.01,0.49,0.6052631578947368,146,158
7,404,10,100,0.001,0.01,0.474,0.556930693069307,200,204
7,504,10,100,0.001,0.01,0.464,0.5892857142857143,257,247
7,604,10,100,0.001,0.01,0.514,0.6026490066225165,306,298
7,704,10,100,0.001,0.01,0.514,0.6292613636363636,366,338
7,804,10,100,0.001,0.01,0.48,0.6218905472636815,413,391
7,904,10,100,0.001,0.01,0.478,0.6747787610619469,464,440
7,1004,10,100,0.001,0.01,0.478,0.6822709163346613,514,490
7,1104,10,100,0.001,0.01,0.484,0.6431159420289855,561,543
7,1204,10,100,0.001,0.01,0.528,0.665282392026578,610,594
7,1304,10,100,0.001,0.01,0.472,0.6587423312883436,656,648
7,1404,10,100,0.001,0.01,0.52,0.6844729344729344,703,701
7,1504,10,100,0.001,0.01,0.5,0.7480053191489362,759,745
7,1604,10,100,0.001,0.01,0.526,0.766209476309227,802,802
7,1704,10,100,0.001,0.01,0.53,0.7464788732394366,848,856
7,1804,10,100,0.001,0.01,0.616,0.7754988913525499,898,906
7,1904,10,100,0.001,0.01,0.59,0.7809873949579832,946,958
7,2004,10,100,0.001,0.01,0.616,0.8308383233532934,996,1008
7,2104,10,100,0.001,0.01,0.624,0.8540874524714829,1047,1057
7,2204,10,100,0.001,0.01,0.628,0.8457350272232305,1086,1118
7,2304,10,100,0.001,0.01,0.688,0.8532986111111112,1131,1173
7,2404,10,100,0.001,0.01,0.684,0.8885191347753744,1181,1223
7,2504,10,100,0.001,0.01,0.71,0.9109424920127795,1222,1282
7,2604,10,100,0.001,0.01,0.726,0.9205069124423964,1267,1337
7,2704,10,100,0.001,0.01,0.698,0.9045857988165681,1326,1378
7,2804,10,100,0.001,0.01,0.728,0.9151212553495007,1379,1425
7,2904,10,100,0.001,0.01,0.718,0.8715564738292011,1427,1477
7,3004,10,100,0.001,0.01,0.734,0.8924766977363515,1471,1533
7,3104,10,100,0.001,0.01,0.76,0.9155927835051546,1521,1583
7,3204,10,100,0.001,0.01,0.758,0.9391385767790262,1568,1636
7,3304,10,100,0.001,0.01,0.784,0.9539951573849879,1620,1684
7,3404,10,100,0.001,0.01,0.812,0.9612220916568742,1669,1735
7,3504,10,100,0.001,0.01,0.798,0.958904109589041,1728,1776
7,3604,10,100,0.001,0.01,0.8,0.9622641509433962,1774,1830
7,3704,10,100,0.001,0.01,0.81,0.978671706263499,1825,1879
7,3804,10,100,0.001,0.01,0.778,0.900105152471083,1877,1927
7,3904,10,100,0.001,0.01,0.788,0.8980532786885246,1931,1973
7,4004,10,100,0.001,0.01,0.786,0.942057942057942,1984,2020
7,4104,10,100,0.001,0.01,0.834,0.9544346978557505,2035,2069
7,4204,10,100,0.001,0.01,0.848,0.9662226450999049,2084,2120
7,4304,10,100,0.001,0.01,0.818,0.9556226765799256,2136,2168
7,4404,10,100,0.001,0.01,0.838,0.9623069936421436,2192,2212
7,4504,10,100,0.001,0.01,0.838,0.9698046181172292,2242,2262
7,4604,10,100,0.001,0.01,0.854,0.9700260642919201,2295,2309
7,4704,10,100,0.001,0.01,0.846,0.9757653061224489,2344,2360
7,4804,10,100,0.001,0.01,0.846,0.9812656119900083,2402,2402
7,4904,10,100,0.001,0.01,0.842,0.9810358890701468,2448,2456
7,5004,10,100,0.001,0.01,0.836,0.9676258992805755,2504,2500
7,5104,10,100,0.001,0.01,0.818,0.9337774294670846,2550,2554
7,5204,10,100,0.001,0.01,0.85,0.9588777863182167,2597,2607
7,5304,10,100,0.001,0.01,0.864,0.9626696832579186,2644,2660
7,5404,10,100,0.001,0.01,0.866,0.9768689859363434,2687,2717
7,5504,10,100,0.001,0.01,0.872,0.984375,2731,2773
7,5604,10,100,0.001,0.01,0.864,0.9880442541042113,2780,2824
7,5704,10,100,0.001,0.01,0.874,0.9866760168302945,2839,2865
7,5804,10,100,0.001,0.01,0.89,0.9801860785665059,2895,2909
7,5904,10,100,0.001,0.01,0.852,0.9642615176151762,2946,2958
7,6004,10,100,0.001,0.01,0.872,0.9683544303797469,2999,3005
7,6104,10,100,0.001,0.01,0.866,0.9759174311926605,3058,3046
7,6204,10,100,0.001,0.01,0.88,0.9824306898774984,3107,3097
7,6304,10,100,0.001,0.01,0.876,0.9881027918781726,3157,3147
7,6404,10,100,0.001,0.01,0.878,0.9831355402873204,3212,3192
7,6504,10,100,0.001,0.01,0.888,0.9420356703567035,3267,3237
7,6604,10,100,0.001,0.01,0.906,0.9662325863113265,3323,3281
7,6704,10,100,0.001,0.01,0.932,0.970763723150358,3377,3327
7,6804,10,100,0.001,0.01,0.922,0.9869194591416813,3421,3383
7,6904,10,100,0.001,0.01,0.922,0.9881228273464658,3475,3429
7,7004,10,100,0.001,0.01,0.938,0.9945745288406624,3521,3483
7,7104,10,100,0.001,0.01,0.934,0.9943693693693694,3582,3522
7,7204,10,100,0.001,0.01,0.934,0.9943087173792338,3641,3563
7,7304,10,100,0.001,0.01,0.944,0.9934282584884995,3689,3615
7,7404,10,100,0.001,0.01,0.934,0.9918962722852512,3744,3660
7,7504,10,100,0.001,0.01,0.94,0.9894722814498934,3796,3708
7,7604,10,100,0.001,0.01,0.936,0.9914518674381905,3835,3769
7,7704,10,100,0.001,0.01,0.946,0.993380062305296,3882,3822
7,7804,10,100,0.001,0.01,0.932,0.9947462839569452,3934,3870
7,7904,10,100,0.001,0.01,0.934,0.9921558704453441,3992,3912
7,8004,10,100,0.001,0.01,0.942,0.9932533733133433,4046,3958
7,8104,10,100,0.001,0.01,0.95,0.9954343534057256,4094,4010
7,8204,10,100,0.001,0.01,0.944,0.9945148707947343,4148,4056
7,8304,10,100,0.001,0.01,0.948,0.9871146435452793,4190,4114
7,8404,10,100,0.001,0.01,0.932,0.9782246549262256,4245,4159
7,8504,10,100,0.001,0.01,0.944,0.985653809971778,4299,4205
7,8604,10,100,0.001,0.01,0.954,0.9891910739191074,4349,4255
7,8704,10,100,0.001,0.01,0.954,0.9893152573529411,4402,4302
7,8804,10,100,0.001,0.01,0.944,0.9911403907314857,4454,4350
7,8904,10,100,0.001,0.01,0.946,0.9943845462713388,4499,4405
7,9004,10,100,0.001,0.01,0.964,0.9972234562416704,4556,4448
7,9104,10,100,0.001,0.01,0.96,0.9957161687170475,4610,4494
7,9204,10,100,0.001,0.01,0.964,0.9948935245545415,4653,4551
7,9304,10,100,0.001,0.01,0.964,0.9957007738607051,4706,4598
7,9404,10,100,0.001,0.01,0.974,0.9953211399404509,4759,4645
7,9504,10,100,0.001,0.01,0.968,0.9944234006734006,4804,4700
7,9604,10,100,0.001,0.01,0.954,0.9891711786755518,4858,4746
7,9704,10,100,0.001,0.01,0.958,0.9821723000824403,4906,4798
7,9804,10,100,0.001,0.01,0.976,0.9934720522235823,4951,4853
7,9904,10,100,0.001,0.01,0.972,0.996668012924071,4991,4913
7,10004,10,100,0.001,0.01,0.976,0.997001199520192,5047,4957
7,10104,10,100,0.001,0.01,0.968,0.9977236737925574,5105,4999
7,10204,10,100,0.001,0.01,0.974,0.9908859270874167,5156,5048
7,10304,10,100,0.001,0.01,0.96,0.9958268633540373,5204,5100
7,10404,10,100,0.001,0.01,0.97,0.9971164936562861,5254,5150
7,10504,10,100,0.001,0.01,0.976,0.9979055597867479,5302,5202
7,10604,10,100,0.001,0.01,0.976,0.9990569596378726,5360,5244
7,10704,10,100,0.001,0.01,0.972,0.9965433482810164,5408,5296
7,10804,10,100,0.001,0.01,0.962,0.9902813772676786,5461,5343
7,10904,10,100,0.001,0.01,0.954,0.9902787967718268,5504,5400
7,11004,10,100,0.001,0.01,0.964,0.9849145765176299,5552,5452
7,11104,10,100,0.001,0.01,0.974,0.9959474063400576,5606,5498
7,11204,10,100,0.001,0.01,0.976,0.9986611924312745,5662,5542
7,11304,10,100,0.001,0.01,0.976,0.9978768577494692,5708,5596
7,11404,10,100,0.001,0.01,0.986,0.9994738688179586,5754,5650
7,11504,10,100,0.001,0.01,0.98,0.9985222531293463,5792,5712
7,11604,10,100,0.001,0.01,0.98,0.9976732161323681,5840,5764
7,11704,10,100,0.001,0.01,0.988,1.0,5901,5803
7,11804,10,100,0.001,0.01,0.984,1.0,5947,5857
7,11904,10,100,0.001,0.01,0.976,0.9968077956989247,5989,5915
7,12004,10,100,0.001,0.01,0.964,0.9914195268243918,6034,5970
7,12104,10,100,0.001,0.01,0.958,0.9845505617977528,6079,6025
7,12204,10,100,0.001,0.01,0.982,0.9924614880367093,6128,6076
7,12304,10,100,0.001,0.01,0.98,0.9965052015604682,6187,6117
7,12404,10,100,0.001,0.01,0.988,0.9984682360528861,6238,6166
7,12504,10,100,0.001,0.01,0.984,0.9984804862444018,6281,6223
7,12604,10,100,0.001,0.01,0.986,0.9986512218343383,6327,6277
7,12704,10,100,0.001,0.01,0.986,0.9995277078085643,6367,6337
7,12804,10,100,0.001,0.01,0.984,0.9953139643861293,6425,6379
7,12904,10,100,0.001,0.01,0.984,0.9955827650340979,6478,6426
7,13004,10,100,0.001,0.01,0.978,0.987465395262996,6520,6484
7,13104,10,100,0.001,0.01,0.99,0.9955738705738706,6571,6533
7,13204,10,100,0.001,0.01,0.984,0.9932596182974857,6624,6580
7,13304,10,100,0.001,0.01,0.978,0.990829825616356,6671,6633
7,13404,10,100,0.001,0.01,0.984,0.9946284691136974,6719,6685
7,13504,10,100,0.001,0.01,0.998,0.9980005924170616,6765,6739
7,13604,10,100,0.001,0.01,0.99,0.9991179064980888,6812,6792
7,13704,10,100,0.001,0.01,0.99,0.9997081144191476,6861,6843
7,13804,10,100,0.001,0.01,0.988,0.9981164879745001,6903,6901
7,13904,10,100,0.001,0.01,0.996,0.9995684695051784,6955,6949
7,14004,10,100,0.001,0.01,0.99,0.9999285918309054,6997,7007
7,14104,10,100,0.001,0.01,0.996,0.9999290981281905,7054,7050
7,14204,10,100,0.001,0.01,0.998,0.9992959729653619,7107,7097
7,14304,10,100,0.001,0.01,0.988,0.9955956375838926,7167,7137
7,14404,10,100,0.001,0.01,0.966,0.9750763676756456,7215,7189
7,14504,10,100,0.001,0.01,0.978,0.991588527302813,7267,7237
7,14604,10,100,0.001,0.01,0.988,0.9973979731580389,7324,7280
7,14704,10,100,0.001,0.01,1.0,0.9984357997823722,7374,7330
7,14804,10,100,0.001,0.01,0.992,0.9977708727370981,7431,7373
7,14904,10,100,0.001,0.01,0.996,0.9989264626945786,7477,7427
7,15004,10,100,0.001,0.01,0.998,0.9995334577446015,7523,7481
8,104,10,100,0.001,0.01,0.506,0.4423076923076923,46,58
8,204,10,100,0.001,0.01,0.496,0.6813725490196079,103,101
8,304,10,100,0.001,0.01,0.498,0.6776315789473685,152,152
8,404,10,100,0.001,0.01,0.516,0.698019801980198,199,205
8,504,10,100,0.001,0.01,0.504,0.7063492063492064,238,266
8,604,10,100,0.001,0.01,0.508,0.7086092715231788,290,314
8,704,10,100,0.001,0.01,0.538,0.6931818181818182,345,359
8,804,10,100,0.001,0.01,0.526,0.681592039800995,394,410
8,904,10,100,0.001,0.01,0.53,0.7002212389380531,447,457
8,1004,10,100,0.001,0.01,0.508,0.701195219123506,495,509
8,1104,10,100,0.001,0.01,0.528,0.7128623188405797,549,555
8,1204,10,100,0.001,0.01,0.518,0.7018272425249169,599,605
8,1304,10,100,0.001,0.01,0.526,0.7331288343558282,645,659
8,1404,10,100,0.001,0.01,0.514,0.7713675213675214,701,703
8,1504,10,100,0.001,0.01,0.528,0.7726063829787234,752,752
8,1604,10,100,0.001,0.01,0.548,0.7599750623441397,789,815
8,1704,10,100,0.001,0.01,0.57,0.7699530516431925,843,861
8,1804,10,100,0.001,0.01,0.608,0.8187361419068736,892,912
8,1904,10,100,0.001,0.01,0.602,0.835609243697479,950,954
8,2004,10,100,0.001,0.01,0.594,0.845309381237525,1009,995
8,2104,10,100,0.001,0.01,0.642,0.8393536121673004,1058,1046
8,2204,10,100,0.001,0.01,0.632,0.8425589836660617,1113,1091
8,2304,10,100,0.001,0.01,0.63,0.8255208333333334,1164,1140
8,2404,10,100,0.001,0.01,0.676,0.8377703826955075,1210,1194
8,2504,10,100,0.001,0.01,0.648,0.8466453674121406,1262,1242
8,2604,10,100,0.001,0.01,0.7,0.8874807987711214,1308,1296
8,2704,10,100,0.001,0.01,0.718,0.915310650887574,1363,1341
8,2804,10,100,0.001,0.01,0.722,0.9111982881597718,1407,1397
8,2904,10,100,0.001,0.01,0.752,0.9297520661157025,1452,1452
8,3004,10,100,0.001,0.01,0.728,0.9404127829560586,1506,1498
8,3104,10,100,0.001,0.01,0.764,0.9333118556701031,1557,1547
8,3204,10,100,0.001,0.01,0.756,0.9444444444444444,1601,1603
8,3304,10,100,0.001,0.01,0.762,0.924636803874092,1652,1652
8,3404,10,100,0.001,0.01,0.764,0.9433019976498237,1702,1702
8,3504,10,100,0.001,0.01,0.8,0.9577625570776256,1754,1750
8,3604,10,100,0.001,0.01,0.794,0.9572697003329633,1806,1798
8,3704,10,100,0.001,0.01,0.796,0.9443844492440605,1864,1840
8,3804,10,100,0.001,0.01,0.78,0.9445320715036803,1912,1892
8,3904,10,100,0.001,0.01,0.812,0.9444159836065574,1962,1942
8,4004,10,100,0.001,0.01,0.816,0.9493006993006993,2011,1993
8,4104,10,100,0.001,0.01,0.818,0.9468810916179338,2056,2048
8,4204,10,100,0.001,0.01,0.844,0.9595623215984777,2107,2097
8,4304,10,100,0.001,0.01,0.842,0.9804832713754646,2153,2151
8,4404,10,100,0.001,0.01,0.828,0.9752497729336966,2205,2199
8,4504,10,100,0.001,0.01,0.854,0.9840142095914742,2263,2241
8,4604,10,100,0.001,0.01,0.862,0.9784969591659427,2318,2286
8,4704,10,100,0.001,0.01,0.844,0.9617346938775511,2367,2337
8,4804,10,100,0.001,0.01,0.87,0.9739800166527893,2421,2383
8,4904,10,100,0.001,0.01,0.87,0.9853181076672104,2457,2447
8,5004,10,100,0.001,0.01,0.87,0.9892086330935251,2506,2498
8,5104,10,100,0.001,0.01,0.872,0.9886363636363636,2552,2552
8,5204,10,100,0.001,0.01,0.89,0.9857801691006918,2607,2597
8,5304,10,100,0.001,0.01,0.862,0.9671945701357466,2654,2650
8,5404,10,100,0.001,0.01,0.858,0.9602146558105107,2697,2707
8,5504,10,100,0.001,0.01,0.86,0.9725654069767442,2743,2761
8,5604,10,100,0.001,0.01,0.882,0.9809064953604568,2793,2811
8,5704,10,100,0.001,0.01,0.898,0.9854488078541375,2854,2850
8,5804,10,100,0.001,0.01,0.89,0.9820813232253618,2899,2905
8,5904,10,100,0.001,0.01,0.906,0.989159891598916,2948,2956
8,6004,10,100,0.001,0.01,0.888,0.9865089940039974,3001,3003
8,6104,10,100,0.001,0.01,0.914,0.984600262123198,3055,3049
8,6204,10,100,0.001,0.01,0.89,0.9838813668600903,3106,3098
8,6304,10,100,0.001,0.01,0.886,0.9701776649746193,3157,3147
8,6404,10,100,0.001,0.01,0.91,0.9793878825733916,3206,3198
8,6504,10,100,0.001,0.01,0.914,0.9880073800738007,3247,3257
8,6604,10,100,0.001,0.01,0.912,0.9909145972138098,3294,3310
8,6704,10,100,0.001,0.01,0.922,0.9920942720763724,3335,3369
8,6804,10,100,0.001,0.01,0.91,0.9833921222810111,3389,3415
8,6904,10,100,0.001,0.01,0.922,0.9937717265353418,3437,3467
8,7004,10,100,0.001,0.01,0.926,0.9852941176470589,3493,3511
8,7104,10,100,0.001,0.01,0.92,0.9818412162162162,3538,3566
8,7204,10,100,0.001,0.01,0.92,0.9833425874514159,3590,3614
8,7304,10,100,0.001,0.01,0.926,0.9875410733844469,3638,3666
8,7404,10,100,0.001,0.01,0.916,0.9873041599135602,3687,3717
8,7504,10,100,0.001,0.01,0.934,0.9913379530916845,3731,3773
8,7604,10,100,0.001,0.01,0.928,0.9894792214623882,3780,3824
8,7704,10,100,0.001,0.01,0.932,0.9920820353063343,3832,3872
8,7804,10,100,0.001,0.01,0.934,0.9857765248590467,3875,3929
8,7904,10,100,0.001,0.01,0.93,0.9754554655870445,3915,3989
8,8004,10,100,0.001,0.01,0.94,0.9851324337831084,3967,4037
8,8104,10,100,0.001,0.01,0.934,0.9882773938795657,4026,4078
8,8204,10,100,0.001,0.01,0.944,0.9914675767918089,4089,4115
8,8304,10,100,0.001,0.01,0.942,0.9928949903660886,4140,4164
8,8404,10,100,0.001,0.01,0.938,0.9920276059019515,4189,4215
8,8504,10,100,0.001,0.01,0.948,0.9948259642521167,4247,4257
8,8604,10,100,0.001,0.01,0.95,0.9973268247326825,4302,4302
8,8704,10,100,0.001,0.01,0.932,0.9904641544117647,4352,4352
8,8804,10,100,0.001,0.01,0.95,0.9893230349840981,4408,4396
8,8904,10,100,0.001,0.01,0.946,0.9940476190476191,4458,4446
8,9004,10,100,0.001,0.01,0.954,0.9907818747223456,4515,4489
8,9104,10,100,0.001,0.01,0.96,0.9957161687170475,4564,4540
8,9204,10,100,0.001,0.01,0.948,0.9935897435897436,4612,4592
8,9304,10,100,0.001,0.01,0.928,0.9799011177987962,4663,4641
8,9404,10,100,0.001,0.01,0.952,0.9915993194385367,4720,4684
8,9504,10,100,0.001,0.01,0.95,0.9946338383838383,4766,4738
8,9604,10,100,0.001,0.01,0.928,0.9753227821740942,4814,4790
8,9704,10,100,0.001,0.01,0.948,0.9943322341302555,4871,4833
8,9804,10,100,0.001,0.01,0.946,0.994390044879641,4920,4884
8,9904,10,100,0.001,0.01,0.958,0.996062197092084,4972,4932
8,10004,10,100,0.001,0.01,0.952,0.9935025989604158,5025,4979
8,10104,10,100,0.001,0.01,0.958,0.9922802850356295,5075,5029
8,10204,10,100,0.001,0.01,0.954,0.9801058408467268,5126,5078
8,10304,10,100,0.001,0.01,0.946,0.9836956521739131,5163,5141
8,10404,10,100,0.001,0.01,0.952,0.9886582083813917,5211,5193
8,10504,10,100,0.001,0.01,0.962,0.9955255140898706,5256,5248
8,10604,10,100,0.001,0.01,0.962,0.9983968313843833,5305,5299
8,10704,10,100,0.001,0.01,0.964,0.9972907324364724,5351,5353
8,10804,10,100,0.001,0.01,0.966,0.9980562754535357,5409,5395
8,10904,10,100,0.001,0.01,0.962,0.9966984592809978,5439,5465
8,11004,10,100,0.001,0.01,0.966,0.9958197019265722,5494,5510
8,11104,10,100,0.001,0.01,0.972,0.9977485590778098,5548,5556
8,11204,10,100,0.001,0.01,0.968,0.9952695465905034,5603,5601
8,11304,10,100,0.001,0.01,0.934,0.9716914366595896,5652,5652
8,11404,10,100,0.001,0.01,0.952,0.985619081024202,5702,5702
8,11504,10,100,0.001,0.01,0.958,0.9867872044506258,5749,5755
8,11604,10,100,0.001,0.01,0.96,0.9918993450534298,5804,5800
8,11704,10,100,0.001,0.01,0.97,0.9976076555023924,5847,5857
8,11804,10,100,0.001,0.01,0.972,0.9986445272788885,5895,5909
8,11904,10,100,0.001,0.01,0.966,0.9969758064516129,5942,5962
8,12004,10,100,0.001,0.01,0.968,0.9927524158613795,5989,6015
8,12104,10,100,0.001,0.01,0.97,0.9982650363516193,6043,6061
8,12204,10,100,0.001,0.01,0.974,0.9978695509668961,6104,6100
8,12304,10,100,0.001,0.01,0.964,0.9964239271781534,6154,6150
8,12404,10,100,0.001,0.01,0.966,0.9954853273137697,6203,6201
8,12504,10,100,0.001,0.01,0.95,0.9896033269353807,6253,6251
8,12604,10,100,0.001,0.01,0.97,0.9913519517613456,6300,6304
8,12704,10,100,0.001,0.01,0.964,0.9807934508816121,6357,6347
8,12804,10,100,0.001,0.01,0.97,0.9900812246173071,6413,6391
8,12904,10,100,0.001,0.01,0.972,0.9930254184748915,6465,6439
8,13004,10,100,0.001,0.01,0.974,0.9953860350661335,6514,6490
8,13104,10,100,0.001,0.01,0.97,0.9970238095238095,6563,6541
8,13204,10,100,0.001,0.01,0.974,0.9979551651014844,6609,6595
8,13304,10,100,0.001,0.01,0.974,0.9992483463619964,6658,6646
8,13404,10,100,0.001,0.01,0.974,0.9992539540435691,6713,6691
8,13504,10,100,0.001,0.01,0.966,0.9974081753554502,6779,6725
8,13604,10,100,0.001,0.01,0.974,0.9958100558659218,6829,6775
8,13704,10,100,0.001,0.01,0.966,0.9932136602451839,6876,6828
8,13804,10,100,0.001,0.01,0.974,0.9842799188640974,6929,6875
8,13904,10,100,0.001,0.01,0.976,0.9968354430379747,6978,6926
8,14004,10,100,0.001,0.01,0.974,0.9964295915452728,7033,6971
8,14104,10,100,0.001,0.01,0.972,0.9939733408961997,7081,7023
8,14204,10,100,0.001,0.01,0.968,0.9867642917488032,7128,7076
8,14304,10,100,0.001,0.01,0.97,0.9944770693512305,7177,7127
8,14404,10,100,0.001,0.01,0.972,0.9925715079144682,7219,7185
8,14504,10,100,0.001,0.01,0.976,0.9979316050744622,7267,7237
8,14604,10,100,0.001,0.01,0.976,0.9978772938920843,7307,7297
8,14704,10,100,0.001,0.01,0.972,0.9945593035908596,7358,7346
8,14804,10,100,0.001,0.01,0.978,0.9954741961631991,7409,7395
8,14904,10,100,0.001,0.01,0.972,0.9957729468599034,7455,7449
8,15004,10,100,0.001,0.01,0.972,0.9924686750199947,7499,7505
9,104,10,100,0.001,0.01,0.524,0.5288461538461539,48,56
9,204,10,100,0.001,0.01,0.482,0.553921568627451,104,100
9,304,10,100,0.001,0.01,0.496,0.680921052631579,141,163
9,404,10,100,0.001,0.01,0.502,0.6188118811881188,191,213
9,504,10,100,0.001,0.01,0.484,0.6666666666666666,251,253
9,604,10,100,0.001,0.01,0.466,0.6158940397350994,305,299
9,704,10,100,0.001,0.01,0.48,0.640625,341,363
9,804,10,100,0.001,0.01,0.494,0.6554726368159204,386,418
9,904,10,100,0.001,0.01,0.494,0.672566371681416,431,473
9,1004,10,100,0.001,0.01,0.488,0.702191235059761,484,520
9,1104,10,100,0.001,0.01,0.484,0.6938405797101449,533,571
9,1204,10,100,0.001,0.01,0.506,0.7026578073089701,581,623
9,1304,10,100,0.001,0.01,0.488,0.7116564417177914,634,670
9,1404,10,100,0.001,0.01,0.498,0.7307692307692307,691,713
9,1504,10,100,0.001,0.01,0.536,0.723404255319149,743,761
9,1604,10,100,0.001,0.01,0.486,0.7556109725685786,791,813
9,1704,10,100,0.001,0.01,0.472,0.721244131455399,841,863
9,1804,10,100,0.001,0.01,0.51,0.7699556541019955,892,912
9,1904,10,100,0.001,0.01,0.512,0.7531512605042017,934,970
9,2004,10,100,0.001,0.01,0.534,0.7904191616766467,977,1027
9,2104,10,100,0.001,0.01,0.532,0.7756653992395437,1024,1080
9,2204,10,100,0.001,0.01,0.558,0.7481851179673321,1074,1130
9,2304,10,100,0.001,0.01,0.534,0.8233506944444444,1128,1176
9,2404,10,100,0.001,0.01,0.51,0.8240432612312812,1190,1214
9,2504,10,100,0.001,0.01,0.504,0.8258785942492013,1236,1268
9,2604,10,100,0.001,0.01,0.528,0.8556067588325653,1284,1320
9,2704,10,100,0.001,0.01,0.512,0.8176775147928994,1331,1373
9,2804,10,100,0.001,0.01,0.552,0.8434379457917262,1389,1415
9,2904,10,100,0.001,0.01,0.55,0.8178374655647382,1435,1469
9,3004,10,100,0.001,0.01,0.554,0.8525299600532623,1488,1516
9,3104,10,100,0.001,0.01,0.54,0.8460051546391752,1540,1564
9,3204,10,100,0.001,0.01,0.558,0.8626716604244694,1587,1617
9,3304,10,100,0.001,0.01,0.544,0.8171912832929782,1636,1668
9,3404,10,100,0.001,0.01,0.582,0.7923031727379554,1687,1717
9,3504,10,100,0.001,0.01,0.594,0.8458904109589042,1738,1766
9,3604,10,100,0.001,0.01,0.566,0.8515538290788013,1787,1817
9,3704,10,100,0.001,0.01,0.604,0.9006479481641468,1833,1871
9,3804,10,100,0.001,0.01,0.62,0.9121976866456362,1883,1921
9,3904,10,100,0.001,0.01,0.616,0.9177766393442623,1931,1973
9,4004,10,100,0.001,0.01,0.648,0.8908591408591409,1982,2022
9,4104,10,100,0.001,0.01,0.628,0.8223684210526315,2025,2079
9,4204,10,100,0.001,0.01,0.622,0.870837297811608,2083,2121
9,4304,10,100,0.001,0.01,0.634,0.8703531598513011,2140,2164
9,4404,10,100,0.001,0.01,0.636,0.905086285195277,2194,2210
9,4504,10,100,0.001,0.01,0.64,0.9031971580817052,2240,2264
9,4604,10,100,0.001,0.01,0.656,0.9176802780191138,2292,2312
9,4704,10,100,0.001,0.01,0.642,0.9243197278911565,2342,2362
9,4804,10,100,0.001,0.01,0.696,0.9236053288925895,2383,2421
9,4904,10,100,0.001,0.01,0.68,0.9115008156606852,2435,2469
9,5004,10,100,0.001,0.01,0.696,0.929056754596323,2486,2518
9,5104,10,100,0.001,0.01,0.69,0.9212382445141066,2534,2570
9,5204,10,100,0.001,0.01,0.726,0.9329362029208301,2593,2611
9,5304,10,100,0.001,0.01,0.724,0.9509803921568627,2648,2656
9,5404,10,100,0.001,0.01,0.704,0.9437453737971873,2697,2707
9,5504,10,100,0.001,0.01,0.706,0.9358648255813954,2746,2758
9,5604,10,100,0.001,0.01,0.736,0.935581727337616,2790,2814
9,5704,10,100,0.001,0.01,0.726,0.9030504908835905,2843,2861
9,5804,10,100,0.001,0.01,0.752,0.934355616815989,2890,2914
9,5904,10,100,0.001,0.01,0.766,0.9461382113821138,2932,2972
9,6004,10,100,0.001,0.01,0.74,0.9348767488341105,2984,3020
9,6104,10,100,0.001,0.01,0.76,0.9333224115334207,3042,3062
9,6204,10,100,0.001,0.01,0.75,0.9323017408123792,3088,3116
9,6304,10,100,0.001,0.01,0.76,0.9324238578680203,3137,3167
9,6404,10,100,0.001,0.01,0.76,0.9478450968144909,3196,3208
9,6504,10,100,0.001,0.01,0.74,0.9363468634686347,3243,3261
9,6604,10,100,0.001,0.01,0.786,0.9413991520290733,3300,3304
9,6704,10,100,0.001,0.01,0.786,0.9595763723150358,3352,3352
9,6804,10,100,0.001,0.01,0.794,0.9707524985302763,3394,3410
9,6904,10,100,0.001,0.01,0.804,0.977404403244496,3440,3464
9,7004,10,100,0.001,0.01,0.8,0.9814391776127926,3493,3511
9,7104,10,100,0.001,0.01,0.8,0.9767736486486487,3551,3553
9,7204,10,100,0.001,0.01,0.792,0.9665463631315936,3604,3600
9,7304,10,100,0.001,0.01,0.804,0.9726177437020811,3648,3656
9,7404,10,100,0.001,0.01,0.814,0.9736628849270664,3696,3708
9,7504,10,100,0.001,0.01,0.78,0.9772121535181236,3745,3759
9,7604,10,100,0.001,0.01,0.81,0.9711993687532877,3795,3809
9,7704,10,100,0.001,0.01,0.82,0.9772845275181724,3837,3867
9,7804,10,100,0.001,0.01,0.848,0.9752690927729369,3885,3919
9,7904,10,100,0.001,0.01,0.832,0.9774797570850202,3943,3961
9,8004,10,100,0.001,0.01,0.826,0.9711394302848576,3993,4011
9,8104,10,100,0.001,0.01,0.83,0.9813672260612043,4046,4058
9,8204,10,100,0.001,0.01,0.81,0.9701365187713311,4094,4110
9,8304,10,100,0.001,0.01,0.836,0.9773603082851637,4140,4164
9,8404,10,100,0.001,0.01,0.79,0.9575202284626368,4192,4212
9,8504,10,100,0.001,0.01,0.8,0.903692380056444,4241,4263
9,8604,10,100,0.001,0.01,0.814,0.9509530450953045,4296,4308
9,8704,10,100,0.001,0.01,0.814,0.9608226102941176,4347,4357
9,8804,10,100,0.001,0.01,0.826,0.9679691049522944,4397,4407
9,8904,10,100,0.001,0.01,0.85,0.97911051212938,4446,4458
9,9004,10,100,0.001,0.01,0.828,0.9775655264326966,4499,4505
9,9104,10,100,0.001,0.01,0.824,0.9636423550087874,4558,4546
9,9204,10,100,0.001,0.01,0.832,0.9751195132551065,4599,4605
9,9304,10,100,0.001,0.01,0.846,0.9850601891659502,4650,4654
9,9404,10,100,0.001,0.01,0.84,0.986282433007231,4700,4704
9,9504,10,100,0.001,0.01,0.84,0.9869528619528619,4745,4759
9,9604,10,100,0.001,0.01,0.848,0.9880258225739276,4793,4811
9,9704,10,100,0.001,0.01,0.85,0.9788746908491344,4842,4862
9,9804,10,100,0.001,0.01,0.846,0.9805181558547532,4899,4905
9,9904,10,100,0.001,0.01,0.834,0.9765751211631664,4956,4948
9,10004,10,100,0.001,0.01,0.852,0.975609756097561,5016,4988
9,10104,10,100,0.001,0.01,0.836,0.9643705463182898,5065,5039
9,10204,10,100,0.001,0.01,0.842,0.9817718541748334,5116,5088
9,10304,10,100,0.001,0.01,0.836,0.9879658385093167,5156,5148
9,10404,10,100,0.001,0.01,0.868,0.9903883121876201,5200,5204
9,10504,10,100,0.001,0.01,0.858,0.988956587966489,5253,5251
9,10604,10,100,0.001,0.01,0.876,0.9889664277631083,5308,5296
9,10704,10,100,0.001,0.01,0.856,0.9912182361733931,5355,5349
9,10804,10,100,0.001,0.01,0.864,0.9839874120696038,5403,5401
9,10904,10,100,0.001,0.01,0.844,0.9769809244314013,5455,5449
9,11004,10,100,0.001,0.01,0.86,0.982824427480916,5503,5501
9,11104,10,100,0.001,0.01,0.858,0.9731628242074928,5556,5548
9,11204,10,100,0.001,0.01,0.858,0.9806319171724384,5607,5597
9,11304,10,100,0.001,0.01,0.852,0.9777954706298655,5656,5648
9,11404,10,100,0.001,0.01,0.856,0.9819361627499124,5710,5694
9,11504,10,100,0.001,0.01,0.844,0.9793984700973575,5761,5743
9,11604,10,100,0.001,0.01,0.846,0.9848328162702517,5800,5804
9,11704,10,100,0.001,0.01,0.864,0.9845352016404648,5848,5856
9,11804,10,100,0.001,0.01,0.868,0.9877160284649271,5895,5909
9,11904,10,100,0.001,0.01,0.872,0.9914314516129032,5929,5975
9,12004,10,100,0.001,0.01,0.868,0.988003998667111,5980,6024
9,12104,10,100,0.001,0.01,0.878,0.971083939193655,6030,6074
9,12204,10,100,0.001,0.01,0.856,0.9711569977056703,6079,6125
9,12304,10,100,0.001,0.01,0.868,0.9883777633289987,6131,6173
9,12404,10,100,0.001,0.01,0.874,0.9872621734924218,6191,6213
9,12504,10,100,0.001,0.01,0.856,0.9836852207293666,6240,6264
9,12604,10,100,0.001,0.01,0.884,0.9895271342430975,6292,6312
9,12704,10,100,0.001,0.01,0.858,0.9807934508816121,6343,6361
9,12804,10,100,0.001,0.01,0.832,0.9570446735395189,6386,6418
9,12904,10,100,0.001,0.01,0.818,0.9276193428394296,6438,6466
9,13004,10,100,0.001,0.01,0.86,0.9553214395570594,6493,6511
9,13104,10,100,0.001,0.01,0.884,0.9752747252747253,6538,6566
9,13204,10,100,0.001,0.01,0.88,0.9720539230536202,6579,6625
9,13304,10,100,0.001,0.01,0.886,0.9860192423331329,6629,6675
9,13404,10,100,0.001,0.01,0.898,0.9856013130408833,6682,6722
9,13504,10,100,0.001,0.01,0.892,0.9833382701421801,6735,6769
9,13604,10,100,0.001,0.01,0.872,0.976845045574831,6783,6821
9,13704,10,100,0.001,0.01,0.894,0.9863543490951547,6822,6882
9,13804,10,100,0.001,0.01,0.898,0.9810924369747899,6873,6931
9,13904,10,100,0.001,0.01,0.912,0.9888521288837745,6925,6979
9,14004,10,100,0.001,0.01,0.886,0.9872179377320766,6971,7033
9,14104,10,100,0.001,0.01,0.906,0.9719228587634714,7023,7081
9,14204,10,100,0.001,0.01,0.89,0.9755702618980568,7075,7129
9,14304,10,100,0.001,0.01,0.912,0.9803551454138703,7130,7174
9,14404,10,100,0.001,0.01,0.902,0.9866703693418495,7185,7219
9,14504,10,100,0.001,0.01,0.902,0.987934362934363,7236,7268
9,14604,10,100,0.001,0.01,0.922,0.9858258011503698,7283,7321
9,14704,10,100,0.001,0.01,0.912,0.9922470076169749,7335,7369
9,14804,10,100,0.001,0.01,0.9,0.9889219129964875,7385,7419
9,14904,10,100,0.001,0.01,0.914,0.9890633387010198,7435,7469
9,15004,10,100,0.001,0.01,0.896,0.9804052252732605,7486,7518
10,104,10,100,0.001,0.01,0.52,0.49038461538461536,51,53
10,204,10,100,0.001,0.01,0.514,0.6470588235294118,109,95
10,304,10,100,0.001,0.01,0.484,0.5789473684210527,157,147
10,404,10,100,0.001,0.01,0.494,0.6212871287128713,204,200
10,504,10,100,0.001,0.01,0.502,0.623015873015873,255,249
10,604,10,100,0.001,0.01,0.514,0.6572847682119205,300,304
10,704,10,100,0.001,0.01,0.492,0.6676136363636364,353,351
10,804,10,100,0.001,0.01,0.522,0.6865671641791045,404,400
10,904,10,100,0.001,0.01,0.546,0.6880530973451328,453,451
10,1004,10,100,0.001,0.01,0.508,0.704183266932271,497,507
10,1104,10,100,0.001,0.01,0.512,0.6920289855072463,545,559
10,1204,10,100,0.001,0.01,0.522,0.7225913621262459,601,603
10,1304,10,100,0.001,0.01,0.51,0.7415644171779141,652,652
10,1404,10,100,0.001,0.01,0.494,0.7293447293447294,702,702
10,1504,10,100,0.001,0.01,0.486,0.7253989361702128,752,752
10,1604,10,100,0.001,0.01,0.504,0.7549875311720698,803,801
10,1704,10,100,0.001,0.01,0.524,0.7417840375586855,848,856
10,1804,10,100,0.001,0.01,0.552,0.7505543237250555,898,906
10,1904,10,100,0.001,0.01,0.564,0.7662815126050421,940,964
10,2004,10,100,0.001,0.01,0.528,0.7839321357285429,998,1006
10,2104,10,100,0.001,0.01,0.532,0.8255703422053232,1051,1053
10,2204,10,100,0.001,0.01,0.534,0.8362068965517241,1103,1101
10,2304,10,100,0.001,0.01,0.542,0.7890625,1162,1142
10,2404,10,100,0.001,0.01,0.564,0.8381863560732113,1218,1186
10,2504,10,100,0.001,0.01,0.56,0.8406549520766773,1270,1234
10,2604,10,100,0.001,0.01,0.578,0.8824884792626728,1324,1280
10,2704,10,100,0.001,0.01,0.604,0.8450443786982249,1365,1339
10,2804,10,100,0.001,0.01,0.674,0.8848074179743224,1417,1387
10,2904,10,100,0.001,0.01,0.654,0.8488292011019284,1462,1442
10,3004,10,100,0.001,0.01,0.65,0.9054593874833555,1516,1488
10,3104,10,100,0.001,0.01,0.68,0.9220360824742269,1575,1529
10,3204,10,100,0.001,0.01,0.724,0.9450686641697877,1623,1581
10,3304,10,100,0.001,0.01,0.722,0.9494552058111381,1677,1627
10,3404,10,100,0.001,0.01,0.74,0.9430082256169212,1720,1684
10,3504,10,100,0.001,0.01,0.77,0.96175799086758,1766,1738
10,3604,10,100,0.001,0.01,0.79,0.970865704772475,1814,1790
10,3704,10,100,0.001,0.01,0.804,0.9781317494600432,1857,1847
10,3804,10,100,0.001,0.01,0.796,0.9768664563617245,1904,1900
10,3904,10,100,0.001,0.01,0.806,0.9761782786885246,1950,1954
10,4004,10,100,0.001,0.01,0.79,0.975024975024975,1999,2005
10,4104,10,100,0.001,0.01,0.8,0.9878167641325536,2051,2053
10,4204,10,100,0.001,0.01,0.802,0.9747859181731684,2109,2095
10,4304,10,100,0.001,0.01,0.826,0.974907063197026,2153,2151
10,4404,10,100,0.001,0.01,0.834,0.9795640326975477,2201,2203
10,4504,10,100,0.001,0.01,0.796,0.9564831261101243,2253,2251
10,4604,10,100,0.001,0.01,0.844,0.9841442224152911,2301,2303
10,4704,10,100,0.001,0.01,0.87,0.9887329931972789,2348,2356
10,4804,10,100,0.001,0.01,0.848,0.9866777685262281,2399,2405
10,4904,10,100,0.001,0.01,0.872,0.9938825448613376,2452,2452
10,5004,10,100,0.001,0.01,0.866,0.9914068745003997,2502,2502
10,5104,10,100,0.001,0.01,0.862,0.9894200626959248,2550,2554
10,5204,10,100,0.001,0.01,0.896,0.9907763259031515,2596,2608
10,5304,10,100,0.001,0.01,0.88,0.9935897435897436,2654,2650
10,5404,10,100,0.001,0.01,0.896,0.9929681717246485,2706,2698
10,5504,10,100,0.001,0.01,0.892,0.9940043604651163,2752,2752
10,5604,10,100,0.001,0.01,0.888,0.9926837972876517,2805,2799
10,5704,10,100,0.001,0.01,0.894,0.9914095371669004,2860,2844
10,5804,10,100,0.001,0.01,0.876,0.9734665747760165,2911,2893
10,5904,10,100,0.001,0.01,0.904,0.988990514905149,2957,2947
10,6004,10,100,0.001,0.01,0.9,0.9880079946702198,3014,2990
10,6104,10,100,0.001,0.01,0.896,0.9896788990825688,3066,3038
10,6204,10,100,0.001,0.01,0.91,0.9943584784010316,3118,3086
10,6304,10,100,0.001,0.01,0.91,0.993020304568528,3176,3128
10,6404,10,100,0.001,0.01,0.908,0.9954715802623361,3232,3172
10,6504,10,100,0.001,0.01,0.908,0.9952337023370234,3280,3224
10,6604,10,100,0.001,0.01,0.894,0.9831920048455481,3324,3280
10,6704,10,100,0.001,0.01,0.902,0.9901551312649165,3367,3337
10,6804,10,100,0.001,0.01,0.89,0.9767783656672545,3415,3389
10,6904,10,100,0.001,0.01,0.916,0.9911645422943222,3468,3436
10,7004,10,100,0.001,0.01,0.92,0.9948600799543118,3522,3482
10,7104,10,100,0.001,0.01,0.924,0.9938063063063063,3572,3532
10,7204,10,100,0.001,0.01,0.918,0.9861188228761799,3619,3585
10,7304,10,100,0.001,0.01,0.918,0.9832968236582694,3668,3636
10,7404,10,100,0.001,0.01,0.924,0.9897352782279849,3720,3684
10,7504,10,100,0.001,0.01,0.914,0.9886727078891258,3769,3735
10,7604,10,100,0.001,0.01,0.914,0.9911888479747502,3815,3789
10,7704,10,100,0.001,0.01,0.926,0.9931204569055037,3864,3840
10,7804,10,100,0.001,0.01,0.932,0.9934648898001025,3918,3886
10,7904,10,100,0.001,0.01,0.938,0.9850708502024291,3962,3942
10,8004,10,100,0.001,0.01,0.914,0.9703898050974513,4010,3994
10,8104,10,100,0.001,0.01,0.918,0.9880306021717671,4061,4043
10,8204,10,100,0.001,0.01,0.928,0.9907362262311068,4111,4093
10,8304,10,100,0.001,0.01,0.942,0.9980732177263969,4159,4145
10,8404,10,100,0.001,0.01,0.938,0.997977153736316,4215,4189
10,8504,10,100,0.001,0.01,0.944,0.9996472248353716,4261,4243
10,8604,10,100,0.001,0.01,0.942,0.9996513249651325,4303,4301
10,8704,10,100,0.001,0.01,0.946,0.9993106617647058,4358,4346
10,8804,10,100,0.001,0.01,0.942,0.9993184915947296,4410,4394
10,8904,10,100,0.001,0.01,0.948,0.9988769092542678,4467,4437
10,9004,10,100,0.001,0.01,0.946,0.9984451354953354,4510,4494
10,9104,10,100,0.001,0.01,0.94,0.9932996485061512,4561,4543
10,9204,10,100,0.001,0.01,0.95,0.9890265102129508,4616,4588
10,9304,10,100,0.001,0.01,0.944,0.9930137575236457,4665,4639
10,9404,10,100,0.001,0.01,0.93,0.9822415993194386,4705,4699
10,9504,10,100,0.001,0.01,0.94,0.9932659932659933,4761,4743
10,9604,10,100,0.001,0.01,0.944,0.9934402332361516,4815,4789
10,9704,10,100,0.001,0.01,0.944,0.9926834295136027,4868,4836
10,9804,10,100,0.001,0.01,0.948,0.9950020399836801,4916,4888
10,9904,10,100,0.001,0.01,0.956,0.9967689822294022,4971,4933
10,10004,10,100,0.001,0.01,0.958,0.9935025989604158,5029,4975
10,10104,10,100,0.001,0.01,0.96,0.9989113222486145,5065,5039
10,10204,10,100,0.001,0.01,0.962,0.999607996863975,5112,5092
10,10304,10,100,0.001,0.01,0.954,0.999611801242236,5154,5150
10,10404,10,100,0.001,0.01,0.96,0.9994232987312572,5204,5200
10,10504,10,100,0.001,0.01,0.958,0.9945734958111195,5247,5257
10,10604,10,100,0.001,0.01,0.946,0.99622783855149,5296,5308
10,10704,10,100,0.001,0.01,0.958,0.992339312406577,5336,5368
10,10804,10,100,0.001,0.01,0.94,0.9888004442798963,5387,5417
10,10904,10,100,0.001,0.01,0.936,0.9723954512105649,5438,5466
10,11004,10,100,0.001,0.01,0.954,0.9922755361686659,5482,5522
10,11104,10,100,0.001,0.01,0.962,0.9988292507204611,5534,5570
10,11204,10,100,0.001,0.01,0.97,0.9986611924312745,5589,5615
10,11304,10,100,0.001,0.01,0.962,0.997965322009908,5646,5658
10,11404,10,100,0.001,0.01,0.964,0.9998246229393195,5697,5707
10,11504,10,100,0.001,0.01,0.96,0.9980876216968011,5753,5751
10,11604,10,100,0.001,0.01,0.966,0.9969837986901069,5803,5801
10,11704,10,100,0.001,0.01,0.962,0.9924812030075187,5844,5860
10,11804,10,100,0.001,0.01,0.964,0.9967807522873602,5897,5907
10,11904,10,100,0.001,0.01,0.966,0.998067876344086,5939,5965
10,12004,10,100,0.001,0.01,0.96,0.9983338887037654,5997,6007
10,12104,10,100,0.001,0.01,0.964,0.9966953073364178,6047,6057
10,12204,10,100,0.001,0.01,0.962,0.9971320878400525,6096,6108
10,12304,10,100,0.001,0.01,0.962,0.9995936280884266,6145,6159
10,12404,10,100,0.001,0.01,0.96,0.9993550467591099,6194,6210
10,12504,10,100,0.001,0.01,0.966,0.9998400511836213,6251,6253
10,12604,10,100,0.001,0.01,0.968,0.9991272611869247,6303,6301
10,12704,10,100,0.001,0.01,0.954,0.9949622166246851,6357,6347
10,12804,10,100,0.001,0.01,0.958,0.988987816307404,6398,6406
10,12904,10,100,0.001,0.01,0.962,0.9917854928704277,6439,6465
10,13004,10,100,0.001,0.01,0.96,0.9962319286373423,6487,6517
10,13104,10,100,0.001,0.01,0.968,0.9993131868131868,6534,6570
10,13204,10,100,0.001,0.01,0.974,0.9997727961223871,6579,6625
10,13304,10,100,0.001,0.01,0.978,0.9999248346361996,6635,6669
10,13404,10,100,0.001,0.01,0.974,1.0,6679,6725
10,13504,10,100,0.001,0.01,0.976,1.0,6727,6777
10,13604,10,100,0.001,0.01,0.972,0.9983093207880035,6778,6826
10,13704,10,100,0.001,0.01,0.97,0.9964973730297724,6829,6875
10,13804,10,100,0.001,0.01,0.966,0.9971747319617502,6886,6918
10,13904,10,100,0.001,0.01,0.96,0.9920886075949367,6937,6967
10,14004,10,100,0.001,0.01,0.962,0.9942159383033419,6989,7015
10,14104,10,100,0.001,0.01,0.974,0.9941151446398185,7037,7067
10,14204,10,100,0.001,0.01,0.968,0.9963390594198818,7082,7122
10,14304,10,100,0.001,0.01,0.972,0.9963646532438478,7132,7172
10,14404,10,100,0.001,0.01,0.972,0.9990280477645098,7186,7218
10,14504,10,100,0.001,0.01,0.978,0.9997931605074463,7233,7271
10,14604,10,100,0.001,0.01,0.974,0.9992467817036428,7282,7322
10,14704,10,100,0.001,0.01,0.972,0.9996599564744287,7327,7377
10,14804,10,100,0.001,0.01,0.982,0.9981086192920832,7381,7423
10,14904,10,100,0.001,0.01,0.97,0.9966451959205582,7440,7464
10,15004,10,100,0.001,0.01,0.972,0.9951346307651293,7491,7513
11,104,10,100,0.001,0.01,0.516,0.5,54,50
11,204,10,100,0.001,0.01,0.48,0.5245098039215687,107,97
11,304,10,100,0.001,0.01,0.484,0.5361842105263158,153,151
11,404,10,100,0.001,0.01,0.5,0.5693069306930693,207,197
11,504,10,100,0.001,0.01,0.526,0.5297619047619048,263,241
11,604,10,100,0.001,0.01,0.474,0.5844370860927153,315,289
11,704,10,100,0.001,0.01,0.488,0.6065340909090909,372,332
11,804,10,100,0.001,0.01,0.488,0.5808457711442786,415,389
11,904,10,100,0.001,0.01,0.494,0.6426991150442478,467,437
11,1004,10,100,0.001,0.01,0.474,0.6414342629482072,509,495
11,1104,10,100,0.001,0.01,0.48,0.6458333333333334,559,545
11,1204,10,100,0.001,0.01,0.508,0.6627906976744186,608,596
11,1304,10,100,0.001,0.01,0.5,0.6526073619631901,658,646
11,1404,10,100,0.001,0.01,0.518,0.7094017094017094,710,694
11,1504,10,100,0.001,0.01,0.506,0.680186170212766,762,742
11,1604,10,100,0.001,0.01,0.516,0.690149625935162,811,793
11,1704,10,100,0.001,0.01,0.514,0.6907276995305164,864,840
11,1804,10,100,0.001,0.01,0.522,0.7477827050997783,913,891
11,1904,10,100,0.001,0.01,0.524,0.7153361344537815,967,937
11,2004,10,100,0.001,0.01,0.538,0.7574850299401198,1011,993
11,2104,10,100,0.001,0.01,0.532,0.75,1065,1039
11,2204,10,100,0.001,0.01,0.542,0.7826678765880217,1117,1087
11,2304,10,100,0.001,0.01,0.55,0.7391493055555556,1170,1134
11,2404,10,100,0.001,0.01,0.554,0.7554076539101497,1225,1179
11,2504,10,100,0.001,0.01,0.562,0.7404153354632588,1270,1234
11,2604,10,100,0.001,0.01,0.554,0.8029953917050692,1322,1282
11,2704,10,100,0.001,0.01,0.536,0.8224852071005917,1374,1330
11,2804,10,100,0.001,0.01,0.568,0.8427246790299572,1427,1377
11,2904,10,100,0.001,0.01,0.568,0.8495179063360881,1469,1435
11,3004,10,100,0.001,0.01,0.54,0.8382157123834887,1519,1485
11,3104,10,100,0.001,0.01,0.586,0.8070231958762887,1568,1536
11,3204,10,100,0.001,0.01,0.568,0.8508114856429463,1627,1577
11,3304,10,100,0.001,0.01,0.61,0.8716707021791767,1676,1628
11,3404,10,100,0.001,0.01,0.644,0.9150998824911868,1726,1678
11,3504,10,100,0.001,0.01,0.656,0.9023972602739726,1770,1734
11,3604,10,100,0.001,0.01,0.71,0.9289678135405105,1820,1784
11,3704,10,100,0.001,0.01,0.722,0.9443844492440605,1866,1838
11,3804,10,100,0.001,0.01,0.712,0.9600420609884333,1920,1884
11,3904,10,100,0.001,0.01,0.748,0.9705430327868853,1966,1938
11,4004,10,100,0.001,0.01,0.778,0.97002997002997,2008,1996
11,4104,10,100,0.001,0.01,0.778,0.9529727095516569,2061,2043
11,4204,10,100,0.001,0.01,0.782,0.9757373929590866,2103,2101
11,4304,10,100,0.001,0.01,0.784,0.9795539033457249,2150,2154
11,4404,10,100,0.001,0.01,0.81,0.9509536784741145,2204,2200
11,4504,10,100,0.001,0.01,0.814,0.9489342806394316,2257,2247
11,4604,10,100,0.001,0.01,0.842,0.9685056472632494,2310,2294
11,4704,10,100,0.001,0.01,0.852,0.9840561224489796,2361,2343
11,4804,10,100,0.001,0.01,0.856,0.9843880099916736,2404,2400
11,4904,10,100,0.001,0.01,0.888,0.9906199021207178,2457,2447
11,5004,10,100,0.001,0.01,0.87,0.9804156674660272,2515,2489
11,5104,10,100,0.001,0.01,0.866,0.9858934169278997,2569,2535
11,5204,10,100,0.001,0.01,0.864,0.9713681783243658,2616,2588
11,5304,10,100,0.001,0.01,0.868,0.9681372549019608,2670,2634
11,5404,10,100,0.001,0.01,0.894,0.981680236861584,2726,2678
11,5504,10,100,0.001,0.01,0.906,0.9938226744186046,2784,2720
11,5604,10,100,0.001,0.01,0.9,0.9882226980728052,2831,2773
11,5704,10,100,0.001,0.01,0.896,0.9907082748948106,2885,2819
11,5804,10,100,0.001,0.01,0.91,0.9946588559614059,2937,2867
11,5904,10,100,0.001,0.01,0.918,0.9915311653116531,2985,2919
11,6004,10,100,0.001,0.01,0.922,0.991672218520986,3035,2969
11,6104,10,100,0.001,0.01,0.922,0.995740498034076,3083,3021
11,6204,10,100,0.001,0.01,0.91,0.9938749194068343,3127,3077
11,6304,10,100,0.001,0.01,0.928,0.9960342639593909,3176,3128
11,6404,10,100,0.001,0.01,0.924,0.9962523422860712,3228,3176
11,6504,10,100,0.001,0.01,0.918,0.9920049200492005,3284,3220
11,6604,10,100,0.001,0.01,0.934,0.9909145972138098,3326,3278
11,6704,10,100,0.001,0.01,0.912,0.9873210023866349,3370,3334
11,6804,10,100,0.001,0.01,0.93,0.9886831275720165,3422,3382
11,6904,10,100,0.001,0.01,0.932,0.9949304750869061,3470,3434
11,7004,10,100,0.001,0.01,0.93,0.9857224443175329,3519,3485
11,7104,10,100,0.001,0.01,0.934,0.9973254504504504,3571,3533
11,7204,10,100,0.001,0.01,0.938,0.9961132704053304,3618,3586
11,7304,10,100,0.001,0.01,0.948,0.9927437020810514,3672,3632
11,7404,10,100,0.001,0.01,0.94,0.9917612101566721,3728,3676
11,7504,10,100,0.001,0.01,0.934,0.9966684434968017,3774,3730
11,7604,10,100,0.001,0.01,0.962,0.9972382956338769,3827,3777
11,7704,10,100,0.001,0.01,0.928,0.991822429906542,3869,3835
11,7804,10,100,0.001,0.01,0.946,0.9929523321373654,3917,3887
11,7904,10,100,0.001,0.01,0.944,0.9873481781376519,3970,3934
11,8004,10,100,0.001,0.01,0.924,0.9762618690654673,4021,3983
11,8104,10,100,0.001,0.01,0.96,0.993213228035538,4071,4033
11,8204,10,100,0.001,0.01,0.958,0.9984154071184788,4117,4087
11,8304,10,100,0.001,0.01,0.962,0.9990366088631984,4173,4131
11,8404,10,100,0.001,0.01,0.972,0.9991670633031889,4217,4187
11,8504,10,100,0.001,0.01,0.964,0.9971777986829727,4266,4238
11,8604,10,100,0.001,0.01,0.954,0.9918642491864249,4319,4285
11,8704,10,100,0.001,0.01,0.966,0.9956341911764706,4365,4339
11,8804,10,100,0.001,0.01,0.954,0.9890958655156747,4411,4393
11,8904,10,100,0.001,0.01,0.962,0.9933737646001797,4464,4440
11,9004,10,100,0.001,0.01,0.964,0.9971123944913372,4518,4486
11,9104,10,100,0.001,0.01,0.956,0.9969244288224957,4569,4535
11,9204,10,100,0.001,0.01,0.952,0.9894611038678836,4624,4580
11,9304,10,100,0.001,0.01,0.976,0.9906491831470335,4671,4633
11,9404,10,100,0.001,0.01,0.97,0.994470438111442,4715,4689
11,9504,10,100,0.001,0.01,0.97,0.9975799663299664,4758,4746
11,9604,10,100,0.001,0.01,0.964,0.9957309454394002,4804,4800
11,9704,10,100,0.001,0.01,0.974,0.9977328936521023,4853,4851
11,9804,10,100,0.001,0.01,0.974,0.9958180334557324,4899,4905
11,9904,10,100,0.001,0.01,0.962,0.9891962843295639,4941,4963
11,10004,10,100,0.001,0.01,0.956,0.9877049180327869,4989,5015
11,10104,10,100,0.001,0.01,0.97,0.9920823436262867,5039,5065
11,10204,10,100,0.001,0.01,0.968,0.9939239513916112,5094,5110
11,10304,10,100,0.001,0.01,0.976,0.9963121118012422,5146,5158
11,10404,10,100,0.001,0.01,0.97,0.9952902729719338,5184,5220
11,10504,10,100,0.001,0.01,0.964,0.9902894135567403,5230,5274
11,10604,10,100,0.001,0.01,0.976,0.995850622406639,5283,5321
11,10704,10,100,0.001,0.01,0.964,0.9928998505231689,5327,5377
11,10804,10,100,0.001,0.01,0.976,0.9937060348019252,5380,5424
11,10904,10,100,0.001,0.01,0.986,0.9976155539251651,5438,5466
11,11004,10,100,0.001,0.01,0.972,0.9918211559432933,5478,5526
11,11104,10,100,0.001,0.01,0.986,0.9955871757925072,5528,5576
11,11204,10,100,0.001,0.01,0.99,0.9950910389146733,5581,5623
11,11304,10,100,0.001,0.01,0.978,0.9978768577494692,5639,5665
11,11404,10,100,0.001,0.01,0.988,0.9991231146965976,5703,5701
11,11504,10,100,0.001,0.01,0.984,0.9994784422809457,5743,5761
11,11604,10,100,0.001,0.01,0.984,0.9993105825577387,5793,5811
11,11704,10,100,0.001,0.01,0.982,0.9982911825017088,5846,5858
11,11804,10,100,0.001,0.01,0.984,0.9990681125042359,5902,5902
11,11904,10,100,0.001,0.01,0.974,0.9978998655913979,5946,5958
11,12004,10,100,0.001,0.01,0.97,0.9961679440186605,5993,6011
11,12104,10,100,0.001,0.01,0.976,0.9963648380700595,6048,6056
11,12204,10,100,0.001,0.01,0.976,0.9934447722058342,6102,6102
11,12304,10,100,0.001,0.01,0.982,0.9908159947984395,6154,6150
11,12404,10,100,0.001,0.01,0.974,0.9883908416639794,6197,6207
11,12504,10,100,0.001,0.01,0.982,0.9964011516314779,6252,6252
11,12604,10,100,0.001,0.01,0.97,0.9961916851793081,6305,6299
11,12704,10,100,0.001,0.01,0.986,0.9985044080604534,6357,6347
11,12804,10,100,0.001,0.01,0.982,0.9973445798188066,6401,6403
11,12904,10,100,0.001,0.01,0.984,0.9975976441413515,6446,6458
11,13004,10,100,0.001,0.01,0.982,0.9961550292217779,6492,6512
11,13104,10,100,0.001,0.01,0.99,0.9984737484737485,6537,6567
11,13204,10,100,0.001,0.01,0.988,0.9997727961223871,6586,6618
11,13304,10,100,0.001,0.01,0.988,1.0,6646,6658
11,13404,10,100,0.001,0.01,0.988,0.9998507908087139,6693,6711
11,13504,10,100,0.001,0.01,0.99,0.9999259478672986,6748,6756
11,13604,10,100,0.001,0.01,0.99,0.9998529844163482,6795,6809
11,13704,10,100,0.001,0.01,0.986,0.9997810858143608,6855,6849
11,13804,10,100,0.001,0.01,0.99,0.9989858012170385,6899,6905
11,13904,10,100,0.001,0.01,0.99,0.9991369390103567,6941,6963
11,14004,10,100,0.001,0.01,0.976,0.9913596115395601,6986,7018
11,14104,10,100,0.001,0.01,0.978,0.9910663641520137,7036,7068
11,14204,10,100,0.001,0.01,0.978,0.9929597296536187,7086,7118
11,14304,10,100,0.001,0.01,0.984,0.9952460850111857,7144,7160
11,14404,10,100,0.001,0.01,0.99,0.996875867814496,7201,7203
11,14504,10,100,0.001,0.01,0.984,0.9983452840595698,7253,7251
11,14604,10,100,0.001,0.01,0.99,0.9994522048753766,7302,7302
11,14704,10,100,0.001,0.01,0.996,0.9977557127312296,7351,7353
11,14804,10,100,0.001,0.01,0.996,0.9992569575790327,7398,7406
11,14904,10,100,0.001,0.01,0.994,0.9990606548577563,7457,7447
11,15004,10,100,0.001,0.01,0.996,0.9990669154892029,7512,7492
12,104,10,100,0.001,0.01,0.48,0.5,52,52
12,204,10,100,0.001,0.01,0.522,0.5735294117647058,106,98
12,304,10,100,0.001,0.01,0.524,0.5328947368421053,156,148
12,404,10,100,0.001,0.01,0.508,0.599009900990099,207,197
12,504,10,100,0.001,0.01,0.478,0.6031746031746031,256,248
12,604,10,100,0.001,0.01,0.482,0.609271523178808,306,298
12,704,10,100,0.001,0.01,0.48,0.6150568181818182,357,347
12,804,10,100,0.001,0.01,0.496,0.6455223880597015,407,397
12,904,10,100,0.001,0.01,0.474,0.6194690265486725,455,449
12,1004,10,100,0.001,0.01,0.476,0.650398406374502,506,498
12,1104,10,100,0.001,0.01,0.476,0.6068840579710145,547,557
12,1204,10,100,0.001,0.01,0.49,0.6478405315614618,594,610
12,1304,10,100,0.001,0.01,0.496,0.6487730061349694,647,657
12,1404,10,100,0.001,0.01,0.464,0.6680911680911681,705,699
12,1504,10,100,0.001,0.01,0.476,0.6848404255319149,756,748
12,1604,10,100,0.001,0.01,0.466,0.7088528678304239,805,799
12,1704,10,100,0.001,0.01,0.486,0.6895539906103286,854,850
12,1804,10,100,0.001,0.01,0.486,0.6951219512195121,906,898
12,1904,10,100,0.001,0.01,0.466,0.7127100840336135,957,947
12,2004,10,100,0.001,0.01,0.494,0.7280439121756487,1009,995
12,2104,10,100,0.001,0.01,0.496,0.6886882129277566,1055,1049
12,2204,10,100,0.001,0.01,0.508,0.7450090744101633,1103,1101
12,2304,10,100,0.001,0.01,0.492,0.7348090277777778,1144,1160
12,2404,10,100,0.001,0.01,0.516,0.7366888519134775,1192,1212
12,2504,10,100,0.001,0.01,0.502,0.764776357827476,1237,1267
12,2604,10,100,0.001,0.01,0.498,0.7791858678955453,1289,1315
12,2704,10,100,0.001,0.01,0.526,0.7777366863905325,1338,1366
12,2804,10,100,0.001,0.01,0.502,0.7970756062767475,1391,1413
12,2904,10,100,0.001,0.01,0.532,0.7868457300275482,1436,1468
12,3004,10,100,0.001,0.01,0.5,0.8082556591211718,1483,1521
12,3104,10,100,0.001,0.01,0.496,0.7525773195876289,1527,1577
12,3204,10,100,0.001,0.01,0.498,0.7774656679151061,1582,1622
12,3304,10,100,0.001,0.01,0.532,0.7796610169491526,1634,1670
12,3404,10,100,0.001,0.01,0.544,0.7911280846063454,1681,1723
12,3504,10,100,0.001,0.01,0.526,0.7953767123287672,1730,1774
12,3604,10,100,0.001,0.01,0.534,0.7946725860155383,1780,1824
12,3704,10,100,0.001,0.01,0.514,0.8018358531317494,1832,1872
12,3804,10,100,0.001,0.01,0.506,0.796267087276551,1881,1923
12,3904,10,100,0.001,0.01,0.522,0.811219262295082,1929,1975
12,4004,10,100,0.001,0.01,0.522,0.8064435564435565,1979,2025
12,4104,10,100,0.001,0.01,0.548,0.8267543859649122,2034,2070
12,4204,10,100,0.001,0.01,0.552,0.8606089438629876,2086,2118
12,4304,10,100,0.001,0.01,0.552,0.8424721189591078,2140,2164
12,4404,10,100,0.001,0.01,0.56,0.8619436875567665,2186,2218
12,4504,10,100,0.001,0.01,0.58,0.8738898756660746,2234,2270
12,4604,10,100,0.001,0.01,0.568,0.8679409209383145,2283,2321
12,4704,10,100,0.001,0.01,0.594,0.8730867346938775,2332,2372
12,4804,10,100,0.001,0.01,0.596,0.8896752706078268,2385,2419
12,4904,10,100,0.001,0.01,0.57,0.8550163132137031,2428,2476
12,5004,10,100,0.001,0.01,0.592,0.8639088729016786,2484,2520
12,5104,10,100,0.001,0.01,0.576,0.8659874608150471,2536,2568
12,5204,10,100,0.001,0.01,0.63,0.8954650269023828,2582,2622
12,5304,10,100,0.001,0.01,0.612,0.9023378582202112,2639,2665
12,5404,10,100,0.001,0.01,0.626,0.8786084381939304,2684,2720
12,5504,10,100,0.001,0.01,0.612,0.8557412790697675,2733,2771
12,5604,10,100,0.001,0.01,0.636,0.8998929336188437,2782,2822
12,5704,10,100,0.001,0.01,0.636,0.914796633941094,2831,2873
12,5804,10,100,0.001,0.01,0.64,0.9195382494831151,2889,2915
12,5904,10,100,0.001,0.01,0.66,0.888550135501355,2938,2966
12,6004,10,100,0.001,0.01,0.66,0.9068954030646236,2983,3021
12,6104,10,100,0.001,0.01,0.702,0.9238204456094364,3033,3071
12,6204,10,100,0.001,0.01,0.688,0.9302063185041909,3084,3120
12,6304,10,100,0.001,0.01,0.686,0.9289340101522843,3130,3174
12,6404,10,100,0.001,0.01,0.696,0.9144284821986258,3190,3214
12,6504,10,100,0.001,0.01,0.694,0.939729397293973,3230,3274
12,6604,10,100,0.001,0.01,0.686,0.9311023622047244,3284,3320
12,6704,10,100,0.001,0.01,0.688,0.8861873508353222,3339,3365
12,6804,10,100,0.001,0.01,0.704,0.9027042915931804,3396,3408
12,6904,10,100,0.001,0.01,0.678,0.899188876013905,3440,3464
12,7004,10,100,0.001,0.01,0.732,0.933466590519703,3491,3513
12,7104,10,100,0.001,0.01,0.72,0.9462274774774775,3544,3560
12,7204,10,100,0.001,0.01,0.73,0.9435036091060522,3599,3605
12,7304,10,100,0.001,0.01,0.734,0.9545454545454546,3639,3665
12,7404,10,100,0.001,0.01,0.726,0.9434089681253377,3689,3715
12,7504,10,100,0.001,0.01,0.73,0.902318763326226,3738,3766
12,7604,10,100,0.001,0.01,0.736,0.9347711730668069,3783,3821
12,7704,10,100,0.001,0.01,0.746,0.9441848390446521,3840,3864
12,7804,10,100,0.001,0.01,0.756,0.9677088672475653,3894,3910
12,7904,10,100,0.001,0.01,0.766,0.9607793522267206,3947,3957
12,8004,10,100,0.001,0.01,0.75,0.9606446776611695,3998,4006
12,8104,10,100,0.001,0.01,0.748,0.9642152023692004,4049,4055
12,8204,10,100,0.001,0.01,0.742,0.9549000487567041,4099,4105
12,8304,10,100,0.001,0.01,0.752,0.9707369942196532,4146,4158
12,8404,10,100,0.001,0.01,0.756,0.9735840076154212,4192,4212
12,8504,10,100,0.001,0.01,0.746,0.9765992474129821,4239,4265
12,8604,10,100,0.001,0.01,0.734,0.9621106462110646,4288,4316
12,8704,10,100,0.001,0.01,0.746,0.9554227941176471,4335,4369
12,8804,10,100,0.001,0.01,0.734,0.9535438437074057,4381,4423
12,8904,10,100,0.001,0.01,0.776,0.9692273135669363,4431,4473
12,9004,10,100,0.001,0.01,0.766,0.9761217236783651,4475,4529
12,9104,10,100,0.001,0.01,0.768,0.9745166959578208,4523,4581
12,9204,10,100,0.001,0.01,0.76,0.957083876575402,4573,4631
12,9304,10,100,0.001,0.01,0.738,0.8896173688736028,4611,4693
12,9404,10,100,0.001,0.01,0.736,0.9283283709059974,4661,4743
12,9504,10,100,0.001,0.01,0.758,0.9249789562289562,4710,4794
12,9604,10,100,0.001,0.01,0.744,0.9450229071220325,4766,4838
12,9704,10,100,0.001,0.01,0.772,0.9379637262984336,4817,4887
12,9804,10,100,0.001,0.01,0.786,0.956548347613219,4862,4942
12,9904,10,100,0.001,0.01,0.772,0.9535541195476576,4909,4995
12,10004,10,100,0.001,0.01,0.782,0.9555177928828469,4967,5037
12,10104,10,100,0.001,0.01,0.756,0.9434877276326208,5016,5088
12,10204,10,100,0.001,0.01,0.756,0.9560956487651902,5074,5130
12,10304,10,100,0.001,0.01,0.786,0.9702057453416149,5126,5178
12,10404,10,100,0.001,0.01,0.784,0.9677047289504037,5172,5232
12,10504,10,100,0.001,0.01,0.77,0.9563975628332064,5226,5278
12,10604,10,100,0.001,0.01,0.764,0.9734062617880045,5276,5328
12,10704,10,100,0.001,0.01,0.794,0.9749626307922272,5328,5376
12,10804,10,100,0.001,0.01,0.754,0.9772306553128471,5379,5425
12,10904,10,100,0.001,0.01,0.79,0.9817498165810712,5434,5470
12,11004,10,100,0.001,0.01,0.784,0.97546346782988,5493,5511
12,11104,10,100,0.001,0.01,0.808,0.9713616714697406,5538,5566
12,11204,10,100,0.001,0.01,0.802,0.9754551945733666,5584,5620
12,11304,10,100,0.001,0.01,0.818,0.977618542108988,5637,5667
12,11404,10,100,0.001,0.01,0.794,0.9713258505787443,5691,5713
12,11504,10,100,0.001,0.01,0.774,0.9365438108484005,5743,5761
12,11604,10,100,0.001,0.01,0.794,0.958031713202344,5795,5809
12,11704,10,100,0.001,0.01,0.808,0.9690704032809296,5844,5860
12,11804,10,100,0.001,0.01,0.818,0.9694171467299221,5898,5906
12,11904,10,100,0.001,0.01,0.814,0.974630376344086,5950,5954
12,12004,10,100,0.001,0.01,0.81,0.9741752749083639,5991,6013
12,12104,10,100,0.001,0.01,0.832,0.9558823529411765,6036,6068
12,12204,10,100,0.001,0.01,0.79,0.9473942969518191,6090,6114
12,12304,10,100,0.001,0.01,0.812,0.9592002600780234,6138,6166
12,12404,10,100,0.001,0.01,0.806,0.9722670106417285,6186,6218
12,12504,10,100,0.001,0.01,0.838,0.9822456813819578,6241,6263
12,12604,10,100,0.001,0.01,0.82,0.9847667407172326,6290,6314
12,12704,10,100,0.001,0.01,0.816,0.9863035264483627,6334,6370
12,12804,10,100,0.001,0.01,0.84,0.9885192127460168,6385,6419
12,12904,10,100,0.001,0.01,0.82,0.9783013019218847,6432,6472
12,13004,10,100,0.001,0.01,0.824,0.9843125192248539,6486,6518
12,13104,10,100,0.001,0.01,0.838,0.9814560439560439,6531,6573
12,13204,10,100,0.001,0.01,0.812,0.9478188427749167,6585,6619
12,13304,10,100,0.001,0.01,0.788,0.9158147925435959,6633,6671
12,13404,10,100,0.001,0.01,0.806,0.9562817069531483,6681,6723
12,13504,10,100,0.001,0.01,0.808,0.9666765402843602,6734,6770
12,13604,10,100,0.001,0.01,0.804,0.9645692443399,6779,6825
12,13704,10,100,0.001,0.01,0.814,0.978108581436077,6833,6871
12,13804,10,100,0.001,0.01,0.824,0.9785569400173862,6886,6918
12,13904,10,100,0.001,0.01,0.826,0.9578538550057537,6937,6967
12,14004,10,100,0.001,0.01,0.832,0.975078548986004,6996,7008
12,14104,10,100,0.001,0.01,0.836,0.9781622234827,7048,7056
12,14204,10,100,0.001,0.01,0.826,0.9692340185863138,7098,7106
12,14304,10,100,0.001,0.01,0.836,0.983011744966443,7148,7156
12,14404,10,100,0.001,0.01,0.832,0.9792418772563177,7189,7215
12,14504,10,100,0.001,0.01,0.836,0.9834528405956977,7245,7259
12,14604,10,100,0.001,0.01,0.844,0.973979731580389,7286,7318
12,14704,10,100,0.001,0.01,0.846,0.9846980413492927,7331,7373
12,14804,10,100,0.001,0.01,0.86,0.9764928397730344,7386,7418
12,14904,10,100,0.001,0.01,0.802,0.9294820182501342,7439,7465
12,15004,10,100,0.001,0.01,0.822,0.9660090642495335,7492,7512
13,104,10,100,0.001,0.01,0.536,0.7596153846153846,47,57
13,204,10,100,0.001,0.01,0.538,0.7401960784313726,91,113
13,304,10,100,0.001,0.01,0.522,0.6875,149,155
13,404,10,100,0.001,0.01,0.494,0.7153465346534653,197,207
13,504,10,100,0.001,0.01,0.492,0.6587301587301587,250,254
13,604,10,100,0.001,0.01,0.508,0.6937086092715232,300,304
13,704,10,100,0.001,0.01,0.526,0.6960227272727273,356,348
13,804,10,100,0.001,0.01,0.526,0.7263681592039801,404,400
13,904,10,100,0.001,0.01,0.538,0.7179203539823009,444,460
13,1004,10,100,0.001,0.01,0.584,0.7549800796812749,498,506
13,1104,10,100,0.001,0.01,0.546,0.7264492753623188,552,552
13,1204,10,100,0.001,0.01,0.542,0.7483388704318937,606,598
13,1304,10,100,0.001,0.01,0.55,0.7377300613496932,654,650
13,1404,10,100,0.001,0.01,0.566,0.7628205128205128,710,694
13,1504,10,100,0.001,0.01,0.554,0.7626329787234043,765,739
13,1604,10,100,0.001,0.01,0.536,0.7512468827930174,807,797
13,1704,10,100,0.001,0.01,0.59,0.7376760563380281,850,854
13,1804,10,100,0.001,0.01,0.586,0.7754988913525499,902,902
13,1904,10,100,0.001,0.01,0.564,0.7394957983193278,944,960
13,2004,10,100,0.001,0.01,0.566,0.7874251497005988,991,1013
13,2104,10,100,0.001,0.01,0.566,0.8174904942965779,1034,1070
13,2204,10,100,0.001,0.01,0.596,0.8421052631578947,1086,1118
13,2304,10,100,0.001,0.01,0.574,0.8372395833333334,1143,1161
13,2404,10,100,0.001,0.01,0.576,0.8090682196339434,1190,1214
13,2504,10,100,0.001,0.01,0.608,0.8354632587859425,1235,1269
13,2604,10,100,0.001,0.01,0.598,0.868663594470046,1278,1326
13,2704,10,100,0.001,0.01,0.622,0.8635355029585798,1333,1371
13,2804,10,100,0.001,0.01,0.61,0.8840941512125535,1380,1424
13,2904,10,100,0.001,0.01,0.62,0.8660468319559229,1431,1473
13,3004,10,100,0.001,0.01,0.658,0.9124500665778962,1474,1530
13,3104,10,100,0.001,0.01,0.646,0.9120489690721649,1529,1575
13,3204,10,100,0.001,0.01,0.678,0.9353932584269663,1575,1629
13,3304,10,100,0.001,0.01,0.706,0.9567191283292978,1621,1683
13,3404,10,100,0.001,0.01,0.73,0.9656286721504113,1675,1729
13,3504,10,100,0.001,0.01,0.76,0.9726027397260274,1730,1774
13,3604,10,100,0.001,0.01,0.75,0.9714206437291898,1787,1817
13,3704,10,100,0.001,0.01,0.772,0.9808315334773218,1840,1864
13,3804,10,100,0.001,0.01,0.79,0.9792323869610936,1895,1909
13,3904,10,100,0.001,0.01,0.804,0.9879610655737705,1951,1953
13,4004,10,100,0.001,0.01,0.822,0.987012987012987,2007,1997
13,4104,10,100,0.001,0.01,0.812,0.9814814814814815,2058,2046
13,4204,10,100,0.001,0.01,0.788,0.9626546146527117,2095,2109
13,4304,10,100,0.001,0.01,0.852,0.9753717472118959,2141,2163
13,4404,10,100,0.001,0.01,0.848,0.9763851044504995,2193,2211
13,4504,10,100,0.001,0.01,0.858,0.9837921847246892,2239,2265
13,4604,10,100,0.001,0.01,0.884,0.991094700260643,2293,2311
13,4704,10,100,0.001,0.01,0.874,0.9919217687074829,2347,2357
13,4804,10,100,0.001,0.01,0.854,0.9727310574521232,2401,2403
13,4904,10,100,0.001,0.01,0.892,0.9953099510603589,2449,2455
13,5004,10,100,0.001,0.01,0.89,0.986810551558753,2501,2503
13,5104,10,100,0.001,0.01,0.882,0.979819749216301,2543,2561
13,5204,10,100,0.001,0.01,0.882,0.9825134511913912,2582,2622
13,5304,10,100,0.001,0.01,0.902,0.9962292609351433,2637,2667
13,5404,10,100,0.001,0.01,0.902,0.9909326424870466,2682,2722
13,5504,10,100,0.001,0.01,0.914,0.995094476744186,2725,2779
13,5604,10,100,0.001,0.01,0.908,0.9898286937901499,2780,2824
13,5704,10,100,0.001,0.01,0.92,0.995617110799439,2831,2873
13,5804,10,100,0.001,0.01,0.914,0.9936250861474845,2883,2921
13,5904,10,100,0.001,0.01,0.926,0.9969512195121951,2948,2956
13,6004,10,100,0.001,0.01,0.94,0.998834110592938,2992,3012
13,6104,10,100,0.001,0.01,0.934,0.9949213630406291,3044,3060
13,6204,10,100,0.001,0.01,0.936,0.9887169568020632,3092,3112
13,6304,10,100,0.001,0.01,0.948,0.9976205583756346,3144,3160
13,6404,10,100,0.001,0.01,0.916,0.9647095565271705,3199,3205
13,6504,10,100,0.001,0.01,0.882,0.9351168511685117,3250,3254
13,6604,10,100,0.001,0.01,0.914,0.9644155057540884,3304,3300
13,6704,10,100,0.001,0.01,0.948,0.9907517899761337,3354,3350
13,6804,10,100,0.001,0.01,0.942,0.9944150499706055,3406,3398
13,6904,10,100,0.001,0.01,0.952,0.9939165701042874,3457,3447
13,7004,10,100,0.001,0.01,0.972,0.9925756710451171,3502,3502
13,7104,10,100,0.001,0.01,0.968,0.9971846846846847,3551,3553
13,7204,10,100,0.001,0.01,0.97,0.999305941143809,3595,3609
13,7304,10,100,0.001,0.01,0.974,0.9987677984665937,3657,3647
13,7404,10,100,0.001,0.01,0.968,0.9991896272285251,3715,3689
13,7504,10,100,0.001,0.01,0.96,0.9974680170575693,3773,3731
13,7604,10,100,0.001,0.01,0.976,0.9981588637559179,3834,3770
13,7704,10,100,0.001,0.01,0.972,0.9977933541017653,3893,3811
13,7804,10,100,0.001,0.01,0.976,0.9983341875961046,3942,3862
13,7904,10,100,0.001,0.01,0.962,0.9987348178137652,3991,3913
13,8004,10,100,0.001,0.01,0.954,0.9933783108445777,4039,3965
13,8104,10,100,0.001,0.01,0.968,0.9950641658440277,4096,4008
13,8204,10,100,0.001,0.01,0.962,0.9952462213554364,4135,4069
13,8304,10,100,0.001,0.01,0.974,0.9966281310211946,4177,4127
13,8404,10,100,0.001,0.01,0.96,0.9928605425987624,4222,4182
13,8504,10,100,0.001,0.01,0.976,0.9917685794920038,4268,4236
13,8604,10,100,0.001,0.01,0.974,0.995583449558345,4312,4292
13,8704,10,100,0.001,0.01,0.964,0.9965533088235294,4356,4348
13,8804,10,100,0.001,0.01,0.978,0.9985233984552476,4407,4397
13,8904,10,100,0.001,0.01,0.968,0.9983153638814016,4471,4433
13,9004,10,100,0.001,0.01,0.958,0.9896712572190137,4521,4483
13,9104,10,100,0.001,0.01,0.978,0.9975834797891037,4573,4531
13,9204,10,100,0.001,0.01,0.976,0.9923946110386789,4623,4581
13,9304,10,100,0.001,0.01,0.946,0.9786113499570077,4674,4630
13,9404,10,100,0.001,0.01,0.966,0.9938324117396853,4717,4687
13,9504,10,100,0.001,0.01,0.976,0.9987373737373737,4762,4742
13,9604,10,100,0.001,0.01,0.976,0.9984381507705122,4811,4793
13,9704,10,100,0.001,0.01,0.984,0.9998969497114591,4862,4842
13,9804,10,100,0.001,0.01,0.978,0.9998980008159934,4911,4893
13,9904,10,100,0.001,0.01,0.98,1.0,4957,4947
13,10004,10,100,0.001,0.01,0.98,1.0,5011,4993
13,10104,10,100,0.001,0.01,0.978,0.9981195566112431,5061,5043
13,10204,10,100,0.001,0.01,0.98,0.9999019992159938,5109,5095
13,10304,10,100,0.001,0.01,0.976,0.999708850931677,5159,5145
13,10404,10,100,0.001,0.01,0.982,0.999519415609381,5209,5195
13,10504,10,100,0.001,0.01,0.98,0.9985719725818736,5262,5242
13,10604,10,100,0.001,0.01,0.978,0.9964164466239155,5312,5292
13,10704,10,100,0.001,0.01,0.976,0.9928998505231689,5360,5344
13,10804,10,100,0.001,0.01,0.976,0.9954646427249167,5404,5400
13,10904,10,100,0.001,0.01,0.974,0.9944974321349963,5456,5448
13,11004,10,100,0.001,0.01,0.986,0.9984551072337332,5508,5496
13,11104,10,100,0.001,0.01,0.986,0.997478386167147,5564,5540
13,11204,10,100,0.001,0.01,0.988,0.9981256694037843,5609,5595
13,11304,10,100,0.001,0.01,0.982,0.997965322009908,5666,5638
13,11404,10,100,0.001,0.01,0.988,0.9962293931953701,5712,5692
13,11504,10,100,0.001,0.01,0.982,0.99365438108484,5765,5739
13,11604,10,100,0.001,0.01,0.982,0.9980179248534988,5817,5787
13,11704,10,100,0.001,0.01,0.982,0.9935064935064936,5862,5842
13,11804,10,100,0.001,0.01,0.986,0.997289054557777,5907,5897
13,11904,10,100,0.001,0.01,0.984,0.9997479838709677,5950,5954
13,12004,10,100,0.001,0.01,0.988,0.9995001666111296,5998,6006
13,12104,10,100,0.001,0.01,0.986,0.9995042961004627,6050,6054
13,12204,10,100,0.001,0.01,0.986,0.9971320878400525,6102,6102
13,12304,10,100,0.001,0.01,0.988,0.9990247074122237,6155,6149
13,12404,10,100,0.001,0.01,0.986,0.9929861335053208,6204,6200
13,12504,10,100,0.001,0.01,0.982,0.9985604606525912,6247,6257
13,12604,10,100,0.001,0.01,0.986,0.9958743256109172,6297,6307
13,12704,10,100,0.001,0.01,0.988,0.996536523929471,6336,6368
13,12804,10,100,0.001,0.01,0.986,0.9975007810059356,6386,6418
13,12904,10,100,0.001,0.01,0.984,0.9904680719156851,6438,6466
13,13004,10,100,0.001,0.01,0.988,0.9982313134420179,6499,6505
13,13104,10,100,0.001,0.01,0.99,0.9984737484737485,6546,6558
13,13204,10,100,0.001,0.01,0.988,0.9993941229930324,6594,6610
13,13304,10,100,0.001,0.01,0.99,1.0,6647,6657
13,13404,10,100,0.001,0.01,0.99,0.9992539540435691,6693,6711
13,13504,10,100,0.001,0.01,0.986,0.9992594786729858,6742,6762
13,13604,10,100,0.001,0.01,0.988,0.9986033519553073,6792,6812
13,13704,10,100,0.001,0.01,0.982,0.9964244016345593,6837,6867
13,13804,10,100,0.001,0.01,0.988,0.9971747319617502,6881,6923
13,13904,10,100,0.001,0.01,0.986,0.9966196777905638,6930,6974
13,14004,10,100,0.001,0.01,0.984,0.9965724078834619,6980,7024
13,14104,10,100,0.001,0.01,0.986,0.9985819625638117,7032,7072
13,14204,10,100,0.001,0.01,0.99,0.9995775837792171,7090,7114
13,14304,10,100,0.001,0.01,0.988,0.9969938478747203,7149,7155
13,14404,10,100,0.001,0.01,0.98,0.9930574840322133,7199,7205
13,14504,10,100,0.001,0.01,0.99,0.9985521235521235,7252,7252
13,14604,10,100,0.001,0.01,0.976,0.9930840865516297,7307,7297
13,14704,10,100,0.001,0.01,0.984,0.9942192600652884,7356,7348
13,14804,10,100,0.001,0.01,0.992,0.9991218589570386,7406,7398
13,14904,10,100,0.001,0.01,0.992,0.9997316156736447,7454,7450
13,15004,10,100,0.001,0.01,0.99,0.9999333511063716,7501,7503
14,104,10,100,0.001,0.01,0.546,0.5384615384615384,53,51
14,204,10,100,0.001,0.01,0.482,0.6519607843137255,98,106
14,304,10,100,0.001,0.01,0.516,0.6743421052631579,147,157
14,404,10,100,0.001,0.01,0.512,0.7054455445544554,210,194
14,504,10,100,0.001,0.01,0.47,0.6884920634920635,265,239
14,604,10,100,0.001,0.01,0.474,0.7086092715231788,313,291
14,704,10,100,0.001,0.01,0.5,0.6974431818181818,363,341
14,804,10,100,0.001,0.01,0.498,0.7151741293532339,416,388
14,904,10,100,0.001,0.01,0.512,0.6869469026548672,469,435
14,1004,10,100,0.001,0.01,0.518,0.704183266932271,516,488
14,1104,10,100,0.001,0.01,0.524,0.6875,565,539
14,1204,10,100,0.001,0.01,0.524,0.7126245847176079,618,586
14,1304,10,100,0.001,0.01,0.508,0.7200920245398773,666,638
14,1404,10,100,0.001,0.01,0.54,0.7407407407407407,713,691
14,1504,10,100,0.001,0.01,0.508,0.7167553191489362,761,743
14,1604,10,100,0.001,0.01,0.54,0.743142144638404,815,789
14,1704,10,100,0.001,0.01,0.514,0.7241784037558685,865,839
14,1804,10,100,0.001,0.01,0.504,0.7572062084257206,911,893
14,1904,10,100,0.001,0.01,0.548,0.7725840336134454,958,946
14,2004,10,100,0.001,0.01,0.558,0.8063872255489022,1004,1000
14,2104,10,100,0.001,0.01,0.564,0.7937262357414449,1052,1052
14,2204,10,100,0.001,0.01,0.576,0.8035390199637024,1097,1107
14,2304,10,100,0.001,0.01,0.568,0.8311631944444444,1151,1153
14,2404,10,100,0.001,0.01,0.542,0.8011647254575707,1203,1201
14,2504,10,100,0.001,0.01,0.6,0.8210862619808307,1259,1245
14,2604,10,100,0.001,0.01,0.604,0.8721198156682027,1306,1298
14,2704,10,100,0.001,0.01,0.646,0.8631656804733728,1353,1351
14,2804,10,100,0.001,0.01,0.642,0.8965763195435092,1400,1404
14,2904,10,100,0.001,0.01,0.714,0.9194214876033058,1450,1454
14,3004,10,100,0.001,0.01,0.724,0.931757656458056,1510,1494
14,3104,10,100,0.001,0.01,0.728,0.9439432989690721,1556,1548
14,3204,10,100,0.001,0.01,0.74,0.934769038701623,1613,1591
14,3304,10,100,0.001,0.01,0.73,0.9400726392251816,1664,1640
14,3404,10,100,0.001,0.01,0.756,0.9653349001175088,1709,1695
14,3504,10,100,0.001,0.01,0.77,0.9754566210045662,1762,1742
14,3604,10,100,0.001,0.01,0.752,0.9697558268590455,1815,1789
14,3704,10,100,0.001,0.01,0.772,0.9481641468682506,1862,1842
14,3804,10,100,0.001,0.01,0.786,0.9589905362776026,1907,1897
14,3904,10,100,0.001,0.01,0.82,0.9597848360655737,1957,1947
14,4004,10,100,0.001,0.01,0.826,0.9837662337662337,2009,1995
14,4104,10,100,0.001,0.01,0.814,0.9868421052631579,2052,2052
14,4204,10,100,0.001,0.01,0.84,0.9938154138915318,2104,2100
14,4304,10,100,0.001,0.01,0.834,0.991635687732342,2153,2151
14,4404,10,100,0.001,0.01,0.842,0.9872842870118075,2199,2205
14,4504,10,100,0.001,0.01,0.834,0.9906749555950266,2248,2256
14,4604,10,100,0.001,0.01,0.858,0.9860990443092963,2306,2298
14,4704,10,100,0.001,0.01,0.848,0.9885204081632653,2353,2351
14,4804,10,100,0.001,0.01,0.842,0.9602414654454621,2394,2410
14,4904,10,100,0.001,0.01,0.85,0.9581973898858075,2450,2454
14,5004,10,100,0.001,0.01,0.866,0.9778177458033573,2490,2514
14,5104,10,100,0.001,0.01,0.876,0.9903996865203761,2543,2561
14,5204,10,100,0.001,0.01,0.898,0.9959646425826287,2593,2611
14,5304,10,100,0.001,0.01,0.902,0.994343891402715,2643,2661
14,5404,10,100,0.001,0.01,0.906,0.9974093264248705,2693,2711
14,5504,10,100,0.001,0.01,0.906,0.9961845930232558,2745,2759
14,5604,10,100,0.001,0.01,0.91,0.9914346895074947,2804,2800
14,5704,10,100,0.001,0.01,0.914,0.9931626928471248,2858,2846
14,5804,10,100,0.001,0.01,0.896,0.9936250861474845,2906,2898
14,5904,10,100,0.001,0.01,0.91,0.9933943089430894,2954,2950
14,6004,10,100,0.001,0.01,0.94,0.9913391072618255,2999,3005
14,6104,10,100,0.001,0.01,0.91,0.9949213630406291,3055,3049
14,6204,10,100,0.001,0.01,0.928,0.9946808510638298,3102,3102
14,6304,10,100,0.001,0.01,0.904,0.995241116751269,3153,3151
14,6404,10,100,0.001,0.01,0.904,0.9900062460961899,3203,3201
14,6504,10,100,0.001,0.01,0.934,0.9876998769987699,3253,3251
14,6604,10,100,0.001,0.01,0.918,0.9800121138703816,3307,3297
14,6704,10,100,0.001,0.01,0.898,0.9639021479713604,3350,3354
14,6804,10,100,0.001,0.01,0.936,0.989564961787184,3403,3401
14,6904,10,100,0.001,0.01,0.936,0.9953650057937428,3449,3455
14,7004,10,100,0.001,0.01,0.946,0.9961450599657339,3491,3513
14,7104,10,100,0.001,0.01,0.962,0.9991554054054054,3538,3566
14,7204,10,100,0.001,0.01,0.954,0.9933370349805664,3596,3608
14,7304,10,100,0.001,0.01,0.96,0.9990416210295728,3640,3664
14,7404,10,100,0.001,0.01,0.962,0.9997298757428417,3692,3712
14,7504,10,100,0.001,0.01,0.968,0.9996002132196162,3741,3763
14,7604,10,100,0.001,0.01,0.972,0.9986849026827985,3793,3811
14,7704,10,100,0.001,0.01,0.968,0.9983125649013499,3831,3873
14,7804,10,100,0.001,0.01,0.968,0.995643259866735,3892,3912
14,7904,10,100,0.001,0.01,0.968,0.9978491902834008,3942,3962
14,8004,10,100,0.001,0.01,0.97,0.998375812093953,3993,4011
14,8104,10,100,0.001,0.01,0.974,0.9974086870681145,4055,4049
14,8204,10,100,0.001,0.01,0.968,0.9967089224768406,4105,4099
14,8304,10,100,0.001,0.01,0.978,0.997471098265896,4147,4157
14,8404,10,100,0.001,0.01,0.968,0.9964302712993812,4198,4206
14,8504,10,100,0.001,0.01,0.966,0.9976481655691439,4244,4260
14,8604,10,100,0.001,0.01,0.966,0.9952347745234774,4296,4308
14,8704,10,100,0.001,0.01,0.97,0.9931066176470589,4343,4361
14,8804,10,100,0.001,0.01,0.968,0.9976147205815539,4395,4409
14,8904,10,100,0.001,0.01,0.968,0.9974168912848158,4449,4455
14,9004,10,100,0.001,0.01,0.976,0.9966681474900044,4502,4502
14,9104,10,100,0.001,0.01,0.97,0.9987917398945518,4551,4553
14,9204,10,100,0.001,0.01,0.97,0.9971751412429378,4602,4602
14,9304,10,100,0.001,0.01,0.976,0.9958082545141874,4649,4655
14,9404,10,100,0.001,0.01,0.978,0.9958528285835815,4703,4701
14,9504,10,100,0.001,0.01,0.97,0.9967382154882155,4754,4750
14,9604,10,100,0.001,0.01,0.98,0.9967721782590587,4806,4798
14,9704,10,100,0.001,0.01,0.98,0.9969084913437758,4858,4846
14,9804,10,100,0.001,0.01,0.98,0.9989800081599347,4896,4908
14,9904,10,100,0.001,0.01,0.978,0.9987883683360258,4951,4953
14,10004,10,100,0.001,0.01,0.978,0.998500599760096,5004,5000
14,10104,10,100,0.001,0.01,0.978,0.9989113222486145,5050,5054
14,10204,10,100,0.001,0.01,0.98,0.9943159545276362,5089,5115
14,10304,10,100,0.001,0.01,0.984,0.9965062111801242,5137,5167
14,10404,10,100,0.001,0.01,0.982,0.998077662437524,5189,5215
14,10504,10,100,0.001,0.01,0.98,0.996001523229246,5235,5269
14,10604,10,100,0.001,0.01,0.97,0.9964164466239155,5288,5316
14,10704,10,100,0.001,0.01,0.974,0.9954222720478326,5346,5358
14,10804,10,100,0.001,0.01,0.98,0.9981488337652721,5390,5414
14,10904,10,100,0.001,0.01,0.984,0.9997248716067498,5435,5469
14,11004,10,100,0.001,0.01,0.982,0.9999091239549255,5482,5522
14,11104,10,100,0.001,0.01,0.978,0.9996397694524496,5541,5563
14,11204,10,100,0.001,0.01,0.984,0.9992859692966798,5591,5613
14,11304,10,100,0.001,0.01,0.986,0.998761500353857,5631,5673
14,11404,10,100,0.001,0.01,0.984,0.9998246229393195,5683,5721
14,11504,10,100,0.001,0.01,0.978,0.997739916550765,5734,5770
14,11604,10,100,0.001,0.01,0.982,0.9987073422957601,5777,5827
14,11704,10,100,0.001,0.01,0.97,0.9917976760082023,5829,5875
14,11804,10,100,0.001,0.01,0.98,0.9933920704845814,5868,5936
14,11904,10,100,0.001,0.01,0.974,0.9949596774193549,5920,5984
14,12004,10,100,0.001,0.01,0.986,0.9980839720093302,5972,6032
14,12104,10,100,0.001,0.01,0.98,0.9971910112359551,6026,6078
14,12204,10,100,0.001,0.01,0.982,0.9959849229760734,6077,6127
14,12304,10,100,0.001,0.01,0.982,0.9955299089726918,6132,6172
14,12404,10,100,0.001,0.01,0.984,0.9966139954853274,6189,6215
14,12504,10,100,0.001,0.01,0.984,0.9984804862444018,6243,6261
14,12604,10,100,0.001,0.01,0.986,0.9981751824817519,6289,6315
14,12704,10,100,0.001,0.01,0.984,0.9984256926952141,6338,6366
14,12804,10,100,0.001,0.01,0.986,0.9924242424242424,6389,6415
14,12904,10,100,0.001,0.01,0.986,0.9976751394916304,6436,6468
14,13004,10,100,0.001,0.01,0.99,0.9983082128575823,6485,6519
14,13104,10,100,0.001,0.01,0.988,0.9976343101343101,6545,6559
14,13204,10,100,0.001,0.01,0.99,0.9990154498636776,6601,6603
14,13304,10,100,0.001,0.01,0.99,0.9990228502705953,6649,6655
14,13404,10,100,0.001,0.01,0.984,0.9988063264697106,6700,6704
14,13504,10,100,0.001,0.01,0.99,0.9980005924170616,6751,6753
14,13604,10,100,0.001,0.01,0.984,0.9991914142899148,6805,6799
14,13704,10,100,0.001,0.01,0.978,0.9974460011675423,6861,6843
14,13804,10,100,0.001,0.01,0.984,0.9992755722978847,6903,6901
14,13904,10,100,0.001,0.01,0.988,0.9989930955120828,6955,6949
14,14004,10,100,0.001,0.01,0.99,0.9970722650671237,7004,7000
14,14104,10,100,0.001,0.01,0.99,0.9992200794100964,7054,7050
14,14204,10,100,0.001,0.01,0.99,0.9972542945649113,7106,7098
14,14304,10,100,0.001,0.01,0.99,0.9984619686800895,7163,7141
14,14404,10,100,0.001,0.01,0.988,0.9970147181338517,7213,7191
14,14504,10,100,0.001,0.01,0.986,0.9979316050744622,7265,7239
14,14604,10,100,0.001,0.01,0.984,0.9964393316899479,7311,7293
14,14704,10,100,0.001,0.01,0.982,0.9953754080522307,7367,7337
14,14804,10,100,0.001,0.01,0.99,0.9945960551202377,7414,7390
14,14904,10,100,0.001,0.01,0.992,0.9979871175523349,7463,7441
14,15004,10,100,0.001,0.01,0.99,0.9995334577446015,7518,7486
15,104,10,100,0.001,0.01,0.51,0.6634615384615384,61,43
15,204,10,100,0.001,0.01,0.522,0.6470588235294118,113,91
15,304,10,100,0.001,0.01,0.47,0.6019736842105263,163,141
15,404,10,100,0.001,0.01,0.454,0.6163366336633663,218,186
15,504,10,100,0.001,0.01,0.482,0.5793650793650794,270,234
15,604,10,100,0.001,0.01,0.476,0.6754966887417219,324,280
15,704,10,100,0.001,0.01,0.458,0.6207386363636364,381,323
15,804,10,100,0.001,0.01,0.494,0.6890547263681592,431,373
15,904,10,100,0.001,0.01,0.498,0.6438053097345132,474,430
15,1004,10,100,0.001,0.01,0.552,0.6434262948207171,524,480
15,1104,10,100,0.001,0.01,0.474,0.6567028985507246,580,524
15,1204,10,100,0.001,0.01,0.564,0.707641196013289,619,585
15,1304,10,100,0.001,0.01,0.524,0.6855828220858896,666,638
15,1404,10,100,0.001,0.01,0.544,0.707977207977208,718,686
15,1504,10,100,0.001,0.01,0.498,0.7094414893617021,759,745
15,1604,10,100,0.001,0.01,0.522,0.7088528678304239,813,791
15,1704,10,100,0.001,0.01,0.524,0.687793427230047,860,844
15,1804,10,100,0.001,0.01,0.56,0.729490022172949,909,895
15,1904,10,100,0.001,0.01,0.552,0.7442226890756303,956,948
15,2004,10,100,0.001,0.01,0.528,0.7819361277445109,997,1007
15,2104,10,100,0.001,0.01,0.524,0.7533269961977186,1050,1054
15,2204,10,100,0.001,0.01,0.592,0.792649727767695,1104,1100
15,2304,10,100,0.001,0.01,0.58,0.8107638888888888,1157,1147
15,2404,10,100,0.001,0.01,0.57,0.8298668885191348,1213,1191
15,2504,10,100,0.001,0.01,0.606,0.825479233226837,1268,1236
15,2604,10,100,0.001,0.01,0.636,0.8605990783410138,1318,1286
15,2704,10,100,0.001,0.01,0.622,0.8768491124260355,1370,1334
15,2804,10,100,0.001,0.01,0.618,0.8883737517831669,1418,1386
15,2904,10,100,0.001,0.01,0.652,0.8715564738292011,1475,1429
15,3004,10,100,0.001,0.01,0.646,0.8984687083888149,1533,1471
15,3104,10,100,0.001,0.01,0.682,0.9226804123711341,1578,1526
15,3204,10,100,0.001,0.01,0.716,0.9488139825218477,1622,1582
15,3304,10,100,0.001,0.01,0.73,0.9570217917675545,1665,1639
15,3404,10,100,0.001,0.01,0.754,0.9612220916568742,1714,1690
15,3504,10,100,0.001,0.01,0.776,0.9560502283105022,1760,1744
15,3604,10,100,0.001,0.01,0.766,0.9747502774694784,1816,1788
15,3704,10,100,0.001,0.01,0.802,0.9838012958963283,1863,1841
15,3804,10,100,0.001,0.01,0.81,0.9831756046267087,1906,1898
15,3904,10,100,0.001,0.01,0.842,0.9869364754098361,1963,1941
15,4004,10,100,0.001,0.01,0.848,0.9882617382617382,2014,1990
15,4104,10,100,0.001,0.01,0.87,0.990009746588694,2072,2032
15,4204,10,100,0.001,0.01,0.87,0.9840627973358707,2131,2073
15,4304,10,100,0.001,0.01,0.872,0.9774628252788105,2180,2124
15,4404,10,100,0.001,0.01,0.874,0.9736603088101726,2230,2174
15,4504,10,100,0.001,0.01,0.84,0.9442717584369449,2282,2222
15,4604,10,100,0.001,0.01,0.916,0.9811033883579496,2330,2274
15,4704,10,100,0.001,0.01,0.916,0.9829931972789115,2383,2321
15,4804,10,100,0.001,0.01,0.92,0.9922980849292257,2440,2364
15,4904,10,100,0.001,0.01,0.944,0.9963295269168027,2493,2411
15,5004,10,100,0.001,0.01,0.952,0.9986011191047163,2532,2472
15,5104,10,100,0.001,0.01,0.954,0.9996081504702194,2590,2514
15,5204,10,100,0.001,0.01,0.952,0.9996156802459646,2632,2572
15,5304,10,100,0.001,0.01,0.958,0.9996229260935143,2688,2616
15,5404,10,100,0.001,0.01,0.954,0.9994448556624722,2738,2666
15,5504,10,100,0.001,0.01,0.96,0.998546511627907,2784,2720
15,5604,10,100,0.001,0.01,0.96,0.9976802284082797,2828,2776
15,5704,10,100,0.001,0.01,0.952,0.9982468443197756,2879,2825
15,5804,10,100,0.001,0.01,0.964,0.9982770503101309,2936,2868
15,5904,10,100,0.001,0.01,0.958,0.9981368563685636,2982,2922
15,6004,10,100,0.001,0.01,0.956,0.9983344437041972,3038,2966
15,6104,10,100,0.001,0.01,0.962,0.9993446920052425,3089,3015
15,6204,10,100,0.001,0.01,0.964,0.999838813668601,3141,3063
15,6304,10,100,0.001,0.01,0.966,0.9993654822335025,3197,3107
15,6404,10,100,0.001,0.01,0.944,0.980793254216115,3250,3154
15,6504,10,100,0.001,0.01,0.946,0.9876998769987699,3301,3203
15,6604,10,100,0.001,0.01,0.968,0.9903089036947305,3353,3251
15,6704,10,100,0.001,0.01,0.954,0.9925417661097852,3401,3303
15,6804,10,100,0.001,0.01,0.97,0.9985302763080541,3455,3349
15,6904,10,100,0.001,0.01,0.978,1.0,3500,3404
15,7004,10,100,0.001,0.01,0.97,0.9994288977727013,3558,3446
15,7104,10,100,0.001,0.01,0.968,0.9977477477477478,3613,3491
15,7204,10,100,0.001,0.01,0.968,0.999305941143809,3660,3544
15,7304,10,100,0.001,0.01,0.966,0.9990416210295728,3709,3595
15,7404,10,100,0.001,0.01,0.978,0.9985143165856294,3763,3641
15,7504,10,100,0.001,0.01,0.974,0.9986673773987207,3812,3692
15,7604,10,100,0.001,0.01,0.976,0.9985533929510784,3862,3742
15,7704,10,100,0.001,0.01,0.978,0.9993509865005192,3916,3788
15,7804,10,100,0.001,0.01,0.978,0.9994874423372629,3965,3839
15,7904,10,100,0.001,0.01,0.982,0.9994939271255061,4015,3889
15,8004,10,100,0.001,0.01,0.984,0.9998750624687656,4055,3949
15,8104,10,100,0.001,0.01,0.978,0.9996298124383021,4109,3995
15,8204,10,100,0.001,0.01,0.98,1.0,4161,4043
15,8304,10,100,0.001,0.01,0.98,0.9998795761078998,4213,4091
15,8404,10,100,0.001,0.01,0.978,0.9998810090433127,4267,4137
15,8504,10,100,0.001,0.01,0.982,1.0,4314,4190
15,8604,10,100,0.001,0.01,0.982,0.996978149697815,4351,4253
15,8704,10,100,0.001,0.01,0.958,0.9790900735294118,4405,4299
15,8804,10,100,0.001,0.01,0.966,0.98284870513403,4447,4357
15,8904,10,100,0.001,0.01,0.984,0.993486073674753,4499,4405
15,9004,10,100,0.001,0.01,0.984,0.9988893824966681,4543,4461
15,9104,10,100,0.001,0.01,0.99,1.0,4601,4503
15,9204,10,100,0.001,0.01,0.994,0.9997827031725337,4649,4555
15,9304,10,100,0.001,0.01,0.988,0.9997850386930353,4700,4604
15,9404,10,100,0.001,0.01,0.994,0.9995746490854955,4750,4654
15,9504,10,100,0.001,0.01,0.992,0.999263468013468,4799,4705
15,9604,10,100,0.001,0.01,0.99,1.0,4846,4758
15,9704,10,100,0.001,0.01,0.988,0.9995877988458368,4900,4804
15,9804,10,100,0.001,0.01,0.988,0.9970420236638107,4955,4849
15,9904,10,100,0.001,0.01,0.986,0.9981825525040388,4998,4906
15,10004,10,100,0.001,0.01,0.99,0.9956017592962815,5046,4958
15,10104,10,100,0.001,0.01,0.988,0.9951504354711006,5090,5014
15,10204,10,100,0.001,0.01,0.992,0.9990199921599373,5136,5068
15,10304,10,100,0.001,0.01,0.988,0.9989324534161491,5196,5108
15,10404,10,100,0.001,0.01,0.988,0.9974048442906575,5239,5165
15,10504,10,100,0.001,0.01,0.996,0.9998095963442498,5295,5209
15,10604,10,100,0.001,0.01,0.99,0.9994341757827235,5342,5262
15,10704,10,100,0.001,0.01,0.996,0.9988789237668162,5392,5312
15,10804,10,100,0.001,0.01,0.988,0.9977786005183266,5446,5358
15,10904,10,100,0.001,0.01,0.992,0.9988077769625825,5504,5400
15,11004,10,100,0.001,0.01,0.986,0.9982733551435842,5553,5451
15,11104,10,100,0.001,0.01,0.994,0.9989193083573487,5613,5491
15,11204,10,100,0.001,0.01,0.986,0.9955373081042485,5659,5545
15,11304,10,100,0.001,0.01,0.99,0.9946036801132343,5711,5593
15,11404,10,100,0.001,0.01,0.99,0.9978077867414942,5762,5642
15,11504,10,100,0.001,0.01,0.994,0.9980006954102921,5814,5690
15,11604,10,100,0.001,0.01,0.99,0.9974146845915202,5862,5742
15,11704,10,100,0.001,0.01,0.992,0.9977785372522214,5908,5796
15,11804,10,100,0.001,0.01,0.996,0.9982209420535412,5943,5861
15,11904,10,100,0.001,0.01,0.986,0.993195564516129,5994,5910
15,12004,10,100,0.001,0.01,0.996,0.9947517494168611,6047,5957
15,12104,10,100,0.001,0.01,0.99,0.9933079973562459,6101,6003
15,12204,10,100,0.001,0.01,0.994,0.9973779088823337,6158,6046
15,12304,10,100,0.001,0.01,0.994,0.9990247074122237,6219,6085
15,12404,10,100,0.001,0.01,0.996,0.9999193808448887,6264,6140
15,12504,10,100,0.001,0.01,0.996,1.0,6310,6194
15,12604,10,100,0.001,0.01,0.996,1.0,6363,6241
15,12704,10,100,0.001,0.01,0.996,1.0,6415,6289
15,12804,10,100,0.001,0.01,0.996,1.0,6462,6342
15,12904,10,100,0.001,0.01,0.996,0.9996900185988841,6498,6406
15,13004,10,100,0.001,0.01,0.996,1.0,6543,6461
15,13104,10,100,0.001,0.01,0.996,1.0,6587,6517
15,13204,10,100,0.001,0.01,0.996,1.0,6638,6566
15,13304,10,100,0.001,0.01,0.996,1.0,6688,6616
15,13404,10,100,0.001,0.01,0.996,1.0,6740,6664
15,13504,10,100,0.001,0.01,0.98,0.9908915876777251,6781,6723
15,13604,10,100,0.001,0.01,0.982,0.9913995883563658,6828,6776
15,13704,10,100,0.001,0.01,0.99,0.9966433158201985,6882,6822
15,13804,10,100,0.001,0.01,0.998,0.9989858012170385,6931,6873
15,13904,10,100,0.001,0.01,0.996,0.999928078250863,6978,6926
15,14004,10,100,0.001,0.01,0.998,0.9997143673236218,7022,6982
15,14104,10,100,0.001,0.01,0.996,0.9997163925127623,7066,7038
15,14204,10,100,0.001,0.01,0.996,0.9994367783722895,7114,7090
15,14304,10,100,0.001,0.01,0.998,0.9999300894854586,7159,7145
15,14404,10,100,0.001,0.01,0.998,1.0,7207,7197
15,14504,10,100,0.001,0.01,0.998,0.9996552675124104,7259,7245
15,14604,10,100,0.001,0.01,0.998,1.0,7320,7284
15,14704,10,100,0.001,0.01,0.998,0.9999319912948857,7370,7334
15,14804,10,100,0.001,0.01,0.998,0.9999324506890029,7433,7371
15,14904,10,100,0.001,0.01,0.996,0.9998658078368223,7479,7425
15,15004,10,100,0.001,0.01,0.996,0.999466808850973,7524,7480
16,104,10,100,0.001,0.01,0.516,0.4326923076923077,45,59
16,204,10,100,0.001,0.01,0.498,0.6470588235294118,96,108
16,304,10,100,0.001,0.01,0.522,0.5789473684210527,146,158
16,404,10,100,0.001,0.01,0.53,0.6386138613861386,211,193
16,504,10,100,0.001,0.01,0.534,0.6051587301587301,264,240
16,604,10,100,0.001,0.01,0.52,0.6158940397350994,311,293
16,704,10,100,0.001,0.01,0.536,0.6136363636363636,352,352
16,804,10,100,0.001,0.01,0.506,0.6206467661691543,402,402
16,904,10,100,0.001,0.01,0.526,0.6227876106194691,442,462
16,1004,10,100,0.001,0.01,0.508,0.6414342629482072,491,513
16,1104,10,100,0.001,0.01,0.548,0.6639492753623188,538,566
16,1204,10,100,0.001,0.01,0.492,0.6686046511627907,580,624
16,1304,10,100,0.001,0.01,0.534,0.6694785276073619,626,678
16,1404,10,100,0.001,0.01,0.502,0.6488603988603988,686,718
16,1504,10,100,0.001,0.01,0.538,0.7054521276595744,728,776
16,1604,10,100,0.001,0.01,0.534,0.6864089775561097,775,829
16,1704,10,100,0.001,0.01,0.514,0.6731220657276995,821,883
16,1804,10,100,0.001,0.01,0.542,0.7039911308203991,863,941
16,1904,10,100,0.001,0.01,0.544,0.7006302521008403,913,991
16,2004,10,100,0.001,0.01,0.578,0.7679640718562875,965,1039
16,2104,10,100,0.001,0.01,0.58,0.7404942965779467,1017,1087
16,2204,10,100,0.001,0.01,0.602,0.7754083484573503,1071,1133
16,2304,10,100,0.001,0.01,0.596,0.78125,1131,1173
16,2404,10,100,0.001,0.01,0.616,0.7853577371048253,1184,1220
16,2504,10,100,0.001,0.01,0.63,0.7771565495207667,1231,1273
16,2604,10,100,0.001,0.01,0.628,0.782258064516129,1281,1323
16,2704,10,100,0.001,0.01,0.632,0.8243343195266272,1333,1371
16,2804,10,100,0.001,0.01,0.66,0.8423680456490727,1381,1423
16,2904,10,100,0.001,0.01,0.636,0.8591597796143251,1428,1476
16,3004,10,100,0.001,0.01,0.65,0.8338881491344874,1485,1519
16,3104,10,100,0.001,0.01,0.654,0.8518041237113402,1529,1575
16,3204,10,100,0.001,0.01,0.674,0.8611111111111112,1586,1618
16,3304,10,100,0.001,0.01,0.67,0.837772397094431,1631,1673
16,3404,10,100,0.001,0.01,0.678,0.836075205640423,1688,1716
16,3504,10,100,0.001,0.01,0.688,0.853310502283105,1742,1762
16,3604,10,100,0.001,0.01,0.692,0.8626526082130965,1785,1819
16,3704,10,100,0.001,0.01,0.686,0.8542116630669546,1829,1875
16,3804,10,100,0.001,0.01,0.708,0.8735541535226078,1880,1924
16,3904,10,100,0.001,0.01,0.67,0.8637295081967213,1940,1964
16,4004,10,100,0.001,0.01,0.696,0.8703796203796204,1996,2008
16,4104,10,100,0.001,0.01,0.726,0.9042397660818714,2046,2058
16,4204,10,100,0.001,0.01,0.722,0.8879638439581351,2104,2100
16,4304,10,100,0.001,0.01,0.722,0.9049721189591078,2152,2152
16,4404,10,100,0.001,0.01,0.728,0.9098546775658493,2195,2209
16,4504,10,100,0.001,0.01,0.726,0.8841030195381883,2242,2262
16,4604,10,100,0.001,0.01,0.742,0.8887923544743701,2284,2320
16,4704,10,100,0.001,0.01,0.704,0.8582057823129252,2324,2380
16,4804,10,100,0.001,0.01,0.694,0.8932139883430474,2377,2427
16,4904,10,100,0.001,0.01,0.74,0.9135399673735726,2417,2487
16,5004,10,100,0.001,0.01,0.744,0.9188649080735412,2464,2540
16,5104,10,100,0.001,0.01,0.726,0.9302507836990596,2508,2596
16,5204,10,100,0.001,0.01,0.754,0.9267870868562644,2556,2648
16,5304,10,100,0.001,0.01,0.74,0.9068627450980392,2605,2699
16,5404,10,100,0.001,0.01,0.684,0.8406735751295337,2655,2749
16,5504,10,100,0.001,0.01,0.696,0.8041424418604651,2705,2799
16,5604,10,100,0.001,0.01,0.718,0.8104925053533191,2752,2852
16,5704,10,100,0.001,0.01,0.726,0.833976157082749,2798,2906
16,5804,10,100,0.001,0.01,0.75,0.8564782908339077,2845,2959
16,5904,10,100,0.001,0.01,0.772,0.9068428184281843,2903,3001
16,6004,10,100,0.001,0.01,0.764,0.9117255163224517,2953,3051
16,6104,10,100,0.001,0.01,0.772,0.9046526867627785,3008,3096
16,6204,10,100,0.001,0.01,0.762,0.8895873629916183,3060,3144
16,6304,10,100,0.001,0.01,0.742,0.8504124365482234,3109,3195
16,6404,10,100,0.001,0.01,0.786,0.9055277951280449,3159,3245
16,6504,10,100,0.001,0.01,0.796,0.9265067650676507,3208,3296
16,6604,10,100,0.001,0.01,0.8,0.9332222895215021,3258,3346
16,6704,10,100,0.001,0.01,0.814,0.943019093078759,3304,3400
16,6804,10,100,0.001,0.01,0.784,0.929159318048207,3359,3445
16,6904,10,100,0.001,0.01,0.78,0.9125144843568945,3412,3492
16,7004,10,100,0.001,0.01,0.802,0.9257567104511708,3464,3540
16,7104,10,100,0.001,0.01,0.804,0.9280686936936937,3513,3591
16,7204,10,100,0.001,0.01,0.756,0.8996390893947807,3570,3634
16,7304,10,100,0.001,0.01,0.748,0.8762322015334063,3618,3686
16,7404,10,100,0.001,0.01,0.758,0.9146407347379795,3668,3736
16,7504,10,100,0.001,0.01,0.8,0.9281716417910447,3721,3783
16,7604,10,100,0.001,0.01,0.804,0.9318779589689637,3770,3834
16,7704,10,100,0.001,0.01,0.828,0.9244548286604362,3814,3890
16,7804,10,100,0.001,0.01,0.816,0.9305484366991287,3865,3939
16,7904,10,100,0.001,0.01,0.822,0.9393977732793523,3914,3990
16,8004,10,100,0.001,0.01,0.838,0.9505247376311844,3962,4042
16,8104,10,100,0.001,0.01,0.85,0.9626110562685094,4004,4100
16,8204,10,100,0.001,0.01,0.85,0.9449049244271087,4056,4148
16,8304,10,100,0.001,0.01,0.854,0.9735067437379576,4111,4193
16,8404,10,100,0.001,0.01,0.862,0.9728700618752975,4163,4241
16,8504,10,100,0.001,0.01,0.826,0.9637817497648166,4217,4287
16,8604,10,100,0.001,0.01,0.876,0.9766387726638772,4267,4337
16,8704,10,100,0.001,0.01,0.866,0.9757582720588235,4323,4381
16,8804,10,100,0.001,0.01,0.88,0.985688323489323,4379,4425
16,8904,10,100,0.001,0.01,0.9,0.980121293800539,4426,4478
16,9004,10,100,0.001,0.01,0.888,0.9686805864060417,4474,4530
16,9104,10,100,0.001,0.01,0.862,0.9647407732864675,4513,4591
16,9204,10,100,0.001,0.01,0.866,0.9578444154715341,4566,4638
16,9304,10,100,0.001,0.01,0.85,0.9211092003439381,4616,4688
16,9404,10,100,0.001,0.01,0.844,0.9331135686941727,4674,4730
16,9504,10,100,0.001,0.01,0.876,0.9681186868686869,4723,4781
16,9604,10,100,0.001,0.01,0.902,0.9792794668887963,4776,4828
16,9704,10,100,0.001,0.01,0.912,0.9846455070074196,4821,4883
16,9804,10,100,0.001,0.01,0.906,0.976438188494492,4880,4924
16,9904,10,100,0.001,0.01,0.888,0.9844507269789984,4930,4974
16,10004,10,100,0.001,0.01,0.916,0.9783086765293882,4976,5028
16,10104,10,100,0.001,0.01,0.898,0.9858471892319873,5028,5076
16,10204,10,100,0.001,0.01,0.916,0.9860838886711094,5079,5125
16,10304,10,100,0.001,0.01,0.924,0.9854425465838509,5132,5172
16,10404,10,100,0.001,0.01,0.926,0.9790465205690119,5175,5229
16,10504,10,100,0.001,0.01,0.926,0.9869573495811119,5219,5285
16,10604,10,100,0.001,0.01,0.932,0.9887778196906828,5263,5341
16,10704,10,100,0.001,0.01,0.924,0.9818759342301944,5313,5391
16,10804,10,100,0.001,0.01,0.92,0.9894483524620511,5363,5441
16,10904,10,100,0.001,0.01,0.93,0.9879860601614087,5417,5487
16,11004,10,100,0.001,0.01,0.934,0.9920937840785169,5468,5536
16,11104,10,100,0.001,0.01,0.932,0.9936059077809798,5522,5582
16,11204,10,100,0.001,0.01,0.946,0.996876115672974,5575,5629
16,11304,10,100,0.001,0.01,0.942,0.9961075725406936,5622,5682
16,11404,10,100,0.001,0.01,0.934,0.9881620484040687,5663,5741
16,11504,10,100,0.001,0.01,0.904,0.9752260083449235,5718,5786
16,11604,10,100,0.001,0.01,0.902,0.9646673560841089,5766,5838
16,11704,10,100,0.001,0.01,0.942,0.9838516746411483,5818,5886
16,11804,10,100,0.001,0.01,0.918,0.9771263978312437,5872,5932
16,11904,10,100,0.001,0.01,0.94,0.9940356182795699,5918,5986
16,12004,10,100,0.001,0.01,0.932,0.988003998667111,5974,6030
16,12104,10,100,0.001,0.01,0.952,0.9866986120290813,6027,6077
16,12204,10,100,0.001,0.01,0.94,0.9930350704686988,6069,6135
16,12304,10,100,0.001,0.01,0.94,0.9880526657997399,6117,6187
16,12404,10,100,0.001,0.01,0.954,0.9950016123831023,6160,6244
16,12504,10,100,0.001,0.01,0.946,0.9949616122840691,6211,6293
16,12604,10,100,0.001,0.01,0.948,0.9961123452872104,6257,6347
16,12704,10,100,0.001,0.01,0.946,0.9972449622166247,6305,6399
16,12804,10,100,0.001,0.01,0.948,0.9928928459856294,6345,6459
16,12904,10,100,0.001,0.01,0.94,0.9886081835089895,6402,6502
16,13004,10,100,0.001,0.01,0.92,0.9813903414334051,6453,6551
16,13104,10,100,0.001,0.01,0.942,0.9883241758241759,6504,6600
16,13204,10,100,0.001,0.01,0.948,0.9909875795213572,6556,6648
16,13304,10,100,0.001,0.01,0.96,0.9930096211665664,6602,6702
16,13404,10,100,0.001,0.01,0.954,0.9973888391524918,6653,6751
16,13504,10,100,0.001,0.01,0.96,0.998074644549763,6694,6810
16,13604,10,100,0.001,0.01,0.952,0.9897089091443693,6756,6848
16,13704,10,100,0.001,0.01,0.948,0.9962784588441331,6810,6894
16,13804,10,100,0.001,0.01,0.954,0.994566792234135,6862,6942
16,13904,10,100,0.001,0.01,0.952,0.9966196777905638,6912,6992
16,14004,10,100,0.001,0.01,0.95,0.9866466723793202,6959,7045
16,14104,10,100,0.001,0.01,0.944,0.982274532047646,7012,7092
16,14204,10,100,0.001,0.01,0.948,0.9878907350042242,7064,7140
16,14304,10,100,0.001,0.01,0.956,0.9935682326621924,7116,7188
16,14404,10,100,0.001,0.01,0.956,0.9961816162177173,7168,7236
16,14504,10,100,0.001,0.01,0.944,0.984142305570877,7224,7280
16,14604,10,100,0.001,0.01,0.95,0.9930156121610517,7277,7327
16,14704,10,100,0.001,0.01,0.956,0.9934031556039173,7327,7377
16,14804,10,100,0.001,0.01,0.966,0.9968251823831397,7378,7426
16,14904,10,100,0.001,0.01,0.958,0.9890633387010198,7434,7470
16,15004,10,100,0.001,0.01,0.948,0.9802052785923754,7494,7510
17,104,10,100,0.001,0.01,0.51,0.5384615384615384,56,48
17,204,10,100,0.001,0.01,0.51,0.6078431372549019,116,88
17,304,10,100,0.001,0.01,0.532,0.5855263157894737,173,131
17,404,10,100,0.001,0.01,0.492,0.655940594059406,221,183
17,504,10,100,0.001,0.01,0.498,0.6746031746031746,269,235
17,604,10,100,0.001,0.01,0.512,0.652317880794702,318,286
17,704,10,100,0.001,0.01,0.476,0.6434659090909091,372,332
17,804,10,100,0.001,0.01,0.506,0.650497512437811,423,381
17,904,10,100,0.001,0.01,0.536,0.6482300884955752,472,432
17,1004,10,100,0.001,0.01,0.55,0.6723107569721115,526,478
17,1104,10,100,0.001,0.01,0.54,0.6811594202898551,568,536
17,1204,10,100,0.001,0.01,0.562,0.7001661129568106,616,588
17,1304,10,100,0.001,0.01,0.544,0.691717791411043,660,644
17,1404,10,100,0.001,0.01,0.578,0.7037037037037037,708,696
17,1504,10,100,0.001,0.01,0.53,0.7047872340425532,759,745
17,1604,10,100,0.001,0.01,0.522,0.6845386533665836,810,794
17,1704,10,100,0.001,0.01,0.522,0.7265258215962441,857,847
17,1804,10,100,0.001,0.01,0.574,0.7167405764966741,915,889
17,1904,10,100,0.001,0.01,0.56,0.729516806722689,965,939
17,2004,10,100,0.001,0.01,0.596,0.7485029940119761,1012,992
17,2104,10,100,0.001,0.01,0.578,0.7585551330798479,1058,1046
17,2204,10,100,0.001,0.01,0.614,0.7676950998185118,1114,1090
17,2304,10,100,0.001,0.01,0.608,0.7847222222222222,1161,1143
17,2404,10,100,0.001,0.01,0.63,0.7974209650582362,1218,1186
17,2504,10,100,0.001,0.01,0.624,0.8083067092651757,1264,1240
17,2604,10,100,0.001,0.01,0.654,0.8233486943164362,1310,1294
17,2704,10,100,0.001,0.01,0.678,0.8424556213017751,1365,1339
17,2804,10,100,0.001,0.01,0.672,0.8473609129814551,1413,1391
17,2904,10,100,0.001,0.01,0.7,0.8684573002754821,1467,1437
17,3004,10,100,0.001,0.01,0.688,0.8818242343541944,1519,1485
17,3104,10,100,0.001,0.01,0.71,0.873389175257732,1572,1532
17,3204,10,100,0.001,0.01,0.724,0.8920099875156055,1617,1587
17,3304,10,100,0.001,0.01,0.75,0.910411622276029,1662,1642
17,3404,10,100,0.001,0.01,0.736,0.9203877790834313,1712,1692
17,3504,10,100,0.001,0.01,0.78,0.918093607305936,1771,1733
17,3604,10,100,0.001,0.01,0.724,0.904550499445061,1822,1782
17,3704,10,100,0.001,0.01,0.782,0.9422246220302376,1876,1828
17,3804,10,100,0.001,0.01,0.796,0.9497896950578338,1924,1880
17,3904,10,100,0.001,0.01,0.826,0.970030737704918,1977,1927
17,4004,10,100,0.001,0.01,0.816,0.9250749250749251,2026,1978
17,4104,10,100,0.001,0.01,0.822,0.9544346978557505,2081,2023
17,4204,10,100,0.001,0.01,0.848,0.9631303520456708,2131,2073
17,4304,10,100,0.001,0.01,0.844,0.9772304832713755,2172,2132
17,4404,10,100,0.001,0.01,0.852,0.9675295186194369,2220,2184
17,4504,10,100,0.001,0.01,0.818,0.8958703374777975,2268,2236
17,4604,10,100,0.001,0.01,0.848,0.9448305821025196,2317,2287
17,4704,10,100,0.001,0.01,0.866,0.9570578231292517,2372,2332
17,4804,10,100,0.001,0.01,0.858,0.966278101582015,2412,2392
17,4904,10,100,0.001,0.01,0.88,0.9808319738988581,2460,2444
17,5004,10,100,0.001,0.01,0.868,0.964828137490008,2503,2501
17,5104,10,100,0.001,0.01,0.884,0.9737460815047022,2549,2555
17,5204,10,100,0.001,0.01,0.892,0.9834742505764796,2598,2606
17,5304,10,100,0.001,0.01,0.918,0.9924585218702866,2641,2663
17,5404,10,100,0.001,0.01,0.906,0.9909326424870466,2683,2721
17,5504,10,100,0.001,0.01,0.898,0.9778343023255814,2729,2775
17,5604,10,100,0.001,0.01,0.902,0.9839400428265525,2784,2820
17,5704,10,100,0.001,0.01,0.886,0.9652875175315568,2828,2876
17,5804,10,100,0.001,0.01,0.89,0.9610613370089593,2877,2927
17,5904,10,100,0.001,0.01,0.882,0.9337737127371274,2933,2971
17,6004,10,100,0.001,0.01,0.87,0.9435376415722851,2981,3023
17,6104,10,100,0.001,0.01,0.91,0.9698558322411533,3033,3071
17,6204,10,100,0.001,0.01,0.864,0.9252095422308189,3089,3115
17,6304,10,100,0.001,0.01,0.92,0.9568527918781726,3142,3162
17,6404,10,100,0.001,0.01,0.944,0.9815740162398501,3194,3210
17,6504,10,100,0.001,0.01,0.948,0.992619926199262,3234,3270
17,6604,10,100,0.001,0.01,0.944,0.9922774076317383,3290,3314
17,6704,10,100,0.001,0.01,0.96,0.9967183770883055,3336,3368
17,6804,10,100,0.001,0.01,0.95,0.9954438565549677,3387,3417
17,6904,10,100,0.001,0.01,0.968,0.996523754345307,3432,3472
17,7004,10,100,0.001,0.01,0.962,0.9947173043974872,3468,3536
17,7104,10,100,0.001,0.01,0.956,0.9946509009009009,3521,3583
17,7204,10,100,0.001,0.01,0.948,0.9838978345363687,3579,3625
17,7304,10,100,0.001,0.01,0.952,0.9863088718510405,3628,3676
17,7404,10,100,0.001,0.01,0.93,0.9771745002701242,3680,3724
17,7504,10,100,0.001,0.01,0.956,0.9888059701492538,3724,3780
17,7604,10,100,0.001,0.01,0.952,0.9940820620725934,3774,3830
17,7704,10,100,0.001,0.01,0.964,0.9962357217030114,3825,3879
17,7804,10,100,0.001,0.01,0.966,0.9966683751922091,3882,3922
17,7904,10,100,0.001,0.01,0.96,0.9943066801619433,3938,3966
17,8004,10,100,0.001,0.01,0.97,0.9978760619690155,3981,4023
17,8104,10,100,0.001,0.01,0.968,0.9981490621915103,4031,4073
17,8204,10,100,0.001,0.01,0.974,0.9984154071184788,4083,4121
17,8304,10,100,0.001,0.01,0.968,0.9983140655105973,4131,4173
17,8404,10,100,0.001,0.01,0.97,0.9967872441694431,4179,4225
17,8504,10,100,0.001,0.01,0.976,0.9981185324553151,4234,4270
17,8604,10,100,0.001,0.01,0.954,0.9945374244537425,4279,4325
17,8704,10,100,0.001,0.01,0.972,0.994140625,4336,4368
17,8804,10,100,0.001,0.01,0.97,0.9978418900499773,4389,4415
17,8904,10,100,0.001,0.01,0.972,0.9985399820305481,4437,4467
17,9004,10,100,0.001,0.01,0.98,0.9991115059973346,4490,4514
17,9104,10,100,0.001,0.01,0.966,0.9932996485061512,4540,4564
17,9204,10,100,0.001,0.01,0.976,0.9963059539330725,4594,4610
17,9304,10,100,0.001,0.01,0.946,0.9831255374032674,4644,4660
17,9404,10,100,0.001,0.01,0.944,0.9839430029774564,4705,4699
17,9504,10,100,0.001,0.01,0.964,0.9822180134680135,4747,4757
17,9604,10,100,0.001,0.01,0.972,0.989067055393586,4792,4812
17,9704,10,100,0.001,0.01,0.98,0.9962901896125309,4841,4863
17,9804,10,100,0.001,0.01,0.98,0.9978580171358629,4894,4910
17,9904,10,100,0.001,0.01,0.98,0.997778675282714,4940,4964
17,10004,10,100,0.001,0.01,0.986,0.9987005197920832,4997,5007
17,10104,10,100,0.001,0.01,0.98,0.9978226444972288,5048,5056
17,10204,10,100,0.001,0.01,0.982,0.997843982751862,5098,5106
17,10304,10,100,0.001,0.01,0.98,0.9971855590062112,5141,5163
17,10404,10,100,0.001,0.01,0.984,0.9959630911188004,5190,5214
17,10504,10,100,0.001,0.01,0.974,0.9936214775323686,5243,5261
17,10604,10,100,0.001,0.01,0.98,0.9912297246322143,5297,5307
17,10704,10,100,0.001,0.01,0.978,0.9932735426008968,5342,5362
17,10804,10,100,0.001,0.01,0.98,0.9941688263606072,5393,5411
17,10904,10,100,0.001,0.01,0.984,0.9920212765957447,5437,5467
17,11004,10,100,0.001,0.01,0.984,0.9964558342420938,5490,5514
17,11104,10,100,0.001,0.01,0.98,0.9987391930835735,5541,5563
17,11204,10,100,0.001,0.01,0.986,0.9986611924312745,5594,5610
17,11304,10,100,0.001,0.01,0.986,0.9993807501769285,5651,5653
17,11404,10,100,0.001,0.01,0.988,0.9992108032269379,5702,5702
17,11504,10,100,0.001,0.01,0.988,0.9987830319888734,5748,5756
17,11604,10,100,0.001,0.01,0.986,0.999741468459152,5804,5800
17,11704,10,100,0.001,0.01,0.986,0.9976930963773069,5854,5850
17,11804,10,100,0.001,0.01,0.982,0.9959335818366656,5897,5907
17,11904,10,100,0.001,0.01,0.976,0.9924395161290323,5946,5958
17,12004,10,100,0.001,0.01,0.984,0.9913362212595801,5997,6007
17,12104,10,100,0.001,0.01,0.968,0.9757105089226702,6044,6060
17,12204,10,100,0.001,0.01,0.96,0.9805801376597837,6100,6104
17,12304,10,100,0.001,0.01,0.984,0.995204811443433,6145,6159
17,12404,10,100,0.001,0.01,0.992,0.9991131892937762,6199,6205
17,12504,10,100,0.001,0.01,0.986,0.9996001279590531,6253,6251
17,12604,10,100,0.001,0.01,0.988,0.9998413202158045,6310,6294
17,12704,10,100,0.001,0.01,0.99,0.9996064231738035,6364,6340
17,12804,10,100,0.001,0.01,0.992,0.999843798812871,6413,6391
17,12904,10,100,0.001,0.01,0.99,1.0,6463,6441
17,13004,10,100,0.001,0.01,0.99,0.9999231005844356,6518,6486
17,13104,10,100,0.001,0.01,0.992,0.9993894993894994,6568,6536
17,13204,10,100,0.001,0.01,0.994,0.999924265374129,6613,6591
17,13304,10,100,0.001,0.01,0.992,1.0,6662,6642
17,13404,10,100,0.001,0.01,0.992,1.0,6710,6694
17,13504,10,100,0.001,0.01,0.986,0.9990373222748815,6761,6743
17,13604,10,100,0.001,0.01,0.982,0.9942663922375772,6804,6800
17,13704,10,100,0.001,0.01,0.992,0.9917542323409223,6855,6849
17,13804,10,100,0.001,0.01,0.962,0.9697189220515793,6903,6901
17,13904,10,100,0.001,0.01,0.992,0.9951093210586881,6950,6954
17,14004,10,100,0.001,0.01,0.994,0.9982147957726364,6999,7005
17,14104,10,100,0.001,0.01,0.99,0.9986528644356211,7046,7058
17,14204,10,100,0.001,0.01,0.99,0.9991551675584343,7095,7109
17,14304,10,100,0.001,0.01,0.99,0.9997203579418344,7141,7163
17,14404,10,100,0.001,0.01,0.992,0.9998611496806442,7190,7214
17,14504,10,100,0.001,0.01,0.992,0.9993105350248207,7242,7262
17,14604,10,100,0.001,0.01,0.974,0.979252259654889,7296,7308
17,14704,10,100,0.001,0.01,0.988,0.9946953210010882,7347,7357
17,14804,10,100,0.001,0.01,0.952,0.9606863009997298,7390,7414
17,14904,10,100,0.001,0.01,0.994,0.9953703703703703,7443,7461
17,15004,10,100,0.001,0.01,0.992,0.9991335643828313,7497,7507
18,104,10,100,0.001,0.01,0.502,0.6057692307692307,45,59
18,204,10,100,0.001,0.01,0.482,0.553921568627451,96,108
18,304,10,100,0.001,0.01,0.434,0.7171052631578947,138,166
18,404,10,100,0.001,0.01,0.468,0.6064356435643564,191,213
18,504,10,100,0.001,0.01,0.484,0.7142857142857143,242,262
18,604,10,100,0.001,0.01,0.478,0.6788079470198676,295,309
18,704,10,100,0.001,0.01,0.49,0.703125,348,356
18,804,10,100,0.001,0.01,0.486,0.7338308457711443,399,405
18,904,10,100,0.001,0.01,0.48,0.7323008849557522,450,454
18,1004,10,100,0.001,0.01,0.49,0.7649402390438247,495,509
18,1104,10,100,0.001,0.01,0.502,0.7418478260869565,547,557
18,1204,10,100,0.001,0.01,0.504,0.7807308970099668,591,613
18,1304,10,100,0.001,0.01,0.486,0.7822085889570553,631,673
18,1404,10,100,0.001,0.01,0.502,0.782051282051282,683,721
18,1504,10,100,0.001,0.01,0.512,0.7952127659574468,728,776
18,1604,10,100,0.001,0.01,0.516,0.7755610972568578,783,821
18,1704,10,100,0.001,0.01,0.528,0.7875586854460094,835,869
18,1804,10,100,0.001,0.01,0.52,0.8248337028824834,881,923
18,1904,10,100,0.001,0.01,0.526,0.8109243697478992,924,980
18,2004,10,100,0.001,0.01,0.542,0.8602794411177644,971,1033
18,2104,10,100,0.001,0.01,0.54,0.8868821292775665,1024,1080
18,2204,10,100,0.001,0.01,0.528,0.8797640653357531,1084,1120
18,2304,10,100,0.001,0.01,0.58,0.8645833333333334,1135,1169
18,2404,10,100,0.001,0.01,0.596,0.8922628951747088,1185,1219
18,2504,10,100,0.001,0.01,0.6,0.9013578274760383,1233,1271
18,2604,10,100,0.001,0.01,0.622,0.9251152073732719,1286,1318
18,2704,10,100,0.001,0.01,0.618,0.8942307692307693,1342,1362
18,2804,10,100,0.001,0.01,0.664,0.9404422253922967,1384,1420
18,2904,10,100,0.001,0.01,0.662,0.9366391184573003,1442,1462
18,3004,10,100,0.001,0.01,0.704,0.9400798934753661,1488,1516
18,3104,10,100,0.001,0.01,0.718,0.9536082474226805,1539,1565
18,3204,10,100,0.001,0.01,0.714,0.9531835205992509,1593,1611
18,3304,10,100,0.001,0.01,0.726,0.9427966101694916,1651,1653
18,3404,10,100,0.001,0.01,0.75,0.9632784958871915,1711,1693
18,3504,10,100,0.001,0.01,0.77,0.9803082191780822,1757,1747
18,3604,10,100,0.001,0.01,0.784,0.9844617092119867,1808,1796
18,3704,10,100,0.001,0.01,0.782,0.9792116630669546,1864,1840
18,3804,10,100,0.001,0.01,0.816,0.9907991587802313,1917,1887
18,3904,10,100,0.001,0.01,0.78,0.9441598360655737,1964,1940
18,4004,10,100,0.001,0.01,0.808,0.968031968031968,2008,1996
18,4104,10,100,0.001,0.01,0.826,0.9778265107212476,2052,2052
18,4204,10,100,0.001,0.01,0.842,0.9931018078020932,2099,2105
18,4304,10,100,0.001,0.01,0.864,0.9923327137546468,2161,2143
18,4404,10,100,0.001,0.01,0.842,0.9911444141689373,2214,2190
18,4504,10,100,0.001,0.01,0.864,0.9955595026642984,2253,2251
18,4604,10,100,0.001,0.01,0.87,0.9971763683753258,2301,2303
18,4704,10,100,0.001,0.01,0.868,0.9974489795918368,2364,2340
18,4804,10,100,0.001,0.01,0.876,0.9966694421315571,2409,2395
18,4904,10,100,0.001,0.01,0.868,0.9959216965742251,2456,2448
18,5004,10,100,0.001,0.01,0.858,0.9886091127098321,2503,2501
18,5104,10,100,0.001,0.01,0.872,0.9935344827586207,2565,2539
18,5204,10,100,0.001,0.01,0.858,0.9744427363566487,2615,2589
18,5304,10,100,0.001,0.01,0.86,0.9820889894419306,2671,2633
18,5404,10,100,0.001,0.01,0.866,0.9850111028867505,2725,2679
18,5504,10,100,0.001,0.01,0.87,0.9809229651162791,2773,2731
18,5604,10,100,0.001,0.01,0.91,0.9866167023554604,2831,2773
18,5704,10,100,0.001,0.01,0.902,0.9924614305750351,2882,2822
18,5804,10,100,0.001,0.01,0.922,0.9950034458993797,2927,2877
18,5904,10,100,0.001,0.01,0.908,0.9845867208672087,2977,2927
18,6004,10,100,0.001,0.01,0.918,0.991672218520986,3023,2981
18,6104,10,100,0.001,0.01,0.934,0.9973787680209698,3073,3031
18,6204,10,100,0.001,0.01,0.938,0.9945196647324307,3121,3083
18,6304,10,100,0.001,0.01,0.93,0.9949238578680203,3167,3137
18,6404,10,100,0.001,0.01,0.928,0.9971892567145534,3227,3177
18,6504,10,100,0.001,0.01,0.934,0.9976937269372693,3281,3223
18,6604,10,100,0.001,0.01,0.94,0.997274379164143,3334,3270
18,6704,10,100,0.001,0.01,0.944,0.9961217183770883,3388,3316
18,6804,10,100,0.001,0.01,0.934,0.9973544973544973,3433,3371
18,6904,10,100,0.001,0.01,0.938,0.9953650057937428,3480,3424
18,7004,10,100,0.001,0.01,0.934,0.992147344374643,3526,3478
18,7104,10,100,0.001,0.01,0.942,0.9936655405405406,3572,3532
18,7204,10,100,0.001,0.01,0.934,0.9761243753470294,3629,3575
18,7304,10,100,0.001,0.01,0.936,0.9719331872946331,3676,3628
18,7404,10,100,0.001,0.01,0.924,0.9700162074554295,3721,3683
18,7504,10,100,0.001,0.01,0.958,0.992137526652452,3775,3729
18,7604,10,100,0.001,0.01,0.964,0.9967122567069964,3829,3775
18,7704,10,100,0.001,0.01,0.966,0.9968847352024922,3870,3834
18,7804,10,100,0.001,0.01,0.97,0.997565351101999,3917,3887
18,7904,10,100,0.001,0.01,0.968,0.9988613360323887,3972,3932
18,8004,10,100,0.001,0.01,0.972,0.9992503748125937,4025,3979
18,8104,10,100,0.001,0.01,0.976,0.9987660414610069,4078,4026
18,8204,10,100,0.001,0.01,0.972,1.0,4134,4070
18,8304,10,100,0.001,0.01,0.972,0.9997591522157996,4188,4116
18,8404,10,100,0.001,0.01,0.972,0.9991670633031889,4240,4164
18,8504,10,100,0.001,0.01,0.976,0.9995296331138288,4293,4211
18,8604,10,100,0.001,0.01,0.978,0.9998837749883775,4347,4257
18,8704,10,100,0.001,0.01,0.976,0.9978170955882353,4386,4318
18,8804,10,100,0.001,0.01,0.978,0.9955701953657429,4443,4361
18,8904,10,100,0.001,0.01,0.974,0.9931491464510332,4488,4416
18,9004,10,100,0.001,0.01,0.954,0.9825633051976899,4538,4466
18,9104,10,100,0.001,0.01,0.962,0.9827548330404218,4581,4523
18,9204,10,100,0.001,0.01,0.98,0.9958713602781399,4622,4582
18,9304,10,100,0.001,0.01,0.978,0.9953783319002579,4680,4624
18,9404,10,100,0.001,0.01,0.982,0.9988302849851127,4733,4671
18,9504,10,100,0.001,0.01,0.988,0.9984217171717171,4785,4719
18,9604,10,100,0.001,0.01,0.988,0.9998958767180341,4832,4772
18,9704,10,100,0.001,0.01,0.992,1.0,4887,4817
18,9804,10,100,0.001,0.01,0.99,1.0,4935,4869
18,9904,10,100,0.001,0.01,0.994,0.9998990306946688,4985,4919
18,10004,10,100,0.001,0.01,0.994,1.0,5031,4973
18,10104,10,100,0.001,0.01,0.99,0.9995051464766429,5084,5020
18,10204,10,100,0.001,0.01,0.992,0.9993139945119561,5140,5064
18,10304,10,100,0.001,0.01,0.988,0.9992236024844721,5190,5114
18,10404,10,100,0.001,0.01,0.994,0.9998077662437524,5237,5167
18,10504,10,100,0.001,0.01,0.994,0.997048743335872,5287,5217
18,10604,10,100,0.001,0.01,0.976,0.9983025273481705,5333,5271
18,10704,10,100,0.001,0.01,0.992,0.9937406576980568,5386,5318
18,10804,10,100,0.001,0.01,0.986,0.9918548685671973,5436,5368
18,10904,10,100,0.001,0.01,0.994,0.995964783565664,5484,5420
18,11004,10,100,0.001,0.01,0.992,0.9941839331152308,5537,5467
18,11104,10,100,0.001,0.01,0.986,0.9963976945244957,5583,5521
18,11204,10,100,0.001,0.01,0.978,0.9926811852909675,5625,5579
18,11304,10,100,0.001,0.01,0.99,0.9949575371549894,5673,5631
18,11404,10,100,0.001,0.01,0.988,0.996580147316731,5724,5680
18,11504,10,100,0.001,0.01,0.99,0.9949582753824756,5775,5729
18,11604,10,100,0.001,0.01,0.988,0.9976732161323681,5822,5782
18,11704,10,100,0.001,0.01,0.986,0.9994019138755981,5863,5841
18,11804,10,100,0.001,0.01,0.992,0.9972043375127075,5904,5900
18,11904,10,100,0.001,0.01,0.99,0.9996639784946236,5952,5952
18,12004,10,100,0.001,0.01,0.996,0.9989170276574475,5994,6010
18,12104,10,100,0.001,0.01,0.99,0.9998347653668209,6043,6061
18,12204,10,100,0.001,0.01,0.994,0.9997541789577188,6085,6119
18,12304,10,100,0.001,0.01,0.996,0.9995936280884266,6139,6165
18,12404,10,100,0.001,0.01,0.988,0.9992744276039988,6191,6213
18,12504,10,100,0.001,0.01,0.996,0.9999200255918106,6240,6264
18,12604,10,100,0.001,0.01,0.99,0.9928594097112028,6287,6317
18,12704,10,100,0.001,0.01,0.986,0.9892159949622166,6335,6369
18,12804,10,100,0.001,0.01,0.986,0.9927366447985004,6392,6412
18,12904,10,100,0.001,0.01,0.994,0.9980626162430254,6439,6465
18,13004,10,100,0.001,0.01,0.986,0.9971547216241157,6492,6512
18,13104,10,100,0.001,0.01,0.996,0.9998473748473748,6539,6565
18,13204,10,100,0.001,0.01,0.996,1.0,6597,6607
18,13304,10,100,0.001,0.01,0.996,1.0,6647,6657
18,13404,10,100,0.001,0.01,0.996,1.0,6691,6713
18,13504,10,100,0.001,0.01,0.998,1.0,6750,6754
18,13604,10,100,0.001,0.01,0.994,0.9984563363716554,6798,6806
18,13704,10,100,0.001,0.01,0.992,0.9941622883829538,6856,6848
18,13804,10,100,0.001,0.01,0.992,0.9968849608809041,6906,6898
18,13904,10,100,0.001,0.01,0.996,0.9971950517836594,6946,6958
18,14004,10,100,0.001,0.01,0.99,0.9948586118251928,7005,6999
18,14104,10,100,0.001,0.01,0.996,0.9980147475893364,7052,7052
18,14204,10,100,0.001,0.01,0.994,0.9990143621515066,7096,7108
18,14304,10,100,0.001,0.01,0.996,0.9995805369127517,7143,7161
18,14404,10,100,0.001,0.01,0.994,0.9992363232435435,7193,7211
18,14504,10,100,0.001,0.01,0.996,0.9993105350248207,7256,7248
18,14604,10,100,0.001,0.01,0.998,0.9974664475486168,7310,7294
18,14704,10,100,0.001,0.01,0.996,0.9990478781284005,7355,7349
18,14804,10,100,0.001,0.01,0.99,0.9962172385841664,7401,7403
18,14904,10,100,0.001,0.01,0.992,0.9989264626945786,7449,7455
18,15004,10,100,0.001,0.01,0.988,0.9978672354038923,7506,7498
19,104,10,100,0.001,0.01,0.498,0.6346153846153846,52,52
19,204,10,100,0.001,0.01,0.528,0.5392156862745098,104,100
19,304,10,100,0.001,0.01,0.516,0.5723684210526315,160,144
19,404,10,100,0.001,0.01,0.472,0.5346534653465347,207,197
19,504,10,100,0.001,0.01,0.464,0.5595238095238095,257,247
19,604,10,100,0.001,0.01,0.508,0.6109271523178808,303,301
19,704,10,100,0.001,0.01,0.518,0.5880681818181818,357,347
19,804,10,100,0.001,0.01,0.53,0.5945273631840796,401,403
19,904,10,100,0.001,0.01,0.508,0.6095132743362832,449,455
19,1004,10,100,0.001,0.01,0.486,0.6384462151394422,500,504
19,1104,10,100,0.001,0.01,0.488,0.6422101449275363,547,557
19,1204,10,100,0.001,0.01,0.506,0.670265780730897,605,599
19,1304,10,100,0.001,0.01,0.492,0.6641104294478528,665,639
19,1404,10,100,0.001,0.01,0.496,0.6780626780626781,714,690
19,1504,10,100,0.001,0.01,0.51,0.6688829787234043,770,734
19,1604,10,100,0.001,0.01,0.514,0.7038653366583542,810,794
19,1704,10,100,0.001,0.01,0.484,0.6942488262910798,866,838
19,1804,10,100,0.001,0.01,0.512,0.7305986696230599,917,887
19,1904,10,100,0.001,0.01,0.476,0.7226890756302521,962,942
19,2004,10,100,0.001,0.01,0.506,0.7280439121756487,1010,994
19,2104,10,100,0.001,0.01,0.498,0.7376425855513308,1068,1036
19,2204,10,100,0.001,0.01,0.554,0.7586206896551724,1116,1088
19,2304,10,100,0.001,0.01,0.568,0.7942708333333334,1167,1137
19,2404,10,100,0.001,0.01,0.578,0.8186356073211315,1213,1191
19,2504,10,100,0.001,0.01,0.606,0.7891373801916933,1252,1252
19,2604,10,100,0.001,0.01,0.596,0.7807219662058372,1303,1301
19,2704,10,100,0.001,0.01,0.584,0.728180473372781,1352,1352
19,2804,10,100,0.001,0.01,0.69,0.8248930099857347,1405,1399
19,2904,10,100,0.001,0.01,0.684,0.8539944903581267,1448,1456
19,3004,10,100,0.001,0.01,0.696,0.8515312916111851,1497,1507
19,3104,10,100,0.001,0.01,0.674,0.8530927835051546,1538,1566
19,3204,10,100,0.001,0.01,0.686,0.848314606741573,1591,1613
19,3304,10,100,0.001,0.01,0.688,0.8529055690072639,1639,1665
19,3404,10,100,0.001,0.01,0.688,0.849882491186839,1677,1727
19,3504,10,100,0.001,0.01,0.73,0.8647260273972602,1726,1778
19,3604,10,100,0.001,0.01,0.752,0.904550499445061,1778,1826
19,3704,10,100,0.001,0.01,0.766,0.9052375809935205,1830,1874
19,3804,10,100,0.001,0.01,0.772,0.9121976866456362,1883,1921
19,3904,10,100,0.001,0.01,0.77,0.9228995901639344,1930,1974
19,4004,10,100,0.001,0.01,0.768,0.9330669330669331,1979,2025
19,4104,10,100,0.001,0.01,0.784,0.9332358674463938,2025,2079
19,4204,10,100,0.001,0.01,0.806,0.9310180780209324,2075,2129
19,4304,10,100,0.001,0.01,0.81,0.9451672862453532,2119,2185
19,4404,10,100,0.001,0.01,0.798,0.9445958219800181,2164,2240
19,4504,10,100,0.001,0.01,0.794,0.9353907637655418,2221,2283
19,4604,10,100,0.001,0.01,0.806,0.9402693310165073,2268,2336
19,4704,10,100,0.001,0.01,0.814,0.9443027210884354,2316,2388
19,4804,10,100,0.001,0.01,0.808,0.9508742714404663,2371,2433
19,4904,10,100,0.001,0.01,0.818,0.9645187601957586,2422,2482
19,5004,10,100,0.001,0.01,0.786,0.917066346922462,2468,2536
19,5104,10,100,0.001,0.01,0.804,0.9220219435736677,2515,2589
19,5204,10,100,0.001,0.01,0.814,0.9398539584934665,2566,2638
19,5304,10,100,0.001,0.01,0.836,0.9547511312217195,2613,2691
19,5404,10,100,0.001,0.01,0.828,0.944300518134715,2665,2739
19,5504,10,100,0.001,0.01,0.828,0.965843023255814,2731,2773
19,5604,10,100,0.001,0.01,0.798,0.9530692362598144,2782,2822
19,5704,10,100,0.001,0.01,0.8,0.9353085553997195,2833,2871
19,5804,10,100,0.001,0.01,0.85,0.95434183321847,2883,2921
19,5904,10,100,0.001,0.01,0.826,0.9622289972899729,2918,2986
19,6004,10,100,0.001,0.01,0.864,0.9610259826782145,2966,3038
19,6104,10,100,0.001,0.01,0.822,0.9621559633027523,3016,3088
19,6204,10,100,0.001,0.01,0.838,0.9563185041908446,3070,3134
19,6304,10,100,0.001,0.01,0.836,0.9576459390862944,3122,3182
19,6404,10,100,0.001,0.01,0.824,0.9409743910056215,3172,3232
19,6504,10,100,0.001,0.01,0.852,0.9540282902829028,3222,3282
19,6604,10,100,0.001,0.01,0.838,0.9651726226529376,3265,3339
19,6704,10,100,0.001,0.01,0.862,0.9744928400954654,3322,3382
19,6804,10,100,0.001,0.01,0.864,0.9748677248677249,3372,3432
19,6904,10,100,0.001,0.01,0.866,0.9737833140208575,3425,3479
19,7004,10,100,0.001,0.01,0.85,0.9767275842375785,3476,3528
19,7104,10,100,0.001,0.01,0.852,0.9666385135135135,3538,3566
19,7204,10,100,0.001,0.01,0.842,0.9729317046085508,3589,3615
19,7304,10,100,0.001,0.01,0.87,0.9548192771084337,3642,3662
19,7404,10,100,0.001,0.01,0.876,0.9643435980551054,3696,3708
19,7504,10,100,0.001,0.01,0.88,0.9733475479744137,3740,3764
19,7604,10,100,0.001,0.01,0.85,0.9696212519726459,3787,3817
19,7704,10,100,0.001,0.01,0.866,0.9839044652128764,3843,3861
19,7804,10,100,0.001,0.01,0.886,0.9828293182983086,3897,3907
19,7904,10,100,0.001,0.01,0.866,0.9194078947368421,3957,3947
19,8004,10,100,0.001,0.01,0.86,0.946776611694153,4010,3994
19,8104,10,100,0.001,0.01,0.9,0.9787759131293189,4064,4040
19,8204,10,100,0.001,0.01,0.89,0.969892735251097,4120,4084
19,8304,10,100,0.001,0.01,0.9,0.9869942196531792,4172,4132
19,8404,10,100,0.001,0.01,0.876,0.9574012375059495,4219,4185
19,8504,10,100,0.001,0.01,0.892,0.9873000940733773,4278,4226
19,8604,10,100,0.001,0.01,0.89,0.9843096234309623,4325,4279
19,8704,10,100,0.001,0.01,0.89,0.98046875,4376,4328
19,8804,10,100,0.001,0.01,0.89,0.9792139936392549,4418,4386
19,8904,10,100,0.001,0.01,0.892,0.9788858939802336,4460,4444
19,9004,10,100,0.001,0.01,0.882,0.9655708573967126,4518,4486
19,9104,10,100,0.001,0.01,0.896,0.9708919156414763,4565,4539
19,9204,10,100,0.001,0.01,0.906,0.9857670578009561,4616,4588
19,9304,10,100,0.001,0.01,0.916,0.9917239896818573,4663,4641
19,9404,10,100,0.001,0.01,0.91,0.9908549553381539,4710,4694
19,9504,10,100,0.001,0.01,0.902,0.9883207070707071,4767,4737
19,9604,10,100,0.001,0.01,0.904,0.9838608912952936,4817,4787
19,9704,10,100,0.001,0.01,0.906,0.983924154987634,4865,4839
19,9804,10,100,0.001,0.01,0.9,0.972562219502244,4911,4893
19,9904,10,100,0.001,0.01,0.902,0.9856623586429726,4951,4953
19,10004,10,100,0.001,0.01,0.92,0.9852059176329468,5005,4999
19,10104,10,100,0.001,0.01,0.928,0.9835708630245448,5048,5056
19,10204,10,100,0.001,0.01,0.94,0.9871618972951783,5093,5111
19,10304,10,100,0.001,0.01,0.942,0.9945652173913043,5144,5160
19,10404,10,100,0.001,0.01,0.92,0.9853902345251826,5195,5209
19,10504,10,100,0.001,0.01,0.926,0.9863861386138614,5249,5255
19,10604,10,100,0.001,0.01,0.918,0.986797434930215,5300,5304
19,10704,10,100,0.001,0.01,0.928,0.9854260089686099,5343,5361
19,10804,10,100,0.001,0.01,0.93,0.9922251018141429,5388,5416
19,10904,10,100,0.001,0.01,0.904,0.9610234776228906,5445,5459
19,11004,10,100,0.001,0.01,0.914,0.9799163940385315,5500,5504
19,11104,10,100,0.001,0.01,0.928,0.990363832853026,5547,5557
19,11204,10,100,0.001,0.01,0.936,0.9937522313459479,5589,5615
19,11304,10,100,0.001,0.01,0.938,0.997523000707714,5641,5663
19,11404,10,100,0.001,0.01,0.926,0.9930726061031218,5694,5710
19,11504,10,100,0.001,0.01,0.928,0.9938282336578581,5744,5760
19,11604,10,100,0.001,0.01,0.938,0.9899172699069286,5797,5807
19,11704,10,100,0.001,0.01,0.948,0.9941045796308954,5847,5857
19,11804,10,100,0.001,0.01,0.916,0.9622161978990172,5899,5905
19,11904,10,100,0.001,0.01,0.932,0.9789986559139785,5946,5958
19,12004,10,100,0.001,0.01,0.934,0.990753082305898,6004,6000
19,12104,10,100,0.001,0.01,0.952,0.9948777263714474,6042,6062
19,12204,10,100,0.001,0.01,0.948,0.9964765650606359,6093,6111
19,12304,10,100,0.001,0.01,0.958,0.9993498049414824,6132,6172
19,12404,10,100,0.001,0.01,0.954,0.9987100935182199,6185,6219
19,12504,10,100,0.001,0.01,0.958,0.9992002559181062,6234,6270
19,12604,10,100,0.001,0.01,0.946,0.9979371628054586,6286,6318
19,12704,10,100,0.001,0.01,0.946,0.9955919395465995,6333,6371
19,12804,10,100,0.001,0.01,0.926,0.9669634489222118,6384,6420
19,12904,10,100,0.001,0.01,0.934,0.9760539367637941,6429,6475
19,13004,10,100,0.001,0.01,0.916,0.9494770839741618,6476,6528
19,13104,10,100,0.001,0.01,0.95,0.9819139194139194,6523,6581
19,13204,10,100,0.001,0.01,0.956,0.9914419872765828,6573,6631
19,13304,10,100,0.001,0.01,0.976,0.9980457005411906,6626,6678
19,13404,10,100,0.001,0.01,0.98,0.9986571172784243,6669,6735
19,13504,10,100,0.001,0.01,0.968,0.998593009478673,6717,6787
19,13604,10,100,0.001,0.01,0.978,0.9994119376653925,6767,6837
19,13704,10,100,0.001,0.01,0.98,0.9997810858143608,6821,6883
19,13804,10,100,0.001,0.01,0.978,0.9997102289191538,6882,6922
19,13904,10,100,0.001,0.01,0.97,0.9987773302646721,6932,6972
19,14004,10,100,0.001,0.01,0.966,0.9921451013996001,6981,7023
19,14104,10,100,0.001,0.01,0.956,0.9853233125354509,7031,7073
19,14204,10,100,0.001,0.01,0.97,0.9900732188116024,7079,7125
19,14304,10,100,0.001,0.01,0.974,0.9880453020134228,7126,7178
19,14404,10,100,0.001,0.01,0.976,0.9964593168564287,7175,7229
19,14504,10,100,0.001,0.01,0.98,0.9995173745173745,7228,7276
19,14604,10,100,0.001,0.01,0.98,0.9961654341276363,7281,7323
19,14704,10,100,0.001,0.01,0.98,0.9967355821545157,7336,7368
19,14804,10,100,0.001,0.01,0.98,0.9958119427181843,7390,7414
19,14904,10,100,0.001,0.01,0.984,0.9950348899624262,7437,7467
19,15004,10,100,0.001,0.01,0.978,0.9973340442548654,7491,7513
20,104,10,100,0.001,0.01,0.482,0.625,49,55
20,204,10,100,0.001,0.01,0.51,0.5931372549019608,93,111
20,304,10,100,0.001,0.01,0.472,0.6546052631578947,134,170
20,404,10,100,0.001,0.01,0.482,0.6410891089108911,178,226
20,504,10,100,0.001,0.01,0.526,0.6111111111111112,227,277
20,604,10,100,0.001,0.01,0.528,0.652317880794702,271,333
20,704,10,100,0.001,0.01,0.528,0.6335227272727273,319,385
20,804,10,100,0.001,0.01,0.518,0.6281094527363185,362,442
20,904,10,100,0.001,0.01,0.518,0.6526548672566371,413,491
20,1004,10,100,0.001,0.01,0.542,0.6752988047808764,465,539
20,1104,10,100,0.001,0.01,0.564,0.6530797101449275,516,588
20,1204,10,100,0.001,0.01,0.522,0.670265780730897,565,639
20,1304,10,100,0.001,0.01,0.52,0.6771472392638037,618,686
20,1404,10,100,0.001,0.01,0.552,0.7008547008547008,660,744
20,1504,10,100,0.001,0.01,0.562,0.714095744680851,707,797
20,1604,10,100,0.001,0.01,0.58,0.7325436408977556,754,850
20,1704,10,100,0.001,0.01,0.562,0.744131455399061,812,892
20,1804,10,100,0.001,0.01,0.568,0.7317073170731707,860,944
20,1904,10,100,0.001,0.01,0.584,0.7447478991596639,907,997
20,2004,10,100,0.001,0.01,0.624,0.7784431137724551,956,1048
20,2104,10,100,0.001,0.01,0.592,0.7699619771863118,1002,1102
20,2204,10,100,0.001,0.01,0.656,0.8053539019963702,1050,1154
20,2304,10,100,0.001,0.01,0.608,0.8133680555555556,1093,1211
20,2404,10,100,0.001,0.01,0.662,0.8344425956738769,1140,1264
20,2504,10,100,0.001,0.01,0.624,0.8091054313099042,1186,1318
20,2604,10,100,0.001,0.01,0.69,0.8544546850998463,1243,1361
20,2704,10,100,0.001,0.01,0.66,0.8616863905325444,1293,1411
20,2804,10,100,0.001,0.01,0.688,0.8598430813124108,1351,1453
20,2904,10,100,0.001,0.01,0.68,0.8694903581267218,1399,1505
20,3004,10,100,0.001,0.01,0.728,0.8964713715046605,1443,1561
20,3104,10,100,0.001,0.01,0.708,0.9097938144329897,1492,1612
20,3204,10,100,0.001,0.01,0.73,0.9060549313358303,1549,1655
20,3304,10,100,0.001,0.01,0.736,0.8958837772397095,1598,1706
20,3404,10,100,0.001,0.01,0.726,0.9145123384253819,1649,1755
20,3504,10,100,0.001,0.01,0.732,0.903824200913242,1704,1800
20,3604,10,100,0.001,0.01,0.714,0.8926193118756937,1758,1846
20,3704,10,100,0.001,0.01,0.716,0.9165766738660908,1819,1885
20,3804,10,100,0.001,0.01,0.748,0.9135120925341745,1875,1929
20,3904,10,100,0.001,0.01,0.746,0.9057377049180327,1922,1982
20,4004,10,100,0.001,0.01,0.776,0.9273226773226774,1969,2035
20,4104,10,100,0.001,0.01,0.788,0.945906432748538,2009,2095
20,4204,10,100,0.001,0.01,0.794,0.9605137963843958,2068,2136
20,4304,10,100,0.001,0.01,0.814,0.9426115241635687,2114,2190
20,4404,10,100,0.001,0.01,0.792,0.9386920980926431,2165,2239
20,4504,10,100,0.001,0.01,0.78,0.9080817051509769,2214,2290
20,4604,10,100,0.001,0.01,0.81,0.9506950477845352,2266,2338
20,4704,10,100,0.001,0.01,0.842,0.9651360544217688,2324,2380
20,4804,10,100,0.001,0.01,0.808,0.9546211490424646,2373,2431
20,4904,10,100,0.001,0.01,0.848,0.9743066884176182,2421,2483
20,5004,10,100,0.001,0.01,0.864,0.9728217426059153,2474,2530
20,5104,10,100,0.001,0.01,0.856,0.9829545454545454,2520,2584
20,5204,10,100,0.001,0.01,0.826,0.9488854727132975,2576,2628
20,5304,10,100,0.001,0.01,0.856,0.9274132730015083,2629,2675
20,5404,10,100,0.001,0.01,0.854,0.9324574389341229,2684,2720
20,5504,10,100,0.001,0.01,0.862,0.9434956395348837,2735,2769
20,5604,10,100,0.001,0.01,0.882,0.9627052105638829,2781,2823
20,5704,10,100,0.001,0.01,0.856,0.9254908835904628,2828,2876
20,5804,10,100,0.001,0.01,0.884,0.9739834596829773,2874,2930
20,5904,10,100,0.001,0.01,0.894,0.9757791327913279,2926,2978
20,6004,10,100,0.001,0.01,0.902,0.9760159893404398,2972,3032
20,6104,10,100,0.001,0.01,0.892,0.9721494102228048,3021,3083
20,6204,10,100,0.001,0.01,0.914,0.9874274661508704,3071,3133
20,6304,10,100,0.001,0.01,0.924,0.9890545685279187,3125,3179
20,6404,10,100,0.001,0.01,0.914,0.9850093691442848,3174,3230
20,6504,10,100,0.001,0.01,0.92,0.9860086100861009,3224,3280
20,6604,10,100,0.001,0.01,0.918,0.9875832828588734,3281,3323
20,6704,10,100,0.001,0.01,0.92,0.9859785202863962,3337,3367
20,6804,10,100,0.001,0.01,0.902,0.9828042328042328,3391,3413
20,6904,10,100,0.001,0.01,0.922,0.9901506373117034,3439,3465
20,7004,10,100,0.001,0.01,0.914,0.9854368932038835,3483,3521
20,7104,10,100,0.001,0.01,0.926,0.9905686936936937,3537,3567
20,7204,10,100,0.001,0.01,0.912,0.9893114936146585,3593,3611
20,7304,10,100,0.001,0.01,0.912,0.9900054764512596,3646,3658
20,7404,10,100,0.001,0.01,0.9,0.9694759589411129,3694,3710
20,7504,10,100,0.001,0.01,0.924,0.9845415778251599,3743,3761
20,7604,10,100,0.001,0.01,0.912,0.9848763808521831,3791,3813
20,7704,10,100,0.001,0.01,0.936,0.9953271028037384,3842,3862
20,7804,10,100,0.001,0.01,0.938,0.9898769861609431,3894,3910
20,7904,10,100,0.001,0.01,0.926,0.9877277327935222,3942,3962
20,8004,10,100,0.001,0.01,0.932,0.9922538730634682,3997,4007
20,8104,10,100,0.001,0.01,0.948,0.9933366238894373,4049,4055
20,8204,10,100,0.001,0.01,0.952,0.9965870307167235,4105,4099
20,8304,10,100,0.001,0.01,0.948,0.996266859344894,4157,4147
20,8404,10,100,0.001,0.01,0.924,0.9807234650166587,4204,4200
20,8504,10,100,0.001,0.01,0.928,0.9703668861712136,4250,4254
20,8604,10,100,0.001,0.01,0.948,0.9800092980009298,4296,4308
20,8704,10,100,0.001,0.01,0.94,0.9761029411764706,4350,4354
20,8804,10,100,0.001,0.01,0.96,0.9872785097682871,4395,4409
20,8904,10,100,0.001,0.01,0.96,0.9913522012578616,4452,4452
20,9004,10,100,0.001,0.01,0.966,0.9937805419813416,4503,4501
20,9104,10,100,0.001,0.01,0.962,0.9953866432337434,4552,4552
20,9204,10,100,0.001,0.01,0.958,0.9978270317253368,4606,4598
20,9304,10,100,0.001,0.01,0.958,0.9983877901977644,4656,4648
20,9404,10,100,0.001,0.01,0.964,0.9980859208847299,4701,4703
20,9504,10,100,0.001,0.01,0.956,0.9963173400673401,4754,4750
20,9604,10,100,0.001,0.01,0.95,0.9808413161182841,4799,4805
20,9704,10,100,0.001,0.01,0.942,0.9857790601813685,4851,4853
20,9804,10,100,0.001,0.01,0.952,0.9885760913912689,4902,4902
20,9904,10,100,0.001,0.01,0.972,0.9886914378029079,4953,4951
20,10004,10,100,0.001,0.01,0.96,0.9933026789284286,4996,5008
20,10104,10,100,0.001,0.01,0.956,0.9904988123515439,5046,5058
20,10204,10,100,0.001,0.01,0.97,0.9887299098392787,5097,5107
20,10304,10,100,0.001,0.01,0.944,0.9895186335403726,5148,5156
20,10404,10,100,0.001,0.01,0.962,0.9952902729719338,5191,5213
20,10504,10,100,0.001,0.01,0.968,0.9977151561309977,5248,5256
20,10604,10,100,0.001,0.01,0.97,0.997736703130894,5292,5312
20,10704,10,100,0.001,0.01,0.974,0.9961696562032885,5342,5362
20,10804,10,100,0.001,0.01,0.972,0.9950018511662347,5393,5411
20,10904,10,100,0.001,0.01,0.972,0.9989911958914159,5434,5470
20,11004,10,100,0.001,0.01,0.964,0.9934569247546347,5481,5523
20,11104,10,100,0.001,0.01,0.966,0.988742795389049,5523,5581
20,11204,10,100,0.001,0.01,0.958,0.9851838629061049,5572,5632
20,11304,10,100,0.001,0.01,0.94,0.9840764331210191,5621,5683
20,11404,10,100,0.001,0.01,0.952,0.9903542616625746,5662,5742
20,11504,10,100,0.001,0.01,0.962,0.9967837273991655,5714,5790
20,11604,10,100,0.001,0.01,0.974,0.9981902792140641,5767,5837
20,11704,10,100,0.001,0.01,0.976,0.9991455912508544,5814,5890
20,11804,10,100,0.001,0.01,0.978,0.9976279227380549,5861,5943
20,11904,10,100,0.001,0.01,0.964,0.9835349462365591,5911,5993
20,12004,10,100,0.001,0.01,0.962,0.98892035988004,5959,6045
20,12104,10,100,0.001,0.01,0.972,0.9951255783212162,6011,6093
20,12204,10,100,0.001,0.01,0.966,0.9963126843657817,6059,6145
20,12304,10,100,0.001,0.01,0.978,0.9965864759427828,6117,6187
20,12404,10,100,0.001,0.01,0.978,0.9960496613995485,6166,6238
20,12504,10,100,0.001,0.01,0.968,0.9845649392194498,6221,6283
20,12604,10,100,0.001,0.01,0.964,0.9919073310060298,6270,6334
20,12704,10,100,0.001,0.01,0.968,0.9960642317380353,6321,6383
20,12804,10,100,0.001,0.01,0.974,0.9979693845673228,6369,6435
20,12904,10,100,0.001,0.01,0.976,0.9865933044017359,6418,6486
20,13004,10,100,0.001,0.01,0.98,0.9936942479237157,6474,6530
20,13104,10,100,0.001,0.01,0.982,0.9977106227106227,6518,6586
20,13204,10,100,0.001,0.01,0.98,0.9995455922447744,6567,6637
20,13304,10,100,0.001,0.01,0.984,0.9997745039085989,6620,6684
20,13404,10,100,0.001,0.01,0.982,1.0,6673,6731
20,13504,10,100,0.001,0.01,0.984,0.9991854265402843,6733,6771
20,13604,10,100,0.001,0.01,0.984,0.9986768597471332,6785,6819
20,13704,10,100,0.001,0.01,0.982,0.9991973146526562,6837,6867
20,13804,10,100,0.001,0.01,0.976,0.9951463343958273,6884,6920
20,13904,10,100,0.001,0.01,0.98,0.9933831990794016,6939,6965
20,14004,10,100,0.001,0.01,0.972,0.9791488146243931,6989,7015
20,14104,10,100,0.001,0.01,0.976,0.9958876914350538,7041,7063
20,14204,10,100,0.001,0.01,0.986,0.9960574486060265,7091,7113
20,14304,10,100,0.001,0.01,0.98,0.998182326621924,7145,7159
20,14404,10,100,0.001,0.01,0.99,0.9990280477645098,7199,7205
20,14504,10,100,0.001,0.01,0.986,0.9973800330943188,7254,7250
20,14604,10,100,0.001,0.01,0.986,0.9971240755957272,7309,7295
20,14704,10,100,0.001,0.01,0.984,0.9967355821545157,7358,7346
20,14804,10,100,0.001,0.01,0.972,0.9894623074844636,7410,7394
20,14904,10,100,0.001,0.01,0.99,0.9957058507783145,7462,7442
20,15004,10,100,0.001,0.01,0.978,0.9970007997867235,7510,7494
