trial,train_size,embed_dim,hidden_dim,alpha,learning_rate,accuracy,train_accuracy,batch_pos,batch_neg
1,104,10,100,1e-05,0.01,0.522,0.5673076923076923,59,45
1,204,10,100,1e-05,0.01,0.474,0.5882352941176471,100,104
1,304,10,100,1e-05,0.01,0.484,0.7039473684210527,148,156
1,404,10,100,1e-05,0.01,0.484,0.6262376237623762,189,215
1,504,10,100,1e-05,0.01,0.478,0.7123015873015873,240,264
1,604,10,100,1e-05,0.01,0.47,0.6341059602649006,296,308
1,704,10,100,1e-05,0.01,0.48,0.6960227272727273,340,364
1,804,10,100,1e-05,0.01,0.472,0.722636815920398,391,413
1,904,10,100,1e-05,0.01,0.48,0.6758849557522124,440,464
1,1004,10,100,1e-05,0.01,0.476,0.7171314741035857,489,515
1,1104,10,100,1e-05,0.01,0.486,0.7273550724637681,538,566
1,1204,10,100,1e-05,0.01,0.446,0.7308970099667774,589,615
1,1304,10,100,1e-05,0.01,0.482,0.7400306748466258,649,655
1,1404,10,100,1e-05,0.01,0.462,0.7535612535612536,702,702
1,1504,10,100,1e-05,0.01,0.476,0.7539893617021277,754,750
1,1604,10,100,1e-05,0.01,0.474,0.7680798004987531,805,799
1,1704,10,100,1e-05,0.01,0.46,0.7353286384976526,859,845
1,1804,10,100,1e-05,0.01,0.464,0.7610864745011087,911,893
1,1904,10,100,1e-05,0.01,0.486,0.7657563025210085,963,941
1,2004,10,100,1e-05,0.01,0.494,0.7914171656686627,1010,994
1,2104,10,100,1e-05,0.01,0.528,0.7937262357414449,1060,1044
1,2204,10,100,1e-05,0.01,0.544,0.8207803992740472,1115,1089
1,2304,10,100,1e-05,0.01,0.528,0.8502604166666666,1159,1145
1,2404,10,100,1e-05,0.01,0.596,0.8810316139767055,1216,1188
1,2504,10,100,1e-05,0.01,0.602,0.8981629392971247,1269,1235
1,2604,10,100,1e-05,0.01,0.584,0.8932411674347158,1317,1287
1,2704,10,100,1e-05,0.01,0.64,0.9001479289940828,1358,1346
1,2804,10,100,1e-05,0.01,0.64,0.9026390870185449,1406,1398
1,2904,10,100,1e-05,0.01,0.652,0.8863636363636364,1453,1451
1,3004,10,100,1e-05,0.01,0.672,0.9137816245006658,1498,1506
1,3104,10,100,1e-05,0.01,0.668,0.939110824742268,1556,1548
1,3204,10,100,1e-05,0.01,0.686,0.9388264669163545,1606,1598
1,3304,10,100,1e-05,0.01,0.678,0.9346246973365617,1652,1652
1,3404,10,100,1e-05,0.01,0.692,0.9256756756756757,1697,1707
1,3504,10,100,1e-05,0.01,0.694,0.9218036529680366,1745,1759
1,3604,10,100,1e-05,0.01,0.724,0.9284128745837957,1797,1807
1,3704,10,100,1e-05,0.01,0.692,0.9071274298056156,1845,1859
1,3804,10,100,1e-05,0.01,0.738,0.9242902208201893,1886,1918
1,3904,10,100,1e-05,0.01,0.742,0.9239241803278688,1936,1968
1,4004,10,100,1e-05,0.01,0.744,0.9253246753246753,1989,2015
1,4104,10,100,1e-05,0.01,0.75,0.9259259259259259,2043,2061
1,4204,10,100,1e-05,0.01,0.75,0.9391056137012369,2101,2103
1,4304,10,100,1e-05,0.01,0.766,0.9284386617100372,2145,2159
1,4404,10,100,1e-05,0.01,0.742,0.9207538601271571,2199,2205
1,4504,10,100,1e-05,0.01,0.79,0.9382770870337478,2242,2262
1,4604,10,100,1e-05,0.01,0.76,0.9459165942658557,2295,2309
1,4704,10,100,1e-05,0.01,0.798,0.9576955782312925,2355,2349
1,4804,10,100,1e-05,0.01,0.8,0.9616985845129059,2407,2397
1,4904,10,100,1e-05,0.01,0.818,0.9563621533442088,2453,2451
1,5004,10,100,1e-05,0.01,0.794,0.9666266986410871,2496,2508
1,5104,10,100,1e-05,0.01,0.826,0.9747257053291536,2532,2572
1,5204,10,100,1e-05,0.01,0.82,0.9654112221368178,2585,2619
1,5304,10,100,1e-05,0.01,0.816,0.9577677224736049,2637,2667
1,5404,10,100,1e-05,0.01,0.796,0.945780903034789,2691,2713
1,5504,10,100,1e-05,0.01,0.802,0.9473110465116279,2736,2768
1,5604,10,100,1e-05,0.01,0.79,0.9566381156316917,2789,2815
1,5704,10,100,1e-05,0.01,0.8,0.9540673211781207,2838,2866
1,5804,10,100,1e-05,0.01,0.802,0.9591660923501034,2885,2919
1,5904,10,100,1e-05,0.01,0.792,0.9278455284552846,2933,2971
1,6004,10,100,1e-05,0.01,0.82,0.9392071952031978,2990,3014
1,6104,10,100,1e-05,0.01,0.822,0.9619921363040629,3043,3061
1,6204,10,100,1e-05,0.01,0.83,0.9626047711154094,3096,3108
1,6304,10,100,1e-05,0.01,0.812,0.970019035532995,3145,3159
1,6404,10,100,1e-05,0.01,0.834,0.9704871955028107,3195,3209
1,6504,10,100,1e-05,0.01,0.84,0.9784747847478474,3256,3248
1,6604,10,100,1e-05,0.01,0.83,0.9678982434887947,3313,3291
1,6704,10,100,1e-05,0.01,0.846,0.9743436754176611,3361,3343
1,6804,10,100,1e-05,0.01,0.832,0.963697824808936,3406,3398
1,6904,10,100,1e-05,0.01,0.832,0.97045191193511,3456,3448
1,7004,10,100,1e-05,0.01,0.81,0.951741861793261,3505,3499
1,7104,10,100,1e-05,0.01,0.806,0.9380630630630631,3551,3553
1,7204,10,100,1e-05,0.01,0.82,0.9410049972237646,3596,3608
1,7304,10,100,1e-05,0.01,0.834,0.9652245345016429,3639,3665
1,7404,10,100,1e-05,0.01,0.82,0.972312263641275,3693,3711
1,7504,10,100,1e-05,0.01,0.836,0.9761460554371002,3751,3753
1,7604,10,100,1e-05,0.01,0.836,0.974092582851131,3805,3799
1,7704,10,100,1e-05,0.01,0.848,0.9754672897196262,3856,3848
1,7804,10,100,1e-05,0.01,0.832,0.9743721168631471,3908,3896
1,7904,10,100,1e-05,0.01,0.828,0.9710273279352226,3954,3950
1,8004,10,100,1e-05,0.01,0.846,0.9683908045977011,4006,3998
1,8104,10,100,1e-05,0.01,0.852,0.9726061204343535,4057,4047
1,8204,10,100,1e-05,0.01,0.842,0.977328132618235,4109,4095
1,8304,10,100,1e-05,0.01,0.842,0.9783236994219653,4155,4149
1,8404,10,100,1e-05,0.01,0.856,0.9704902427415516,4196,4208
1,8504,10,100,1e-05,0.01,0.842,0.9751881467544685,4238,4266
1,8604,10,100,1e-05,0.01,0.822,0.9437470943747094,4290,4314
1,8704,10,100,1e-05,0.01,0.848,0.9293428308823529,4346,4358
1,8804,10,100,1e-05,0.01,0.856,0.9599045888232621,4391,4413
1,8904,10,100,1e-05,0.01,0.838,0.9620395327942498,4447,4457
1,9004,10,100,1e-05,0.01,0.846,0.9719013771657041,4494,4510
1,9104,10,100,1e-05,0.01,0.86,0.9716608084358523,4544,4560
1,9204,10,100,1e-05,0.01,0.844,0.9652325076053889,4591,4613
1,9304,10,100,1e-05,0.01,0.846,0.9483018056749785,4647,4657
1,9404,10,100,1e-05,0.01,0.86,0.9603360272224585,4706,4698
1,9504,10,100,1e-05,0.01,0.874,0.9691708754208754,4743,4761
1,9604,10,100,1e-05,0.01,0.858,0.9682423990004165,4794,4810
1,9704,10,100,1e-05,0.01,0.85,0.9584707337180544,4845,4859
1,9804,10,100,1e-05,0.01,0.838,0.9606283149734802,4894,4910
1,9904,10,100,1e-05,0.01,0.846,0.970718901453958,4946,4958
1,10004,10,100,1e-05,0.01,0.868,0.9724110355857657,4999,5005
1,10104,10,100,1e-05,0.01,0.866,0.9804038004750594,5049,5055
1,10204,10,100,1e-05,0.01,0.874,0.9775578204625637,5095,5109
1,10304,10,100,1e-05,0.01,0.858,0.9767080745341615,5141,5163
1,10404,10,100,1e-05,0.01,0.852,0.9740484429065744,5193,5211
1,10504,10,100,1e-05,0.01,0.858,0.9724866717440975,5244,5260
1,10604,10,100,1e-05,0.01,0.848,0.9504903809883063,5291,5313
1,10704,10,100,1e-05,0.01,0.858,0.9737481315396114,5343,5361
1,10804,10,100,1e-05,0.01,0.854,0.9773232136245835,5386,5418
1,10904,10,100,1e-05,0.01,0.858,0.9735876742479824,5446,5458
1,11004,10,100,1e-05,0.01,0.828,0.9518356961105052,5496,5508
1,11104,10,100,1e-05,0.01,0.84,0.9347982708933718,5544,5560
1,11204,10,100,1e-05,0.01,0.846,0.9556408425562299,5596,5608
1,11304,10,100,1e-05,0.01,0.86,0.9680644019815995,5643,5661
1,11404,10,100,1e-05,0.01,0.862,0.9765871623991582,5702,5702
1,11504,10,100,1e-05,0.01,0.854,0.972183588317107,5757,5747
1,11604,10,100,1e-05,0.01,0.866,0.9675973802137194,5812,5792
1,11704,10,100,1e-05,0.01,0.864,0.9768455228981545,5870,5834
1,11804,10,100,1e-05,0.01,0.882,0.9774652660115215,5910,5894
1,11904,10,100,1e-05,0.01,0.874,0.9745463709677419,5963,5941
1,12004,10,100,1e-05,0.01,0.87,0.9775074975008331,6024,5980
1,12104,10,100,1e-05,0.01,0.862,0.981163251817581,6072,6032
1,12204,10,100,1e-05,0.01,0.866,0.9778761061946902,6114,6090
1,12304,10,100,1e-05,0.01,0.87,0.9752113133940182,6158,6146
1,12404,10,100,1e-05,0.01,0.866,0.9717832957110609,6207,6197
1,12504,10,100,1e-05,0.01,0.872,0.9788867562380038,6264,6240
1,12604,10,100,1e-05,0.01,0.872,0.981196445572834,6315,6289
1,12704,10,100,1e-05,0.01,0.868,0.9778022670025189,6365,6339
1,12804,10,100,1e-05,0.01,0.864,0.9724304904717276,6412,6392
1,12904,10,100,1e-05,0.01,0.892,0.9809361438313701,6470,6434
1,13004,10,100,1e-05,0.01,0.892,0.9807751461088896,6510,6494
1,13104,10,100,1e-05,0.01,0.872,0.9791666666666666,6560,6544
1,13204,10,100,1e-05,0.01,0.878,0.976598000605877,6613,6591
1,13304,10,100,1e-05,0.01,0.888,0.9782020444978954,6663,6641
1,13404,10,100,1e-05,0.01,0.872,0.9805282005371531,6706,6698
1,13504,10,100,1e-05,0.01,0.892,0.9780805687203792,6752,6752
1,13604,10,100,1e-05,0.01,0.886,0.9770655689503087,6804,6800
1,13704,10,100,1e-05,0.01,0.886,0.9699357851722125,6860,6844
1,13804,10,100,1e-05,0.01,0.886,0.9781222833961171,6910,6894
1,13904,10,100,1e-05,0.01,0.884,0.9816599539700805,6963,6941
1,14004,10,100,1e-05,0.01,0.882,0.9798628963153385,7011,6993
1,14104,10,100,1e-05,0.01,0.884,0.9859614293817357,7050,7054
1,14204,10,100,1e-05,0.01,0.874,0.9801464376232047,7098,7106
1,14304,10,100,1e-05,0.01,0.884,0.9628076062639821,7148,7156
1,14404,10,100,1e-05,0.01,0.88,0.9593862815884476,7201,7203
1,14504,10,100,1e-05,0.01,0.878,0.9618725868725869,7244,7260
1,14604,10,100,1e-05,0.01,0.886,0.9746644754861682,7288,7316
1,14704,10,100,1e-05,0.01,0.898,0.982929815016322,7332,7372
1,14804,10,100,1e-05,0.01,0.898,0.973250472845177,7378,7426
1,14904,10,100,1e-05,0.01,0.9,0.9830917874396136,7436,7468
1,15004,10,100,1e-05,0.01,0.888,0.9766062383364437,7491,7513
2,104,10,100,1e-05,0.01,0.504,0.6634615384615384,55,49
2,204,10,100,1e-05,0.01,0.504,0.6274509803921569,105,99
2,304,10,100,1e-05,0.01,0.546,0.6217105263157895,157,147
2,404,10,100,1e-05,0.01,0.572,0.594059405940594,209,195
2,504,10,100,1e-05,0.01,0.528,0.6309523809523809,260,244
2,604,10,100,1e-05,0.01,0.52,0.609271523178808,309,295
2,704,10,100,1e-05,0.01,0.476,0.6363636363636364,351,353
2,804,10,100,1e-05,0.01,0.472,0.650497512437811,398,406
2,904,10,100,1e-05,0.01,0.482,0.6493362831858407,452,452
2,1004,10,100,1e-05,0.01,0.454,0.6613545816733067,497,507
2,1104,10,100,1e-05,0.01,0.504,0.667572463768116,548,556
2,1204,10,100,1e-05,0.01,0.492,0.7142857142857143,594,610
2,1304,10,100,1e-05,0.01,0.486,0.7170245398773006,647,657
2,1404,10,100,1e-05,0.01,0.494,0.7293447293447294,692,712
2,1504,10,100,1e-05,0.01,0.502,0.7107712765957447,731,773
2,1604,10,100,1e-05,0.01,0.51,0.770573566084788,784,820
2,1704,10,100,1e-05,0.01,0.508,0.7406103286384976,831,873
2,1804,10,100,1e-05,0.01,0.526,0.7599778270509978,878,926
2,1904,10,100,1e-05,0.01,0.488,0.7337184873949579,931,973
2,2004,10,100,1e-05,0.01,0.54,0.7884231536926147,976,1028
2,2104,10,100,1e-05,0.01,0.526,0.7913498098859315,1030,1074
2,2204,10,100,1e-05,0.01,0.532,0.8044464609800362,1081,1123
2,2304,10,100,1e-05,0.01,0.514,0.7951388888888888,1133,1171
2,2404,10,100,1e-05,0.01,0.552,0.8169717138103162,1190,1214
2,2504,10,100,1e-05,0.01,0.562,0.8003194888178914,1233,1271
2,2604,10,100,1e-05,0.01,0.564,0.8360215053763441,1277,1327
2,2704,10,100,1e-05,0.01,0.62,0.878698224852071,1317,1387
2,2804,10,100,1e-05,0.01,0.604,0.8637660485021398,1362,1442
2,2904,10,100,1e-05,0.01,0.592,0.8112947658402204,1399,1505
2,3004,10,100,1e-05,0.01,0.582,0.7869507323568575,1442,1562
2,3104,10,100,1e-05,0.01,0.678,0.8920747422680413,1496,1608
2,3204,10,100,1e-05,0.01,0.696,0.9188514357053683,1551,1653
2,3304,10,100,1e-05,0.01,0.702,0.9306900726392252,1601,1703
2,3404,10,100,1e-05,0.01,0.718,0.9444770857814336,1651,1753
2,3504,10,100,1e-05,0.01,0.74,0.9529109589041096,1697,1807
2,3604,10,100,1e-05,0.01,0.75,0.9633740288568258,1761,1843
2,3704,10,100,1e-05,0.01,0.77,0.972732181425486,1808,1896
2,3804,10,100,1e-05,0.01,0.762,0.9621451104100947,1860,1944
2,3904,10,100,1e-05,0.01,0.766,0.9626024590163934,1907,1997
2,4004,10,100,1e-05,0.01,0.778,0.9545454545454546,1956,2048
2,4104,10,100,1e-05,0.01,0.776,0.9573586744639376,2008,2096
2,4204,10,100,1e-05,0.01,0.812,0.9624167459562322,2054,2150
2,4304,10,100,1e-05,0.01,0.81,0.9670074349442379,2105,2199
2,4404,10,100,1e-05,0.01,0.836,0.9725249772933696,2153,2251
2,4504,10,100,1e-05,0.01,0.838,0.9766873889875666,2202,2302
2,4604,10,100,1e-05,0.01,0.85,0.9780625543006082,2235,2369
2,4704,10,100,1e-05,0.01,0.812,0.9402636054421769,2282,2422
2,4804,10,100,1e-05,0.01,0.838,0.9633638634471274,2318,2486
2,4904,10,100,1e-05,0.01,0.842,0.9694127243066885,2368,2536
2,5004,10,100,1e-05,0.01,0.83,0.9520383693045563,2426,2578
2,5104,10,100,1e-05,0.01,0.846,0.9312304075235109,2476,2628
2,5204,10,100,1e-05,0.01,0.874,0.9556110684089162,2530,2674
2,5304,10,100,1e-05,0.01,0.884,0.9609728506787331,2574,2730
2,5404,10,100,1e-05,0.01,0.888,0.9774241302738712,2618,2786
2,5504,10,100,1e-05,0.01,0.882,0.9820130813953488,2655,2849
2,5604,10,100,1e-05,0.01,0.898,0.9828693790149893,2710,2894
2,5704,10,100,1e-05,0.01,0.88,0.9870266479663394,2761,2943
2,5804,10,100,1e-05,0.01,0.888,0.9843211578221915,2815,2989
2,5904,10,100,1e-05,0.01,0.902,0.9815379403794038,2861,3043
2,6004,10,100,1e-05,0.01,0.918,0.9891738840772818,2906,3098
2,6104,10,100,1e-05,0.01,0.902,0.9847640891218873,2961,3143
2,6204,10,100,1e-05,0.01,0.912,0.9811411992263056,3017,3187
2,6304,10,100,1e-05,0.01,0.91,0.9842956852791879,3070,3234
2,6404,10,100,1e-05,0.01,0.894,0.9878201124297314,3124,3280
2,6504,10,100,1e-05,0.01,0.9,0.9826260762607626,3174,3330
2,6604,10,100,1e-05,0.01,0.894,0.9771350696547547,3225,3379
2,6704,10,100,1e-05,0.01,0.894,0.9849343675417661,3279,3425
2,6804,10,100,1e-05,0.01,0.904,0.9619341563786008,3331,3473
2,6904,10,100,1e-05,0.01,0.866,0.9342410196987254,3381,3523
2,7004,10,100,1e-05,0.01,0.922,0.9744431753283838,3433,3571
2,7104,10,100,1e-05,0.01,0.912,0.9769144144144144,3481,3623
2,7204,10,100,1e-05,0.01,0.93,0.9866740699611327,3522,3682
2,7304,10,100,1e-05,0.01,0.928,0.9912376779846659,3578,3726
2,7404,10,100,1e-05,0.01,0.928,0.9881145326850351,3632,3772
2,7504,10,100,1e-05,0.01,0.938,0.9930703624733476,3685,3819
2,7604,10,100,1e-05,0.01,0.938,0.9872435560231457,3735,3869
2,7704,10,100,1e-05,0.01,0.948,0.9896157840083074,3792,3912
2,7804,10,100,1e-05,0.01,0.936,0.9921834956432599,3840,3964
2,7904,10,100,1e-05,0.01,0.944,0.9883603238866396,3897,4007
2,8004,10,100,1e-05,0.01,0.948,0.9927536231884058,3939,4065
2,8104,10,100,1e-05,0.01,0.938,0.9906219151036525,3987,4117
2,8204,10,100,1e-05,0.01,0.938,0.9884202827888835,4046,4158
2,8304,10,100,1e-05,0.01,0.938,0.9822976878612717,4099,4205
2,8404,10,100,1e-05,0.01,0.912,0.9767967634459781,4158,4246
2,8504,10,100,1e-05,0.01,0.908,0.9568438381937912,4210,4294
2,8604,10,100,1e-05,0.01,0.952,0.9844258484425848,4260,4344
2,8704,10,100,1e-05,0.01,0.938,0.9877068014705882,4313,4391
2,8804,10,100,1e-05,0.01,0.93,0.9645615629259428,4372,4432
2,8904,10,100,1e-05,0.01,0.928,0.9679919137466307,4419,4485
2,9004,10,100,1e-05,0.01,0.942,0.9825633051976899,4468,4536
2,9104,10,100,1e-05,0.01,0.948,0.9818760984182777,4514,4590
2,9204,10,100,1e-05,0.01,0.952,0.9898956975228161,4562,4642
2,9304,10,100,1e-05,0.01,0.952,0.9897893379191746,4619,4685
2,9404,10,100,1e-05,0.01,0.954,0.9864951084644832,4675,4729
2,9504,10,100,1e-05,0.01,0.952,0.9931607744107744,4725,4779
2,9604,10,100,1e-05,0.01,0.95,0.9917742607246981,4781,4823
2,9704,10,100,1e-05,0.01,0.958,0.9929925803792251,4837,4867
2,9804,10,100,1e-05,0.01,0.958,0.987454100367197,4893,4911
2,9904,10,100,1e-05,0.01,0.94,0.9903069466882067,4946,4958
2,10004,10,100,1e-05,0.01,0.96,0.9918032786885246,4994,5010
2,10104,10,100,1e-05,0.01,0.952,0.9900039588281868,5041,5063
2,10204,10,100,1e-05,0.01,0.968,0.9900039200313603,5091,5113
2,10304,10,100,1e-05,0.01,0.96,0.9931094720496895,5128,5176
2,10404,10,100,1e-05,0.01,0.948,0.9783737024221453,5182,5222
2,10504,10,100,1e-05,0.01,0.936,0.9701066260472201,5237,5267
2,10604,10,100,1e-05,0.01,0.952,0.9873632591474916,5283,5321
2,10704,10,100,1e-05,0.01,0.952,0.9869207772795217,5335,5369
2,10804,10,100,1e-05,0.01,0.964,0.9912069603850425,5387,5417
2,10904,10,100,1e-05,0.01,0.96,0.9923881144534116,5438,5466
2,11004,10,100,1e-05,0.01,0.952,0.9899127589967285,5474,5530
2,11104,10,100,1e-05,0.01,0.964,0.992885446685879,5526,5578
2,11204,10,100,1e-05,0.01,0.97,0.9948232774009282,5572,5632
2,11304,10,100,1e-05,0.01,0.964,0.9961075725406936,5628,5676
2,11404,10,100,1e-05,0.01,0.952,0.9874605401613469,5677,5727
2,11504,10,100,1e-05,0.01,0.958,0.9867872044506258,5736,5768
2,11604,10,100,1e-05,0.01,0.954,0.9855222337125129,5794,5810
2,11704,10,100,1e-05,0.01,0.95,0.992053998632946,5842,5862
2,11804,10,100,1e-05,0.01,0.958,0.989495086411386,5892,5912
2,11904,10,100,1e-05,0.01,0.958,0.9938676075268817,5941,5963
2,12004,10,100,1e-05,0.01,0.954,0.9923358880373209,5999,6005
2,12104,10,100,1e-05,0.01,0.968,0.9967779246530073,6048,6056
2,12204,10,100,1e-05,0.01,0.966,0.9947558177646674,6095,6109
2,12304,10,100,1e-05,0.01,0.958,0.9947171651495449,6138,6166
2,12404,10,100,1e-05,0.01,0.964,0.9937923250564334,6180,6224
2,12504,10,100,1e-05,0.01,0.966,0.994321817018554,6232,6272
2,12604,10,100,1e-05,0.01,0.96,0.9886543954300222,6284,6320
2,12704,10,100,1e-05,0.01,0.966,0.9879565491183879,6333,6371
2,12804,10,100,1e-05,0.01,0.964,0.989144017494533,6380,6424
2,12904,10,100,1e-05,0.01,0.96,0.9869032858028518,6426,6478
2,13004,10,100,1e-05,0.01,0.964,0.9902337742233159,6465,6539
2,13104,10,100,1e-05,0.01,0.978,0.9941239316239316,6514,6590
2,13204,10,100,1e-05,0.01,0.984,0.9921235989094214,6567,6637
2,13304,10,100,1e-05,0.01,0.97,0.9927841250751653,6614,6690
2,13404,10,100,1e-05,0.01,0.97,0.9927633542226201,6660,6744
2,13504,10,100,1e-05,0.01,0.98,0.9899289099526066,6715,6789
2,13604,10,100,1e-05,0.01,0.968,0.9916936195236695,6771,6833
2,13704,10,100,1e-05,0.01,0.976,0.9943082311733801,6823,6881
2,13804,10,100,1e-05,0.01,0.972,0.9950738916256158,6868,6936
2,13904,10,100,1e-05,0.01,0.966,0.9957566168009206,6913,6991
2,14004,10,100,1e-05,0.01,0.958,0.9892887746358183,6968,7036
2,14104,10,100,1e-05,0.01,0.978,0.9946823596142939,7014,7090
2,14204,10,100,1e-05,0.01,0.968,0.9928893269501549,7072,7132
2,14304,10,100,1e-05,0.01,0.966,0.9901426174496645,7118,7186
2,14404,10,100,1e-05,0.01,0.978,0.9950708136628714,7167,7237
2,14504,10,100,1e-05,0.01,0.974,0.9932432432432432,7227,7277
2,14604,10,100,1e-05,0.01,0.97,0.993700356066831,7273,7331
2,14704,10,100,1e-05,0.01,0.976,0.9922470076169749,7329,7375
2,14804,10,100,1e-05,0.01,0.966,0.9937179140772764,7386,7418
2,14904,10,100,1e-05,0.01,0.984,0.9957729468599034,7438,7466
2,15004,10,100,1e-05,0.01,0.978,0.9911356971474273,7490,7514
3,104,10,100,1e-05,0.01,0.554,0.5769230769230769,45,59
3,204,10,100,1e-05,0.01,0.466,0.5343137254901961,100,104
3,304,10,100,1e-05,0.01,0.516,0.5822368421052632,153,151
3,404,10,100,1e-05,0.01,0.552,0.5816831683168316,203,201
3,504,10,100,1e-05,0.01,0.506,0.628968253968254,261,243
3,604,10,100,1e-05,0.01,0.484,0.6258278145695364,299,305
3,704,10,100,1e-05,0.01,0.512,0.6306818181818182,356,348
3,804,10,100,1e-05,0.01,0.508,0.6355721393034826,401,403
3,904,10,100,1e-05,0.01,0.492,0.6404867256637168,450,454
3,1004,10,100,1e-05,0.01,0.528,0.700199203187251,493,511
3,1104,10,100,1e-05,0.01,0.506,0.6657608695652174,549,555
3,1204,10,100,1e-05,0.01,0.532,0.6644518272425249,603,601
3,1304,10,100,1e-05,0.01,0.53,0.683282208588957,653,651
3,1404,10,100,1e-05,0.01,0.552,0.7094017094017094,706,698
3,1504,10,100,1e-05,0.01,0.532,0.71875,757,747
3,1604,10,100,1e-05,0.01,0.574,0.7369077306733167,805,799
3,1704,10,100,1e-05,0.01,0.564,0.7740610328638498,855,849
3,1804,10,100,1e-05,0.01,0.584,0.7943458980044346,899,905
3,1904,10,100,1e-05,0.01,0.57,0.7783613445378151,950,954
3,2004,10,100,1e-05,0.01,0.62,0.8173652694610778,997,1007
3,2104,10,100,1e-05,0.01,0.646,0.8065589353612167,1043,1061
3,2204,10,100,1e-05,0.01,0.626,0.8316696914700544,1096,1108
3,2304,10,100,1e-05,0.01,0.656,0.8572048611111112,1152,1152
3,2404,10,100,1e-05,0.01,0.668,0.8897670549084858,1208,1196
3,2504,10,100,1e-05,0.01,0.67,0.8833865814696485,1253,1251
3,2604,10,100,1e-05,0.01,0.652,0.890937019969278,1301,1303
3,2704,10,100,1e-05,0.01,0.696,0.9079142011834319,1354,1350
3,2804,10,100,1e-05,0.01,0.65,0.8883737517831669,1405,1399
3,2904,10,100,1e-05,0.01,0.692,0.8667355371900827,1465,1439
3,3004,10,100,1e-05,0.01,0.69,0.9061251664447404,1515,1489
3,3104,10,100,1e-05,0.01,0.702,0.9281572164948454,1565,1539
3,3204,10,100,1e-05,0.01,0.736,0.931023720349563,1613,1591
3,3304,10,100,1e-05,0.01,0.742,0.926452784503632,1657,1647
3,3404,10,100,1e-05,0.01,0.736,0.9294947121034077,1706,1698
3,3504,10,100,1e-05,0.01,0.73,0.9320776255707762,1757,1747
3,3604,10,100,1e-05,0.01,0.766,0.9414539400665927,1809,1795
3,3704,10,100,1e-05,0.01,0.76,0.9325053995680346,1858,1846
3,3804,10,100,1e-05,0.01,0.768,0.9474237644584648,1905,1899
3,3904,10,100,1e-05,0.01,0.782,0.9546618852459017,1944,1960
3,4004,10,100,1e-05,0.01,0.81,0.9552947052947053,1992,2012
3,4104,10,100,1e-05,0.01,0.804,0.9641812865497076,2053,2051
3,4204,10,100,1e-05,0.01,0.792,0.9569457659372027,2099,2105
3,4304,10,100,1e-05,0.01,0.794,0.9546933085501859,2142,2162
3,4404,10,100,1e-05,0.01,0.814,0.9604904632152589,2185,2219
3,4504,10,100,1e-05,0.01,0.814,0.9573712255772646,2232,2272
3,4604,10,100,1e-05,0.01,0.784,0.9361424847958297,2282,2322
3,4704,10,100,1e-05,0.01,0.838,0.9678996598639455,2320,2384
3,4804,10,100,1e-05,0.01,0.824,0.9317235636969192,2370,2434
3,4904,10,100,1e-05,0.01,0.808,0.9269983686786297,2425,2479
3,5004,10,100,1e-05,0.01,0.826,0.9520383693045563,2475,2529
3,5104,10,100,1e-05,0.01,0.84,0.95826802507837,2521,2583
3,5204,10,100,1e-05,0.01,0.842,0.9661798616448886,2572,2632
3,5304,10,100,1e-05,0.01,0.838,0.9651206636500754,2621,2683
3,5404,10,100,1e-05,0.01,0.846,0.9698371576609919,2682,2722
3,5504,10,100,1e-05,0.01,0.848,0.9689316860465116,2735,2769
3,5604,10,100,1e-05,0.01,0.834,0.970378301213419,2786,2818
3,5704,10,100,1e-05,0.01,0.818,0.97054698457223,2839,2865
3,5804,10,100,1e-05,0.01,0.804,0.9098897312198484,2887,2917
3,5904,10,100,1e-05,0.01,0.82,0.926829268292683,2940,2964
3,6004,10,100,1e-05,0.01,0.85,0.9367088607594937,2995,3009
3,6104,10,100,1e-05,0.01,0.786,0.9030144167758847,3050,3054
3,6204,10,100,1e-05,0.01,0.842,0.9377820760799485,3095,3109
3,6304,10,100,1e-05,0.01,0.848,0.953997461928934,3149,3155
3,6404,10,100,1e-05,0.01,0.878,0.962211118051218,3207,3197
3,6504,10,100,1e-05,0.01,0.86,0.9527982779827798,3265,3239
3,6604,10,100,1e-05,0.01,0.848,0.9542701393095094,3318,3286
3,6704,10,100,1e-05,0.01,0.884,0.9730011933174224,3370,3334
3,6804,10,100,1e-05,0.01,0.886,0.9756025867136978,3417,3387
3,6904,10,100,1e-05,0.01,0.886,0.9775492468134415,3470,3434
3,7004,10,100,1e-05,0.01,0.876,0.9721587664191891,3516,3488
3,7104,10,100,1e-05,0.01,0.874,0.9681869369369369,3563,3541
3,7204,10,100,1e-05,0.01,0.872,0.9745974458634092,3608,3596
3,7304,10,100,1e-05,0.01,0.862,0.9463307776560789,3657,3647
3,7404,10,100,1e-05,0.01,0.88,0.967720151269584,3711,3693
3,7504,10,100,1e-05,0.01,0.884,0.9772121535181236,3765,3739
3,7604,10,100,1e-05,0.01,0.854,0.9522619673855865,3818,3786
3,7704,10,100,1e-05,0.01,0.888,0.9597611630321911,3872,3832
3,7804,10,100,1e-05,0.01,0.888,0.9683495643259866,3927,3877
3,7904,10,100,1e-05,0.01,0.884,0.9664726720647774,3979,3925
3,8004,10,100,1e-05,0.01,0.884,0.9640179910044977,4034,3970
3,8104,10,100,1e-05,0.01,0.898,0.9754442250740375,4079,4025
3,8204,10,100,1e-05,0.01,0.894,0.9820819112627986,4132,4072
3,8304,10,100,1e-05,0.01,0.892,0.9684489402697495,4178,4126
3,8404,10,100,1e-05,0.01,0.894,0.9732270347453593,4227,4177
3,8504,10,100,1e-05,0.01,0.894,0.9776575729068674,4275,4229
3,8604,10,100,1e-05,0.01,0.894,0.9791957229195722,4330,4274
3,8704,10,100,1e-05,0.01,0.888,0.9773667279411765,4374,4330
3,8804,10,100,1e-05,0.01,0.89,0.9781917310313494,4424,4380
3,8904,10,100,1e-05,0.01,0.894,0.9712488769092543,4481,4423
3,9004,10,100,1e-05,0.01,0.894,0.9696801421590404,4533,4471
3,9104,10,100,1e-05,0.01,0.886,0.9712214411247804,4591,4513
3,9204,10,100,1e-05,0.01,0.912,0.9800086918730987,4643,4561
3,9304,10,100,1e-05,0.01,0.898,0.9725924333619949,4694,4610
3,9404,10,100,1e-05,0.01,0.906,0.9813908974904296,4745,4659
3,9504,10,100,1e-05,0.01,0.91,0.9781144781144782,4804,4700
3,9604,10,100,1e-05,0.01,0.906,0.9761557684298209,4847,4757
3,9704,10,100,1e-05,0.01,0.898,0.9749587798845837,4889,4815
3,9804,10,100,1e-05,0.01,0.922,0.9824561403508771,4937,4867
3,9904,10,100,1e-05,0.01,0.912,0.9776857835218093,4986,4918
3,10004,10,100,1e-05,0.01,0.92,0.9860055977608957,5040,4964
3,10104,10,100,1e-05,0.01,0.918,0.9813935075217736,5084,5020
3,10204,10,100,1e-05,0.01,0.894,0.9710897687181498,5131,5073
3,10304,10,100,1e-05,0.01,0.906,0.9731172360248447,5178,5126
3,10404,10,100,1e-05,0.01,0.882,0.972798923490965,5220,5184
3,10504,10,100,1e-05,0.01,0.9,0.9761995430312262,5271,5233
3,10604,10,100,1e-05,0.01,0.908,0.9813278008298755,5320,5284
3,10704,10,100,1e-05,0.01,0.918,0.9787929745889388,5363,5341
3,10804,10,100,1e-05,0.01,0.932,0.9866716031099593,5418,5386
3,10904,10,100,1e-05,0.01,0.898,0.980465884079237,5464,5440
3,11004,10,100,1e-05,0.01,0.916,0.9804616503089786,5510,5494
3,11104,10,100,1e-05,0.01,0.912,0.9747838616714697,5565,5539
3,11204,10,100,1e-05,0.01,0.896,0.9743841485183863,5612,5592
3,11304,10,100,1e-05,0.01,0.904,0.9811571125265393,5666,5638
3,11404,10,100,1e-05,0.01,0.876,0.9643107681515258,5721,5683
3,11504,10,100,1e-05,0.01,0.912,0.9599269819193325,5770,5734
3,11604,10,100,1e-05,0.01,0.914,0.9741468459152016,5824,5780
3,11704,10,100,1e-05,0.01,0.93,0.9789815447710185,5869,5835
3,11804,10,100,1e-05,0.01,0.92,0.9828871568959675,5918,5886
3,11904,10,100,1e-05,0.01,0.924,0.9835349462365591,5969,5935
3,12004,10,100,1e-05,0.01,0.918,0.983088970343219,6023,5981
3,12104,10,100,1e-05,0.01,0.91,0.9752148050231328,6075,6029
3,12204,10,100,1e-05,0.01,0.93,0.983284169124877,6124,6080
3,12304,10,100,1e-05,0.01,0.922,0.9849642392717816,6179,6125
3,12404,10,100,1e-05,0.01,0.92,0.9833924540470815,6234,6170
3,12504,10,100,1e-05,0.01,0.928,0.9840051183621241,6286,6218
3,12604,10,100,1e-05,0.01,0.94,0.9869882576959695,6340,6264
3,12704,10,100,1e-05,0.01,0.932,0.986382241813602,6391,6313
3,12804,10,100,1e-05,0.01,0.934,0.9839893783192752,6428,6376
3,12904,10,100,1e-05,0.01,0.922,0.9800061996280223,6483,6421
3,13004,10,100,1e-05,0.01,0.926,0.9794678560442941,6525,6479
3,13104,10,100,1e-05,0.01,0.934,0.9851953601953602,6579,6525
3,13204,10,100,1e-05,0.01,0.918,0.9820508936685852,6628,6576
3,13304,10,100,1e-05,0.01,0.932,0.9815844858689116,6678,6626
3,13404,10,100,1e-05,0.01,0.944,0.9881378692927484,6720,6684
3,13504,10,100,1e-05,0.01,0.932,0.9797837677725119,6772,6732
3,13604,10,100,1e-05,0.01,0.936,0.9826521611290797,6829,6775
3,13704,10,100,1e-05,0.01,0.922,0.9839462930531232,6875,6829
3,13804,10,100,1e-05,0.01,0.926,0.9818893074471168,6921,6883
3,13904,10,100,1e-05,0.01,0.936,0.982307249712313,6973,6931
3,14004,10,100,1e-05,0.01,0.916,0.9751499571550986,7025,6979
3,14104,10,100,1e-05,0.01,0.94,0.9807146908678389,7070,7034
3,14204,10,100,1e-05,0.01,0.94,0.9859898620107012,7117,7087
3,14304,10,100,1e-05,0.01,0.948,0.9879753914988815,7167,7137
3,14404,10,100,1e-05,0.01,0.944,0.988544848653152,7223,7181
3,14504,10,100,1e-05,0.01,0.93,0.9709735245449531,7273,7231
3,14604,10,100,1e-05,0.01,0.936,0.980142426732402,7333,7271
3,14704,10,100,1e-05,0.01,0.936,0.985854189336235,7385,7319
3,14804,10,100,1e-05,0.01,0.944,0.9796001080788976,7428,7376
3,14904,10,100,1e-05,0.01,0.948,0.9830246913580247,7479,7425
3,15004,10,100,1e-05,0.01,0.94,0.9848040522527326,7528,7476
4,104,10,100,1e-05,0.01,0.544,0.6923076923076923,45,59
4,204,10,100,1e-05,0.01,0.494,0.7598039215686274,91,113
4,304,10,100,1e-05,0.01,0.528,0.6842105263157895,147,157
4,404,10,100,1e-05,0.01,0.49,0.6188118811881188,200,204
4,504,10,100,1e-05,0.01,0.518,0.6170634920634921,257,247
4,604,10,100,1e-05,0.01,0.458,0.597682119205298,294,310
4,704,10,100,1e-05,0.01,0.47,0.6363636363636364,348,356
4,804,10,100,1e-05,0.01,0.5,0.650497512437811,399,405
4,904,10,100,1e-05,0.01,0.494,0.6603982300884956,451,453
4,1004,10,100,1e-05,0.01,0.492,0.6703187250996016,489,515
4,1104,10,100,1e-05,0.01,0.496,0.6838768115942029,542,562
4,1204,10,100,1e-05,0.01,0.476,0.6511627906976745,593,611
4,1304,10,100,1e-05,0.01,0.496,0.6533742331288344,647,657
4,1404,10,100,1e-05,0.01,0.498,0.6894586894586895,701,703
4,1504,10,100,1e-05,0.01,0.474,0.7134308510638298,757,747
4,1604,10,100,1e-05,0.01,0.5,0.7306733167082294,799,805
4,1704,10,100,1e-05,0.01,0.492,0.7511737089201878,854,850
4,1804,10,100,1e-05,0.01,0.494,0.761640798226164,911,893
4,1904,10,100,1e-05,0.01,0.498,0.7436974789915967,956,948
4,2004,10,100,1e-05,0.01,0.464,0.7495009980039921,1010,994
4,2104,10,100,1e-05,0.01,0.496,0.7409695817490495,1051,1053
4,2204,10,100,1e-05,0.01,0.478,0.79491833030853,1100,1104
4,2304,10,100,1e-05,0.01,0.508,0.7486979166666666,1156,1148
4,2404,10,100,1e-05,0.01,0.492,0.7928452579034941,1210,1194
4,2504,10,100,1e-05,0.01,0.5,0.7496006389776357,1262,1242
4,2604,10,100,1e-05,0.01,0.53,0.7899385560675883,1311,1293
4,2704,10,100,1e-05,0.01,0.508,0.797707100591716,1361,1343
4,2804,10,100,1e-05,0.01,0.478,0.7664051355206848,1406,1398
4,2904,10,100,1e-05,0.01,0.52,0.8085399449035813,1457,1447
4,3004,10,100,1e-05,0.01,0.508,0.8059254327563249,1522,1482
4,3104,10,100,1e-05,0.01,0.5,0.7661082474226805,1581,1523
4,3204,10,100,1e-05,0.01,0.488,0.8108614232209738,1631,1573
4,3304,10,100,1e-05,0.01,0.506,0.8002421307506054,1678,1626
4,3404,10,100,1e-05,0.01,0.5,0.8111045828437132,1723,1681
4,3504,10,100,1e-05,0.01,0.502,0.8290525114155252,1771,1733
4,3604,10,100,1e-05,0.01,0.484,0.8349056603773585,1828,1776
4,3704,10,100,1e-05,0.01,0.548,0.7794276457883369,1872,1832
4,3804,10,100,1e-05,0.01,0.548,0.8078338590956887,1927,1877
4,3904,10,100,1e-05,0.01,0.56,0.8194159836065574,1981,1923
4,4004,10,100,1e-05,0.01,0.55,0.8304195804195804,2026,1978
4,4104,10,100,1e-05,0.01,0.552,0.8265107212475633,2079,2025
4,4204,10,100,1e-05,0.01,0.534,0.8518078020932446,2120,2084
4,4304,10,100,1e-05,0.01,0.558,0.833410780669145,2174,2130
4,4404,10,100,1e-05,0.01,0.56,0.8553587647593097,2223,2181
4,4504,10,100,1e-05,0.01,0.58,0.8421403197158082,2271,2233
4,4604,10,100,1e-05,0.01,0.578,0.8629452649869679,2314,2290
4,4704,10,100,1e-05,0.01,0.568,0.8798894557823129,2360,2344
4,4804,10,100,1e-05,0.01,0.566,0.86511240632806,2413,2391
4,4904,10,100,1e-05,0.01,0.582,0.8682707993474714,2460,2444
4,5004,10,100,1e-05,0.01,0.604,0.8703037569944044,2506,2498
4,5104,10,100,1e-05,0.01,0.544,0.8626567398119123,2556,2548
4,5204,10,100,1e-05,0.01,0.584,0.8818216756341276,2607,2597
4,5304,10,100,1e-05,0.01,0.582,0.8959276018099548,2661,2643
4,5404,10,100,1e-05,0.01,0.592,0.8762028127313102,2710,2694
4,5504,10,100,1e-05,0.01,0.572,0.8341206395348837,2759,2745
4,5604,10,100,1e-05,0.01,0.628,0.8599214846538187,2807,2797
4,5704,10,100,1e-05,0.01,0.63,0.8895511921458625,2860,2844
4,5804,10,100,1e-05,0.01,0.6,0.8661268090971743,2908,2896
4,5904,10,100,1e-05,0.01,0.648,0.8953252032520326,2959,2945
4,6004,10,100,1e-05,0.01,0.624,0.882744836775483,3010,2994
4,6104,10,100,1e-05,0.01,0.614,0.8687745740498034,3064,3040
4,6204,10,100,1e-05,0.01,0.626,0.874113475177305,3115,3089
4,6304,10,100,1e-05,0.01,0.644,0.8802347715736041,3158,3146
4,6404,10,100,1e-05,0.01,0.648,0.8788257339163024,3213,3191
4,6504,10,100,1e-05,0.01,0.644,0.8912976629766297,3259,3245
4,6604,10,100,1e-05,0.01,0.648,0.8865838885523925,3306,3298
4,6704,10,100,1e-05,0.01,0.654,0.8824582338902148,3350,3354
4,6804,10,100,1e-05,0.01,0.63,0.86331569664903,3395,3409
4,6904,10,100,1e-05,0.01,0.646,0.8571842410196987,3440,3464
4,7004,10,100,1e-05,0.01,0.668,0.8782124500285551,3499,3505
4,7104,10,100,1e-05,0.01,0.69,0.904420045045045,3546,3558
4,7204,10,100,1e-05,0.01,0.686,0.9031093836757357,3588,3616
4,7304,10,100,1e-05,0.01,0.69,0.8838992332968236,3639,3665
4,7404,10,100,1e-05,0.01,0.688,0.8841166936790924,3695,3709
4,7504,10,100,1e-05,0.01,0.67,0.865405117270789,3734,3770
4,7604,10,100,1e-05,0.01,0.698,0.8865071015255129,3785,3819
4,7704,10,100,1e-05,0.01,0.668,0.8917445482866043,3841,3863
4,7804,10,100,1e-05,0.01,0.674,0.9036391594054332,3888,3916
4,7904,10,100,1e-05,0.01,0.684,0.8978997975708503,3942,3962
4,8004,10,100,1e-05,0.01,0.678,0.9170414792603698,3994,4010
4,8104,10,100,1e-05,0.01,0.702,0.9199160908193484,4044,4060
4,8204,10,100,1e-05,0.01,0.68,0.9190638712823013,4093,4111
4,8304,10,100,1e-05,0.01,0.662,0.9054672447013488,4141,4163
4,8404,10,100,1e-05,0.01,0.692,0.9140885292717753,4189,4215
4,8504,10,100,1e-05,0.01,0.708,0.9209783631232361,4240,4264
4,8604,10,100,1e-05,0.01,0.678,0.9073686657368666,4297,4307
4,8704,10,100,1e-05,0.01,0.678,0.8934972426470589,4349,4355
4,8804,10,100,1e-05,0.01,0.682,0.9126533393911859,4398,4406
4,8904,10,100,1e-05,0.01,0.702,0.9135220125786163,4447,4457
4,9004,10,100,1e-05,0.01,0.72,0.9251443802754331,4504,4500
4,9104,10,100,1e-05,0.01,0.736,0.9199253075571178,4554,4550
4,9204,10,100,1e-05,0.01,0.734,0.9254671881790526,4606,4598
4,9304,10,100,1e-05,0.01,0.716,0.921969045571797,4655,4649
4,9404,10,100,1e-05,0.01,0.71,0.9290727350063802,4716,4688
4,9504,10,100,1e-05,0.01,0.712,0.9269781144781145,4765,4739
4,9604,10,100,1e-05,0.01,0.712,0.9285714285714286,4808,4796
4,9704,10,100,1e-05,0.01,0.738,0.93239901071723,4863,4841
4,9804,10,100,1e-05,0.01,0.742,0.9249286005711954,4912,4892
4,9904,10,100,1e-05,0.01,0.748,0.9501211631663974,4960,4944
4,10004,10,100,1e-05,0.01,0.724,0.9300279888044782,5010,4994
4,10104,10,100,1e-05,0.01,0.75,0.9397268408551069,5067,5037
4,10204,10,100,1e-05,0.01,0.744,0.9184633477067816,5110,5094
4,10304,10,100,1e-05,0.01,0.744,0.937014751552795,5170,5134
4,10404,10,100,1e-05,0.01,0.746,0.9232987312572087,5215,5189
4,10504,10,100,1e-05,0.01,0.722,0.9001332825590251,5267,5237
4,10604,10,100,1e-05,0.01,0.73,0.9288947566955865,5322,5282
4,10704,10,100,1e-05,0.01,0.76,0.9408632286995515,5367,5337
4,10804,10,100,1e-05,0.01,0.764,0.9420584968530173,5415,5389
4,10904,10,100,1e-05,0.01,0.798,0.950476889214967,5461,5443
4,11004,10,100,1e-05,0.01,0.744,0.9362050163576882,5512,5492
4,11104,10,100,1e-05,0.01,0.756,0.9272334293948127,5556,5548
4,11204,10,100,1e-05,0.01,0.806,0.9546590503391645,5607,5597
4,11304,10,100,1e-05,0.01,0.798,0.9491330502476999,5662,5642
4,11404,10,100,1e-05,0.01,0.8,0.9512451771308312,5711,5693
4,11504,10,100,1e-05,0.01,0.792,0.9577538247566064,5767,5737
4,11604,10,100,1e-05,0.01,0.806,0.9510513615994485,5818,5786
4,11704,10,100,1e-05,0.01,0.822,0.9503588516746412,5873,5831
4,11804,10,100,1e-05,0.01,0.776,0.9229922060318536,5924,5880
4,11904,10,100,1e-05,0.01,0.758,0.8981854838709677,5971,5933
4,12004,10,100,1e-05,0.01,0.74,0.9120293235588137,6026,5978
4,12104,10,100,1e-05,0.01,0.782,0.9161434236615995,6074,6030
4,12204,10,100,1e-05,0.01,0.824,0.9431333988856113,6119,6085
4,12304,10,100,1e-05,0.01,0.808,0.9509102730819246,6162,6142
4,12404,10,100,1e-05,0.01,0.834,0.9596098032892615,6212,6192
4,12504,10,100,1e-05,0.01,0.856,0.966890595009597,6266,6238
4,12604,10,100,1e-05,0.01,0.844,0.9654078070453824,6322,6282
4,12704,10,100,1e-05,0.01,0.822,0.9615869017632241,6374,6330
4,12804,10,100,1e-05,0.01,0.878,0.9736019993751952,6420,6384
4,12904,10,100,1e-05,0.01,0.862,0.9703967761934283,6472,6432
4,13004,10,100,1e-05,0.01,0.864,0.9620116887111658,6522,6482
4,13104,10,100,1e-05,0.01,0.896,0.9766483516483516,6575,6529
4,13204,10,100,1e-05,0.01,0.872,0.9687973341411693,6631,6573
4,13304,10,100,1e-05,0.01,0.872,0.9718129885748648,6683,6621
4,13404,10,100,1e-05,0.01,0.854,0.9677708146821844,6735,6669
4,13504,10,100,1e-05,0.01,0.874,0.9644549763033176,6785,6719
4,13604,10,100,1e-05,0.01,0.884,0.9769185533666569,6834,6770
4,13704,10,100,1e-05,0.01,0.884,0.9736573263280794,6877,6827
4,13804,10,100,1e-05,0.01,0.884,0.9757316719791365,6918,6886
4,13904,10,100,1e-05,0.01,0.894,0.9765535097813579,6968,6936
4,14004,10,100,1e-05,0.01,0.876,0.9600114253070551,7011,6993
4,14104,10,100,1e-05,0.01,0.902,0.9804310833806013,7062,7042
4,14204,10,100,1e-05,0.01,0.9,0.9797240214024219,7114,7090
4,14304,10,100,1e-05,0.01,0.898,0.9721057046979866,7173,7131
4,14404,10,100,1e-05,0.01,0.894,0.9772285476256596,7219,7185
4,14504,10,100,1e-05,0.01,0.908,0.9833149476006618,7265,7239
4,14604,10,100,1e-05,0.01,0.886,0.9663105998356615,7312,7292
4,14704,10,100,1e-05,0.01,0.896,0.9747687704026116,7363,7341
4,14804,10,100,1e-05,0.01,0.902,0.9849365036476628,7409,7395
4,14904,10,100,1e-05,0.01,0.93,0.9895330112721417,7467,7437
4,15004,10,100,1e-05,0.01,0.924,0.9832044788056519,7516,7488
5,104,10,100,1e-05,0.01,0.486,0.5673076923076923,54,50
5,204,10,100,1e-05,0.01,0.516,0.5637254901960784,114,90
5,304,10,100,1e-05,0.01,0.514,0.5361842105263158,158,146
5,404,10,100,1e-05,0.01,0.466,0.556930693069307,209,195
5,504,10,100,1e-05,0.01,0.474,0.5456349206349206,260,244
5,604,10,100,1e-05,0.01,0.508,0.5927152317880795,308,296
5,704,10,100,1e-05,0.01,0.494,0.578125,343,361
5,804,10,100,1e-05,0.01,0.52,0.595771144278607,396,408
5,904,10,100,1e-05,0.01,0.548,0.6050884955752213,440,464
5,1004,10,100,1e-05,0.01,0.524,0.6354581673306773,483,521
5,1104,10,100,1e-05,0.01,0.512,0.6485507246376812,529,575
5,1204,10,100,1e-05,0.01,0.51,0.6669435215946844,576,628
5,1304,10,100,1e-05,0.01,0.52,0.6579754601226994,626,678
5,1404,10,100,1e-05,0.01,0.536,0.698005698005698,683,721
5,1504,10,100,1e-05,0.01,0.588,0.6968085106382979,739,765
5,1604,10,100,1e-05,0.01,0.586,0.7256857855361596,794,810
5,1704,10,100,1e-05,0.01,0.614,0.7353286384976526,846,858
5,1804,10,100,1e-05,0.01,0.602,0.725609756097561,897,907
5,1904,10,100,1e-05,0.01,0.568,0.7100840336134454,955,949
5,2004,10,100,1e-05,0.01,0.62,0.7709580838323353,1007,997
5,2104,10,100,1e-05,0.01,0.63,0.7718631178707225,1042,1062
5,2204,10,100,1e-05,0.01,0.624,0.7921960072595281,1095,1109
5,2304,10,100,1e-05,0.01,0.658,0.7999131944444444,1146,1158
5,2404,10,100,1e-05,0.01,0.63,0.7712146422628952,1197,1207
5,2504,10,100,1e-05,0.01,0.636,0.7835463258785943,1246,1258
5,2604,10,100,1e-05,0.01,0.656,0.8129800307219662,1299,1305
5,2704,10,100,1e-05,0.01,0.622,0.7847633136094675,1347,1357
5,2804,10,100,1e-05,0.01,0.638,0.7949358059914408,1389,1415
5,2904,10,100,1e-05,0.01,0.686,0.821625344352617,1443,1461
5,3004,10,100,1e-05,0.01,0.698,0.8305592543275633,1492,1512
5,3104,10,100,1e-05,0.01,0.706,0.8125,1541,1563
5,3204,10,100,1e-05,0.01,0.714,0.8420724094881398,1593,1611
5,3304,10,100,1e-05,0.01,0.734,0.8604721549636803,1638,1666
5,3404,10,100,1e-05,0.01,0.768,0.8892479435957696,1690,1714
5,3504,10,100,1e-05,0.01,0.744,0.8613013698630136,1735,1769
5,3604,10,100,1e-05,0.01,0.814,0.9112097669256382,1790,1814
5,3704,10,100,1e-05,0.01,0.794,0.9187365010799136,1844,1860
5,3804,10,100,1e-05,0.01,0.796,0.9150893796004206,1892,1912
5,3904,10,100,1e-05,0.01,0.808,0.9098360655737705,1952,1952
5,4004,10,100,1e-05,0.01,0.836,0.9218281718281718,2000,2004
5,4104,10,100,1e-05,0.01,0.83,0.925682261208577,2042,2062
5,4204,10,100,1e-05,0.01,0.822,0.9088962892483349,2088,2116
5,4304,10,100,1e-05,0.01,0.81,0.9021840148698885,2146,2158
5,4404,10,100,1e-05,0.01,0.798,0.8957765667574932,2193,2211
5,4504,10,100,1e-05,0.01,0.86,0.9431616341030196,2245,2259
5,4604,10,100,1e-05,0.01,0.85,0.9411381407471764,2305,2299
5,4704,10,100,1e-05,0.01,0.864,0.9432397959183674,2357,2347
5,4804,10,100,1e-05,0.01,0.85,0.9442131557035803,2407,2397
5,4904,10,100,1e-05,0.01,0.896,0.9655383360522023,2457,2447
5,5004,10,100,1e-05,0.01,0.878,0.9476418864908074,2506,2498
5,5104,10,100,1e-05,0.01,0.848,0.88891065830721,2550,2554
5,5204,10,100,1e-05,0.01,0.88,0.9396617986164489,2596,2608
5,5304,10,100,1e-05,0.01,0.906,0.958710407239819,2644,2660
5,5404,10,100,1e-05,0.01,0.882,0.9655810510732791,2692,2712
5,5504,10,100,1e-05,0.01,0.88,0.9496729651162791,2743,2761
5,5604,10,100,1e-05,0.01,0.88,0.9543183440399714,2786,2818
5,5704,10,100,1e-05,0.01,0.922,0.9724754558204769,2828,2876
5,5804,10,100,1e-05,0.01,0.92,0.9765678842177808,2882,2922
5,5904,10,100,1e-05,0.01,0.918,0.9708672086720868,2930,2974
5,6004,10,100,1e-05,0.01,0.908,0.9643570952698202,2972,3032
5,6104,10,100,1e-05,0.01,0.932,0.9700196592398427,3026,3078
5,6204,10,100,1e-05,0.01,0.914,0.9695357833655706,3079,3125
5,6304,10,100,1e-05,0.01,0.93,0.9750951776649747,3131,3173
5,6404,10,100,1e-05,0.01,0.93,0.9722048719550281,3178,3226
5,6504,10,100,1e-05,0.01,0.924,0.9723247232472325,3226,3278
5,6604,10,100,1e-05,0.01,0.93,0.9804663840096911,3280,3324
5,6704,10,100,1e-05,0.01,0.922,0.9746420047732697,3327,3377
5,6804,10,100,1e-05,0.01,0.928,0.9779541446208113,3377,3427
5,6904,10,100,1e-05,0.01,0.942,0.9856604866743917,3422,3482
5,7004,10,100,1e-05,0.01,0.892,0.9277555682467161,3469,3535
5,7104,10,100,1e-05,0.01,0.864,0.9048423423423423,3523,3581
5,7204,10,100,1e-05,0.01,0.91,0.9355913381454747,3575,3629
5,7304,10,100,1e-05,0.01,0.94,0.963170865279299,3626,3678
5,7404,10,100,1e-05,0.01,0.942,0.9721772015126958,3671,3733
5,7504,10,100,1e-05,0.01,0.914,0.9697494669509595,3729,3775
5,7604,10,100,1e-05,0.01,0.922,0.9500263019463441,3778,3826
5,7704,10,100,1e-05,0.01,0.948,0.9816978193146417,3827,3877
5,7804,10,100,1e-05,0.01,0.946,0.9769349051768323,3887,3917
5,7904,10,100,1e-05,0.01,0.942,0.9830465587044535,3936,3968
5,8004,10,100,1e-05,0.01,0.948,0.9828835582208896,3996,4008
5,8104,10,100,1e-05,0.01,0.958,0.9838351431391905,4042,4062
5,8204,10,100,1e-05,0.01,0.954,0.9811067771818625,4101,4103
5,8304,10,100,1e-05,0.01,0.93,0.9742292870905588,4151,4153
5,8404,10,100,1e-05,0.01,0.94,0.9792955735364113,4202,4202
5,8504,10,100,1e-05,0.01,0.932,0.9667215428033866,4250,4254
5,8604,10,100,1e-05,0.01,0.956,0.9825662482566249,4304,4300
5,8704,10,100,1e-05,0.01,0.956,0.9817325367647058,4355,4349
5,8804,10,100,1e-05,0.01,0.952,0.9887551113130395,4401,4403
5,8904,10,100,1e-05,0.01,0.956,0.9883198562443846,4452,4452
5,9004,10,100,1e-05,0.01,0.958,0.9873389604620169,4506,4498
5,9104,10,100,1e-05,0.01,0.946,0.9792398945518453,4559,4545
5,9204,10,100,1e-05,0.01,0.956,0.9762059973924381,4608,4596
5,9304,10,100,1e-05,0.01,0.962,0.9811908856405847,4660,4644
5,9404,10,100,1e-05,0.01,0.942,0.974478945129732,4704,4700
5,9504,10,100,1e-05,0.01,0.936,0.9688552188552189,4755,4749
5,9604,10,100,1e-05,0.01,0.95,0.9824031653477717,4802,4802
5,9704,10,100,1e-05,0.01,0.938,0.9792868920032977,4850,4854
5,9804,10,100,1e-05,0.01,0.95,0.9869441044471644,4900,4904
5,9904,10,100,1e-05,0.01,0.95,0.9801090468497576,4949,4955
5,10004,10,100,1e-05,0.01,0.952,0.9689124350259896,5004,5000
5,10104,10,100,1e-05,0.01,0.956,0.9786223277909739,5056,5048
5,10204,10,100,1e-05,0.01,0.956,0.9755978047824383,5106,5098
5,10304,10,100,1e-05,0.01,0.958,0.9822399068322981,5159,5145
5,10404,10,100,1e-05,0.01,0.966,0.9900038446751249,5209,5195
5,10504,10,100,1e-05,0.01,0.962,0.9834348819497334,5249,5255
5,10604,10,100,1e-05,0.01,0.968,0.990569596378725,5298,5306
5,10704,10,100,1e-05,0.01,0.976,0.9939275037369207,5350,5354
5,10804,10,100,1e-05,0.01,0.958,0.9869492780451684,5397,5407
5,10904,10,100,1e-05,0.01,0.95,0.9546038151137197,5444,5460
5,11004,10,100,1e-05,0.01,0.958,0.9721010541621229,5492,5512
5,11104,10,100,1e-05,0.01,0.974,0.982078530259366,5543,5561
5,11204,10,100,1e-05,0.01,0.982,0.9861656551231703,5600,5604
5,11304,10,100,1e-05,0.01,0.972,0.9786801132342534,5648,5656
5,11404,10,100,1e-05,0.01,0.974,0.9877236057523676,5706,5698
5,11504,10,100,1e-05,0.01,0.964,0.9895688456189151,5749,5755
5,11604,10,100,1e-05,0.01,0.976,0.9888831437435367,5810,5794
5,11704,10,100,1e-05,0.01,0.972,0.9915413533834586,5854,5850
5,11804,10,100,1e-05,0.01,0.966,0.990765842087428,5905,5899
5,11904,10,100,1e-05,0.01,0.974,0.9894993279569892,5952,5952
5,12004,10,100,1e-05,0.01,0.96,0.9735921359546817,6005,5999
5,12104,10,100,1e-05,0.01,0.97,0.9833113020489095,6055,6049
5,12204,10,100,1e-05,0.01,0.964,0.987627007538512,6099,6105
5,12304,10,100,1e-05,0.01,0.97,0.9904096228868661,6140,6164
5,12404,10,100,1e-05,0.01,0.974,0.9907287971622057,6180,6224
5,12504,10,100,1e-05,0.01,0.978,0.9904030710172744,6226,6278
5,12604,10,100,1e-05,0.01,0.96,0.9898444938114884,6278,6326
5,12704,10,100,1e-05,0.01,0.976,0.9926794710327456,6330,6374
5,12804,10,100,1e-05,0.01,0.972,0.9882849109653233,6370,6434
5,12904,10,100,1e-05,0.01,0.97,0.990778053316801,6414,6490
5,13004,10,100,1e-05,0.01,0.956,0.9839280221470317,6469,6535
5,13104,10,100,1e-05,0.01,0.976,0.993513431013431,6520,6584
5,13204,10,100,1e-05,0.01,0.974,0.9943199030596789,6571,6633
5,13304,10,100,1e-05,0.01,0.98,0.9928592904389657,6619,6685
5,13404,10,100,1e-05,0.01,0.972,0.9897045658012533,6676,6728
5,13504,10,100,1e-05,0.01,0.98,0.9941498815165877,6721,6783
5,13604,10,100,1e-05,0.01,0.982,0.9938988532784475,6778,6826
5,13704,10,100,1e-05,0.01,0.976,0.984748978400467,6836,6868
5,13804,10,100,1e-05,0.01,0.958,0.9676905244856563,6893,6911
5,13904,10,100,1e-05,0.01,0.968,0.9769131185270425,6947,6957
5,14004,10,100,1e-05,0.01,0.986,0.9899314481576692,7005,6999
5,14104,10,100,1e-05,0.01,0.982,0.9889393079977311,7063,7041
5,14204,10,100,1e-05,0.01,0.978,0.9899324134046747,7107,7097
5,14304,10,100,1e-05,0.01,0.99,0.9945469798657718,7156,7148
5,14404,10,100,1e-05,0.01,0.982,0.9936128853096362,7207,7197
5,14504,10,100,1e-05,0.01,0.982,0.9886238279095422,7252,7252
5,14604,10,100,1e-05,0.01,0.98,0.9916461243494933,7297,7307
5,14704,10,100,1e-05,0.01,0.988,0.9940832426550599,7350,7354
5,14804,10,100,1e-05,0.01,0.99,0.9964874358281546,7393,7411
5,14904,10,100,1e-05,0.01,0.986,0.9933574879227053,7442,7462
5,15004,10,100,1e-05,0.01,0.968,0.977406025059984,7494,7510
6,104,10,100,1e-05,0.01,0.504,0.5096153846153846,53,51
6,204,10,100,1e-05,0.01,0.53,0.6617647058823529,97,107
6,304,10,100,1e-05,0.01,0.536,0.6052631578947368,150,154
6,404,10,100,1e-05,0.01,0.516,0.6287128712871287,200,204
6,504,10,100,1e-05,0.01,0.532,0.6051587301587301,251,253
6,604,10,100,1e-05,0.01,0.488,0.6572847682119205,300,304
6,704,10,100,1e-05,0.01,0.52,0.65625,354,350
6,804,10,100,1e-05,0.01,0.514,0.6592039800995025,404,400
6,904,10,100,1e-05,0.01,0.52,0.6902654867256637,449,455
6,1004,10,100,1e-05,0.01,0.522,0.6802788844621513,504,500
6,1104,10,100,1e-05,0.01,0.504,0.6585144927536232,548,556
6,1204,10,100,1e-05,0.01,0.526,0.6777408637873754,593,611
6,1304,10,100,1e-05,0.01,0.5,0.6779141104294478,642,662
6,1404,10,100,1e-05,0.01,0.522,0.688034188034188,689,715
6,1504,10,100,1e-05,0.01,0.524,0.6735372340425532,748,756
6,1604,10,100,1e-05,0.01,0.542,0.7213216957605985,795,809
6,1704,10,100,1e-05,0.01,0.542,0.7288732394366197,846,858
6,1804,10,100,1e-05,0.01,0.546,0.7732815964523282,895,909
6,1904,10,100,1e-05,0.01,0.572,0.770483193277311,955,949
6,2004,10,100,1e-05,0.01,0.588,0.8143712574850299,1013,991
6,2104,10,100,1e-05,0.01,0.578,0.75,1064,1040
6,2204,10,100,1e-05,0.01,0.584,0.7867513611615246,1113,1091
6,2304,10,100,1e-05,0.01,0.628,0.7864583333333334,1171,1133
6,2404,10,100,1e-05,0.01,0.632,0.8265391014975042,1216,1188
6,2504,10,100,1e-05,0.01,0.628,0.832667731629393,1260,1244
6,2604,10,100,1e-05,0.01,0.624,0.8410138248847926,1310,1294
6,2704,10,100,1e-05,0.01,0.666,0.8590976331360947,1353,1351
6,2804,10,100,1e-05,0.01,0.704,0.8751783166904422,1412,1392
6,2904,10,100,1e-05,0.01,0.714,0.8880853994490359,1467,1437
6,3004,10,100,1e-05,0.01,0.736,0.8978029294274301,1521,1483
6,3104,10,100,1e-05,0.01,0.75,0.9068943298969072,1573,1531
6,3204,10,100,1e-05,0.01,0.724,0.8926342072409488,1627,1577
6,3304,10,100,1e-05,0.01,0.718,0.8907384987893463,1678,1626
6,3404,10,100,1e-05,0.01,0.716,0.8730904817861339,1735,1669
6,3504,10,100,1e-05,0.01,0.746,0.863013698630137,1786,1718
6,3604,10,100,1e-05,0.01,0.758,0.902330743618202,1833,1771
6,3704,10,100,1e-05,0.01,0.776,0.9195464362850972,1881,1823
6,3804,10,100,1e-05,0.01,0.796,0.9403259726603576,1933,1871
6,3904,10,100,1e-05,0.01,0.826,0.9623463114754098,1984,1920
6,4004,10,100,1e-05,0.01,0.832,0.9702797202797203,2038,1966
6,4104,10,100,1e-05,0.01,0.826,0.976364522417154,2088,2016
6,4204,10,100,1e-05,0.01,0.848,0.9740723120837298,2133,2071
6,4304,10,100,1e-05,0.01,0.842,0.958410780669145,2187,2117
6,4404,10,100,1e-05,0.01,0.838,0.9602633969118983,2238,2166
6,4504,10,100,1e-05,0.01,0.868,0.9713587921847247,2282,2222
6,4604,10,100,1e-05,0.01,0.876,0.9811033883579496,2333,2271
6,4704,10,100,1e-05,0.01,0.872,0.98171768707483,2374,2330
6,4804,10,100,1e-05,0.01,0.89,0.9777268942547876,2419,2385
6,4904,10,100,1e-05,0.01,0.896,0.9871533442088092,2465,2439
6,5004,10,100,1e-05,0.01,0.894,0.9902078337330136,2509,2495
6,5104,10,100,1e-05,0.01,0.894,0.9882445141065831,2562,2542
6,5204,10,100,1e-05,0.01,0.882,0.9773251345119139,2615,2589
6,5304,10,100,1e-05,0.01,0.884,0.9515460030165912,2671,2633
6,5404,10,100,1e-05,0.01,0.882,0.9631754256106587,2720,2684
6,5504,10,100,1e-05,0.01,0.874,0.9776526162790697,2768,2736
6,5604,10,100,1e-05,0.01,0.874,0.9735902926481085,2816,2788
6,5704,10,100,1e-05,0.01,0.858,0.9249649368863955,2865,2839
6,5804,10,100,1e-05,0.01,0.9,0.9748449345279118,2905,2899
6,5904,10,100,1e-05,0.01,0.906,0.9845867208672087,2954,2950
6,6004,10,100,1e-05,0.01,0.902,0.978014656895403,3012,2992
6,6104,10,100,1e-05,0.01,0.924,0.991480996068152,3060,3044
6,6204,10,100,1e-05,0.01,0.908,0.9900064474532559,3109,3095
6,6304,10,100,1e-05,0.01,0.9,0.986992385786802,3159,3145
6,6404,10,100,1e-05,0.01,0.906,0.9790755777638975,3216,3188
6,6504,10,100,1e-05,0.01,0.92,0.9781672816728167,3267,3237
6,6604,10,100,1e-05,0.01,0.886,0.9668382798304058,3319,3285
6,6704,10,100,1e-05,0.01,0.904,0.9873210023866349,3369,3335
6,6804,10,100,1e-05,0.01,0.884,0.9600235155790712,3417,3387
6,6904,10,100,1e-05,0.01,0.914,0.9759559675550405,3471,3433
6,7004,10,100,1e-05,0.01,0.93,0.9840091376356368,3526,3478
6,7104,10,100,1e-05,0.01,0.938,0.9912725225225225,3572,3532
6,7204,10,100,1e-05,0.01,0.932,0.9837590227651305,3628,3576
6,7304,10,100,1e-05,0.01,0.932,0.9864457831325302,3674,3630
6,7404,10,100,1e-05,0.01,0.932,0.9912209616423555,3730,3674
6,7504,10,100,1e-05,0.01,0.93,0.9917377398720683,3779,3725
6,7604,10,100,1e-05,0.01,0.946,0.9902682798527092,3835,3769
6,7704,10,100,1e-05,0.01,0.936,0.9941588785046729,3885,3819
6,7804,10,100,1e-05,0.01,0.942,0.9905176832393644,3938,3866
6,7904,10,100,1e-05,0.01,0.934,0.9913967611336032,3984,3920
6,8004,10,100,1e-05,0.01,0.944,0.993503248375812,4036,3968
6,8104,10,100,1e-05,0.01,0.938,0.9898815399802566,4086,4018
6,8204,10,100,1e-05,0.01,0.91,0.9842759629449049,4138,4066
6,8304,10,100,1e-05,0.01,0.93,0.9845857418111753,4188,4116
6,8404,10,100,1e-05,0.01,0.944,0.9897667777248929,4237,4167
6,8504,10,100,1e-05,0.01,0.958,0.9918861712135466,4285,4219
6,8604,10,100,1e-05,0.01,0.95,0.9939562993956299,4336,4268
6,8704,10,100,1e-05,0.01,0.95,0.9914981617647058,4382,4322
6,8804,10,100,1e-05,0.01,0.944,0.9905724670604271,4433,4371
6,8904,10,100,1e-05,0.01,0.94,0.9845013477088949,4489,4415
6,9004,10,100,1e-05,0.01,0.95,0.9893380719680143,4539,4465
6,9104,10,100,1e-05,0.01,0.956,0.9928602811950791,4586,4518
6,9204,10,100,1e-05,0.01,0.962,0.9871794871794872,4630,4574
6,9304,10,100,1e-05,0.01,0.93,0.9670034393809115,4687,4617
6,9404,10,100,1e-05,0.01,0.934,0.9852190557209698,4737,4667
6,9504,10,100,1e-05,0.01,0.952,0.9895833333333334,4800,4704
6,9604,10,100,1e-05,0.01,0.96,0.9936484798000833,4847,4757
6,9704,10,100,1e-05,0.01,0.962,0.9947444352844188,4892,4812
6,9804,10,100,1e-05,0.01,0.954,0.9923500611995104,4940,4864
6,9904,10,100,1e-05,0.01,0.968,0.9933360258481422,4990,4914
6,10004,10,100,1e-05,0.01,0.932,0.9591163534586166,5041,4963
6,10104,10,100,1e-05,0.01,0.956,0.9750593824228029,5088,5016
6,10204,10,100,1e-05,0.01,0.962,0.9861818894551156,5132,5072
6,10304,10,100,1e-05,0.01,0.962,0.9913625776397516,5177,5127
6,10404,10,100,1e-05,0.01,0.97,0.9920222991157247,5218,5186
6,10504,10,100,1e-05,0.01,0.974,0.994002284843869,5269,5235
6,10604,10,100,1e-05,0.01,0.968,0.9949075820445115,5317,5287
6,10704,10,100,1e-05,0.01,0.972,0.9953288490284006,5362,5342
6,10804,10,100,1e-05,0.01,0.964,0.990836727138097,5412,5392
6,10904,10,100,1e-05,0.01,0.956,0.9930300807043286,5459,5445
6,11004,10,100,1e-05,0.01,0.958,0.9950018175209014,5504,5500
6,11104,10,100,1e-05,0.01,0.962,0.9938760806916427,5552,5552
6,11204,10,100,1e-05,0.01,0.968,0.993930739021778,5608,5596
6,11304,10,100,1e-05,0.01,0.968,0.9892958244869073,5651,5653
6,11404,10,100,1e-05,0.01,0.96,0.9834268677656962,5702,5702
6,11504,10,100,1e-05,0.01,0.972,0.9905250347705146,5751,5753
6,11604,10,100,1e-05,0.01,0.976,0.9943123061013444,5798,5806
6,11704,10,100,1e-05,0.01,0.984,0.9956425153793574,5846,5858
6,11804,10,100,1e-05,0.01,0.976,0.9963571670620128,5899,5905
6,11904,10,100,1e-05,0.01,0.976,0.996051747311828,5952,5952
6,12004,10,100,1e-05,0.01,0.972,0.9952515828057314,5997,6007
6,12104,10,100,1e-05,0.01,0.966,0.9903337739590218,6048,6056
6,12204,10,100,1e-05,0.01,0.96,0.984267453294002,6102,6102
6,12304,10,100,1e-05,0.01,0.956,0.9862646293888166,6142,6162
6,12404,10,100,1e-05,0.01,0.97,0.9896001289906482,6196,6208
6,12504,10,100,1e-05,0.01,0.972,0.9893634037108126,6246,6258
6,12604,10,100,1e-05,0.01,0.974,0.9923833703586163,6298,6306
6,12704,10,100,1e-05,0.01,0.982,0.9933879093198993,6342,6362
6,12804,10,100,1e-05,0.01,0.984,0.9949234614183068,6395,6409
6,12904,10,100,1e-05,0.01,0.976,0.9935678859268444,6447,6457
6,13004,10,100,1e-05,0.01,0.974,0.9937711473392802,6499,6505
6,13104,10,100,1e-05,0.01,0.978,0.9945054945054945,6540,6564
6,13204,10,100,1e-05,0.01,0.95,0.98401999394123,6595,6609
6,13304,10,100,1e-05,0.01,0.97,0.9902285027059531,6645,6659
6,13404,10,100,1e-05,0.01,0.976,0.9928379588182632,6693,6711
6,13504,10,100,1e-05,0.01,0.974,0.9934093601895735,6742,6762
6,13604,10,100,1e-05,0.01,0.972,0.9910320493972361,6791,6813
6,13704,10,100,1e-05,0.01,0.964,0.9926298890834793,6837,6867
6,13804,10,100,1e-05,0.01,0.976,0.9921761808171544,6891,6913
6,13904,10,100,1e-05,0.01,0.97,0.9878452243958573,6939,6965
6,14004,10,100,1e-05,0.01,0.986,0.992787774921451,6992,7012
6,14104,10,100,1e-05,0.01,0.984,0.9933352240499149,7044,7060
6,14204,10,100,1e-05,0.01,0.986,0.9959166431990989,7090,7114
6,14304,10,100,1e-05,0.01,0.984,0.9970637583892618,7141,7163
6,14404,10,100,1e-05,0.01,0.98,0.9947236878644821,7188,7216
6,14504,10,100,1e-05,0.01,0.978,0.9959321566464424,7238,7266
6,14604,10,100,1e-05,0.01,0.966,0.9893864694604217,7291,7313
6,14704,10,100,1e-05,0.01,0.976,0.9925190424374319,7344,7360
6,14804,10,100,1e-05,0.01,0.976,0.9936503647662794,7396,7408
6,14904,10,100,1e-05,0.01,0.974,0.9932232957595276,7448,7456
6,15004,10,100,1e-05,0.01,0.986,0.9943348440415889,7500,7504
7,104,10,100,1e-05,0.01,0.528,0.46153846153846156,56,48
7,204,10,100,1e-05,0.01,0.488,0.6715686274509803,114,90
7,304,10,100,1e-05,0.01,0.468,0.6710526315789473,164,140
7,404,10,100,1e-05,0.01,0.502,0.6237623762376238,198,206
7,504,10,100,1e-05,0.01,0.478,0.6349206349206349,236,268
7,604,10,100,1e-05,0.01,0.48,0.6341059602649006,278,326
7,704,10,100,1e-05,0.01,0.438,0.6420454545454546,329,375
7,804,10,100,1e-05,0.01,0.476,0.6616915422885572,372,432
7,904,10,100,1e-05,0.01,0.436,0.6792035398230089,418,486
7,1004,10,100,1e-05,0.01,0.46,0.7081673306772909,468,536
7,1104,10,100,1e-05,0.01,0.484,0.7056159420289855,517,587
7,1204,10,100,1e-05,0.01,0.494,0.7425249169435216,570,634
7,1304,10,100,1e-05,0.01,0.496,0.7515337423312883,628,676
7,1404,10,100,1e-05,0.01,0.526,0.7564102564102564,682,722
7,1504,10,100,1e-05,0.01,0.502,0.776595744680851,733,771
7,1604,10,100,1e-05,0.01,0.506,0.7855361596009975,782,822
7,1704,10,100,1e-05,0.01,0.504,0.8034037558685446,832,872
7,1804,10,100,1e-05,0.01,0.544,0.8159645232815964,885,919
7,1904,10,100,1e-05,0.01,0.526,0.8114495798319328,943,961
7,2004,10,100,1e-05,0.01,0.516,0.8383233532934131,989,1015
7,2104,10,100,1e-05,0.01,0.532,0.8032319391634981,1035,1069
7,2204,10,100,1e-05,0.01,0.53,0.8421052631578947,1081,1123
7,2304,10,100,1e-05,0.01,0.542,0.8259548611111112,1132,1172
7,2404,10,100,1e-05,0.01,0.546,0.8282029950083195,1185,1219
7,2504,10,100,1e-05,0.01,0.536,0.8242811501597445,1231,1273
7,2604,10,100,1e-05,0.01,0.57,0.857910906298003,1290,1314
7,2704,10,100,1e-05,0.01,0.618,0.8642751479289941,1329,1375
7,2804,10,100,1e-05,0.01,0.646,0.8905135520684736,1377,1427
7,2904,10,100,1e-05,0.01,0.638,0.8767217630853994,1418,1486
7,3004,10,100,1e-05,0.01,0.616,0.8605193075898802,1469,1535
7,3104,10,100,1e-05,0.01,0.664,0.8656572164948454,1514,1590
7,3204,10,100,1e-05,0.01,0.7,0.9048064918851436,1560,1644
7,3304,10,100,1e-05,0.01,0.696,0.8849878934624698,1614,1690
7,3404,10,100,1e-05,0.01,0.716,0.8974735605170387,1664,1740
7,3504,10,100,1e-05,0.01,0.716,0.9098173515981736,1715,1789
7,3604,10,100,1e-05,0.01,0.734,0.9170366259711432,1767,1837
7,3704,10,100,1e-05,0.01,0.762,0.9360151187904968,1817,1887
7,3804,10,100,1e-05,0.01,0.754,0.9355941114616193,1868,1936
7,3904,10,100,1e-05,0.01,0.742,0.9126536885245902,1919,1985
7,4004,10,100,1e-05,0.01,0.788,0.9310689310689311,1958,2046
7,4104,10,100,1e-05,0.01,0.774,0.9227582846003899,2019,2085
7,4204,10,100,1e-05,0.01,0.788,0.9391056137012369,2068,2136
7,4304,10,100,1e-05,0.01,0.804,0.9512081784386617,2112,2192
7,4404,10,100,1e-05,0.01,0.834,0.9509536784741145,2160,2244
7,4504,10,100,1e-05,0.01,0.814,0.9664742451154529,2220,2284
7,4604,10,100,1e-05,0.01,0.814,0.9543874891398784,2272,2332
7,4704,10,100,1e-05,0.01,0.806,0.90625,2319,2385
7,4804,10,100,1e-05,0.01,0.826,0.9344296419650291,2373,2431
7,4904,10,100,1e-05,0.01,0.806,0.9571778140293637,2417,2487
7,5004,10,100,1e-05,0.01,0.808,0.9426458832933653,2467,2537
7,5104,10,100,1e-05,0.01,0.842,0.9696316614420063,2508,2596
7,5204,10,100,1e-05,0.01,0.844,0.9761721752498078,2558,2646
7,5304,10,100,1e-05,0.01,0.84,0.976998491704374,2611,2693
7,5404,10,100,1e-05,0.01,0.834,0.9742783123612139,2658,2746
7,5504,10,100,1e-05,0.01,0.84,0.9771075581395349,2707,2797
7,5604,10,100,1e-05,0.01,0.848,0.9709136331192005,2759,2845
7,5704,10,100,1e-05,0.01,0.834,0.9733520336605891,2804,2900
7,5804,10,100,1e-05,0.01,0.828,0.9662301860785665,2852,2952
7,5904,10,100,1e-05,0.01,0.842,0.9662940379403794,2903,3001
7,6004,10,100,1e-05,0.01,0.834,0.9643570952698202,2951,3053
7,6104,10,100,1e-05,0.01,0.848,0.9649410222804718,3004,3100
7,6204,10,100,1e-05,0.01,0.848,0.960348162475822,3049,3155
7,6304,10,100,1e-05,0.01,0.862,0.9746192893401016,3096,3208
7,6404,10,100,1e-05,0.01,0.864,0.9664272329793879,3147,3257
7,6504,10,100,1e-05,0.01,0.862,0.9690959409594095,3193,3311
7,6604,10,100,1e-05,0.01,0.866,0.9742580254391278,3241,3363
7,6704,10,100,1e-05,0.01,0.88,0.9737470167064439,3295,3409
7,6804,10,100,1e-05,0.01,0.858,0.9623750734861846,3343,3461
7,6904,10,100,1e-05,0.01,0.884,0.9708864426419467,3391,3513
7,7004,10,100,1e-05,0.01,0.888,0.9635922330097088,3443,3561
7,7104,10,100,1e-05,0.01,0.882,0.9786036036036037,3490,3614
7,7204,10,100,1e-05,0.01,0.892,0.9708495280399778,3537,3667
7,7304,10,100,1e-05,0.01,0.884,0.9757667031763417,3588,3716
7,7404,10,100,1e-05,0.01,0.85,0.9670448406266883,3637,3767
7,7504,10,100,1e-05,0.01,0.878,0.980410447761194,3695,3809
7,7604,10,100,1e-05,0.01,0.876,0.9711993687532877,3743,3861
7,7704,10,100,1e-05,0.01,0.9,0.980269989615784,3792,3912
7,7804,10,100,1e-05,0.01,0.892,0.980138390568939,3836,3968
7,7904,10,100,1e-05,0.01,0.898,0.9644483805668016,3884,4020
7,8004,10,100,1e-05,0.01,0.88,0.9622688655672164,3930,4074
7,8104,10,100,1e-05,0.01,0.874,0.9445952615992103,3968,4136
7,8204,10,100,1e-05,0.01,0.9,0.962091662603608,4020,4184
7,8304,10,100,1e-05,0.01,0.904,0.9662813102119461,4080,4224
7,8404,10,100,1e-05,0.01,0.908,0.9760828177058544,4134,4270
7,8504,10,100,1e-05,0.01,0.896,0.9793038570084666,4178,4326
7,8604,10,100,1e-05,0.01,0.908,0.9840771734077174,4226,4378
7,8704,10,100,1e-05,0.01,0.916,0.9779411764705882,4278,4426
7,8804,10,100,1e-05,0.01,0.918,0.9791004089050431,4334,4470
7,8904,10,100,1e-05,0.01,0.904,0.9848382749326146,4385,4519
7,9004,10,100,1e-05,0.01,0.916,0.9852287872056864,4440,4564
7,9104,10,100,1e-05,0.01,0.906,0.9860500878734623,4491,4613
7,9204,10,100,1e-05,0.01,0.918,0.9846805736636245,4539,4665
7,9304,10,100,1e-05,0.01,0.894,0.9812983662940671,4593,4711
7,9404,10,100,1e-05,0.01,0.916,0.9761803487877498,4646,4758
7,9504,10,100,1e-05,0.01,0.92,0.9783249158249159,4700,4804
7,9604,10,100,1e-05,0.01,0.922,0.9777176176593086,4758,4846
7,9704,10,100,1e-05,0.01,0.912,0.9842333058532564,4814,4890
7,9804,10,100,1e-05,0.01,0.89,0.9694002447980417,4852,4952
7,9904,10,100,1e-05,0.01,0.926,0.9775848142164781,4902,5002
7,10004,10,100,1e-05,0.01,0.908,0.9835065973610556,4953,5051
7,10104,10,100,1e-05,0.01,0.932,0.9920823436262867,5005,5099
7,10204,10,100,1e-05,0.01,0.912,0.986671893375147,5055,5149
7,10304,10,100,1e-05,0.01,0.922,0.9872864906832298,5107,5197
7,10404,10,100,1e-05,0.01,0.936,0.9846212995001923,5164,5240
7,10504,10,100,1e-05,0.01,0.942,0.9841012947448591,5213,5291
7,10604,10,100,1e-05,0.01,0.936,0.9831195775179178,5265,5339
7,10704,10,100,1e-05,0.01,0.91,0.9739349775784754,5315,5389
7,10804,10,100,1e-05,0.01,0.934,0.9809329877823029,5368,5436
7,10904,10,100,1e-05,0.01,0.94,0.983125458547322,5418,5486
7,11004,10,100,1e-05,0.01,0.932,0.9825517993456925,5467,5537
7,11104,10,100,1e-05,0.01,0.932,0.9846902017291066,5525,5579
7,11204,10,100,1e-05,0.01,0.924,0.9727775794359157,5575,5629
7,11304,10,100,1e-05,0.01,0.944,0.9612526539278131,5622,5682
7,11404,10,100,1e-05,0.01,0.936,0.9768502279901788,5667,5737
7,11504,10,100,1e-05,0.01,0.94,0.9880910987482615,5717,5787
7,11604,10,100,1e-05,0.01,0.958,0.9894863840055154,5765,5839
7,11704,10,100,1e-05,0.01,0.956,0.9943609022556391,5825,5879
7,11804,10,100,1e-05,0.01,0.954,0.993476787529651,5884,5920
7,11904,10,100,1e-05,0.01,0.952,0.9934475806451613,5931,5973
7,12004,10,100,1e-05,0.01,0.96,0.9908363878707097,5984,6020
7,12104,10,100,1e-05,0.01,0.938,0.979841374752148,6036,6068
7,12204,10,100,1e-05,0.01,0.956,0.9854965585054081,6092,6112
7,12304,10,100,1e-05,0.01,0.948,0.9846391417425228,6145,6159
7,12404,10,100,1e-05,0.01,0.964,0.9907287971622057,6195,6209
7,12504,10,100,1e-05,0.01,0.946,0.9892834293026231,6248,6256
7,12604,10,100,1e-05,0.01,0.95,0.9792922881624881,6296,6308
7,12704,10,100,1e-05,0.01,0.96,0.985044080604534,6340,6364
7,12804,10,100,1e-05,0.01,0.962,0.9905498281786942,6396,6408
7,12904,10,100,1e-05,0.01,0.97,0.9903905765654061,6449,6455
7,13004,10,100,1e-05,0.01,0.974,0.9911565672100892,6488,6516
7,13104,10,100,1e-05,0.01,0.95,0.9883241758241759,6539,6565
7,13204,10,100,1e-05,0.01,0.942,0.9781884277491669,6588,6616
7,13304,10,100,1e-05,0.01,0.968,0.9890258568851473,6634,6670
7,13404,10,100,1e-05,0.01,0.958,0.9777678304983587,6694,6710
7,13504,10,100,1e-05,0.01,0.956,0.9893364928909952,6746,6758
7,13604,10,100,1e-05,0.01,0.95,0.9876506909732432,6797,6807
7,13704,10,100,1e-05,0.01,0.966,0.9935785172212492,6850,6854
7,13804,10,100,1e-05,0.01,0.968,0.9926108374384236,6901,6903
7,13904,10,100,1e-05,0.01,0.974,0.9902186421173763,6961,6943
7,14004,10,100,1e-05,0.01,0.958,0.9847900599828621,7009,6995
7,14104,10,100,1e-05,0.01,0.98,0.9892229154849688,7059,7045
7,14204,10,100,1e-05,0.01,0.974,0.9949310053506054,7109,7095
7,14304,10,100,1e-05,0.01,0.976,0.993148769574944,7154,7150
7,14404,10,100,1e-05,0.01,0.982,0.9961121910580394,7198,7206
7,14504,10,100,1e-05,0.01,0.978,0.989726971869829,7256,7248
7,14604,10,100,1e-05,0.01,0.964,0.991029854834292,7310,7294
7,14704,10,100,1e-05,0.01,0.986,0.9965995647442872,7355,7349
7,14804,10,100,1e-05,0.01,0.968,0.9881788705755201,7414,7390
7,14904,10,100,1e-05,0.01,0.972,0.9790660225442834,7466,7438
7,15004,10,100,1e-05,0.01,0.964,0.984337509997334,7515,7489
8,104,10,100,1e-05,0.01,0.504,0.6346153846153846,48,56
8,204,10,100,1e-05,0.01,0.51,0.6029411764705882,92,112
8,304,10,100,1e-05,0.01,0.51,0.5756578947368421,140,164
8,404,10,100,1e-05,0.01,0.508,0.6435643564356436,184,220
8,504,10,100,1e-05,0.01,0.51,0.5654761904761905,228,276
8,604,10,100,1e-05,0.01,0.544,0.5993377483443708,272,332
8,704,10,100,1e-05,0.01,0.542,0.6107954545454546,317,387
8,804,10,100,1e-05,0.01,0.52,0.6654228855721394,366,438
8,904,10,100,1e-05,0.01,0.514,0.6769911504424779,415,489
8,1004,10,100,1e-05,0.01,0.498,0.6603585657370518,463,541
8,1104,10,100,1e-05,0.01,0.522,0.6802536231884058,512,592
8,1204,10,100,1e-05,0.01,0.51,0.6802325581395349,560,644
8,1304,10,100,1e-05,0.01,0.526,0.6986196319018405,619,685
8,1404,10,100,1e-05,0.01,0.522,0.7136752136752137,673,731
8,1504,10,100,1e-05,0.01,0.496,0.7087765957446809,723,781
8,1604,10,100,1e-05,0.01,0.532,0.7562344139650873,782,822
8,1704,10,100,1e-05,0.01,0.544,0.7406103286384976,832,872
8,1804,10,100,1e-05,0.01,0.572,0.7899113082039911,894,910
8,1904,10,100,1e-05,0.01,0.58,0.7741596638655462,948,956
8,2004,10,100,1e-05,0.01,0.592,0.7654690618762475,1001,1003
8,2104,10,100,1e-05,0.01,0.592,0.8041825095057035,1053,1051
8,2204,10,100,1e-05,0.01,0.596,0.8330308529945554,1101,1103
8,2304,10,100,1e-05,0.01,0.644,0.8532986111111112,1153,1151
8,2404,10,100,1e-05,0.01,0.676,0.8406821963394343,1198,1206
8,2504,10,100,1e-05,0.01,0.67,0.8710063897763578,1247,1257
8,2604,10,100,1e-05,0.01,0.676,0.8940092165898618,1293,1311
8,2704,10,100,1e-05,0.01,0.708,0.9075443786982249,1347,1357
8,2804,10,100,1e-05,0.01,0.716,0.9083452211126961,1393,1411
8,2904,10,100,1e-05,0.01,0.776,0.9459366391184573,1441,1463
8,3004,10,100,1e-05,0.01,0.732,0.9350865512649801,1495,1509
8,3104,10,100,1e-05,0.01,0.772,0.9371778350515464,1548,1556
8,3204,10,100,1e-05,0.01,0.732,0.9029338327091136,1585,1619
8,3304,10,100,1e-05,0.01,0.754,0.9207021791767555,1636,1668
8,3404,10,100,1e-05,0.01,0.77,0.9198002350176263,1670,1734
8,3504,10,100,1e-05,0.01,0.808,0.934931506849315,1718,1786
8,3604,10,100,1e-05,0.01,0.78,0.9375693673695893,1758,1846
8,3704,10,100,1e-05,0.01,0.772,0.9130669546436285,1807,1897
8,3804,10,100,1e-05,0.01,0.788,0.9369085173501577,1855,1949
8,3904,10,100,1e-05,0.01,0.824,0.9439036885245902,1900,2004
8,4004,10,100,1e-05,0.01,0.834,0.954045954045954,1953,2051
8,4104,10,100,1e-05,0.01,0.824,0.9617446393762183,2001,2103
8,4204,10,100,1e-05,0.01,0.838,0.9607516650808754,2059,2145
8,4304,10,100,1e-05,0.01,0.834,0.9544609665427509,2112,2192
8,4404,10,100,1e-05,0.01,0.844,0.9495912806539509,2166,2238
8,4504,10,100,1e-05,0.01,0.874,0.9660301953818827,2218,2286
8,4604,10,100,1e-05,0.01,0.862,0.9548218940052129,2264,2340
8,4704,10,100,1e-05,0.01,0.842,0.9315476190476191,2322,2382
8,4804,10,100,1e-05,0.01,0.886,0.9579517069109076,2365,2439
8,4904,10,100,1e-05,0.01,0.878,0.9675774877650897,2417,2487
8,5004,10,100,1e-05,0.01,0.88,0.9718225419664268,2477,2527
8,5104,10,100,1e-05,0.01,0.86,0.9467084639498433,2537,2567
8,5204,10,100,1e-05,0.01,0.896,0.9755956956187548,2589,2615
8,5304,10,100,1e-05,0.01,0.906,0.9813348416289592,2637,2667
8,5404,10,100,1e-05,0.01,0.906,0.9744633604737232,2689,2715
8,5504,10,100,1e-05,0.01,0.908,0.9836482558139535,2753,2751
8,5604,10,100,1e-05,0.01,0.876,0.9295146324054246,2804,2800
8,5704,10,100,1e-05,0.01,0.862,0.9144460028050491,2864,2840
8,5804,10,100,1e-05,0.01,0.882,0.9407305306685044,2909,2895
8,5904,10,100,1e-05,0.01,0.896,0.9478319783197832,2960,2944
8,6004,10,100,1e-05,0.01,0.91,0.9605263157894737,3010,2994
8,6104,10,100,1e-05,0.01,0.914,0.9577326343381389,3065,3039
8,6204,10,100,1e-05,0.01,0.926,0.9713088330109607,3117,3087
8,6304,10,100,1e-05,0.01,0.932,0.9733502538071066,3166,3138
8,6404,10,100,1e-05,0.01,0.944,0.9820424734540912,3213,3191
8,6504,10,100,1e-05,0.01,0.94,0.9800123001230012,3259,3245
8,6604,10,100,1e-05,0.01,0.946,0.9836462749848577,3311,3293
8,6704,10,100,1e-05,0.01,0.948,0.9858293556085919,3359,3345
8,6804,10,100,1e-05,0.01,0.938,0.9742798353909465,3411,3393
8,6904,10,100,1e-05,0.01,0.938,0.9846465816917729,3449,3455
8,7004,10,100,1e-05,0.01,0.934,0.9845802398629354,3493,3511
8,7104,10,100,1e-05,0.01,0.934,0.9766328828828829,3543,3561
8,7204,10,100,1e-05,0.01,0.94,0.9859800111049417,3585,3619
8,7304,10,100,1e-05,0.01,0.948,0.9793263964950711,3633,3671
8,7404,10,100,1e-05,0.01,0.94,0.9804159913560238,3679,3725
8,7504,10,100,1e-05,0.01,0.958,0.9866737739872068,3733,3771
8,7604,10,100,1e-05,0.01,0.946,0.9809310889005787,3783,3821
8,7704,10,100,1e-05,0.01,0.942,0.9863707165109035,3832,3872
8,7804,10,100,1e-05,0.01,0.948,0.9898769861609431,3888,3916
8,7904,10,100,1e-05,0.01,0.952,0.9893724696356275,3939,3965
8,8004,10,100,1e-05,0.01,0.944,0.978135932033983,3992,4012
8,8104,10,100,1e-05,0.01,0.956,0.9871668311944719,4037,4067
8,8204,10,100,1e-05,0.01,0.952,0.9903705509507558,4091,4113
8,8304,10,100,1e-05,0.01,0.956,0.9880780346820809,4141,4163
8,8404,10,100,1e-05,0.01,0.94,0.9790575916230366,4195,4209
8,8504,10,100,1e-05,0.01,0.96,0.992826904985889,4238,4266
8,8604,10,100,1e-05,0.01,0.95,0.9905857740585774,4281,4323
8,8704,10,100,1e-05,0.01,0.946,0.9839154411764706,4329,4375
8,8804,10,100,1e-05,0.01,0.956,0.9837573830077238,4374,4430
8,8904,10,100,1e-05,0.01,0.938,0.9819182389937107,4424,4480
8,9004,10,100,1e-05,0.01,0.95,0.9870057752110173,4467,4537
8,9104,10,100,1e-05,0.01,0.952,0.9793497363796133,4525,4579
8,9204,10,100,1e-05,0.01,0.942,0.9851151673185572,4572,4632
8,9304,10,100,1e-05,0.01,0.962,0.9917239896818573,4630,4674
8,9404,10,100,1e-05,0.01,0.96,0.987239472564866,4681,4723
8,9504,10,100,1e-05,0.01,0.952,0.9873737373737373,4741,4763
8,9604,10,100,1e-05,0.01,0.948,0.9874010828821325,4792,4812
8,9704,10,100,1e-05,0.01,0.956,0.9863973619126134,4851,4853
8,9804,10,100,1e-05,0.01,0.97,0.992452060383517,4911,4893
8,9904,10,100,1e-05,0.01,0.97,0.9906098546042004,4958,4946
8,10004,10,100,1e-05,0.01,0.912,0.9332267093162735,5015,4989
8,10104,10,100,1e-05,0.01,0.948,0.9667458432304038,5054,5050
8,10204,10,100,1e-05,0.01,0.964,0.9766758134065072,5107,5097
8,10304,10,100,1e-05,0.01,0.964,0.9856366459627329,5159,5145
8,10404,10,100,1e-05,0.01,0.954,0.9874086889657824,5223,5181
8,10504,10,100,1e-05,0.01,0.97,0.9904798172124905,5280,5224
8,10604,10,100,1e-05,0.01,0.956,0.9897208600528102,5326,5278
8,10704,10,100,1e-05,0.01,0.97,0.9893497757847534,5372,5332
8,10804,10,100,1e-05,0.01,0.97,0.9895409107737875,5426,5378
8,10904,10,100,1e-05,0.01,0.966,0.9867938371239912,5480,5424
8,11004,10,100,1e-05,0.01,0.97,0.9920937840785169,5534,5470
8,11104,10,100,1e-05,0.01,0.968,0.9929755043227666,5586,5518
8,11204,10,100,1e-05,0.01,0.972,0.9922349161013924,5627,5577
8,11304,10,100,1e-05,0.01,0.964,0.9928343949044586,5682,5622
8,11404,10,100,1e-05,0.01,0.96,0.9912311469659768,5738,5666
8,11504,10,100,1e-05,0.01,0.974,0.9930458970792768,5788,5716
8,11604,10,100,1e-05,0.01,0.97,0.9906066873491899,5833,5771
8,11704,10,100,1e-05,0.01,0.964,0.9905160628844839,5889,5815
8,11804,10,100,1e-05,0.01,0.97,0.9902575398170111,5943,5861
8,11904,10,100,1e-05,0.01,0.976,0.9921875,5988,5916
8,12004,10,100,1e-05,0.01,0.942,0.9763412195934689,6039,5965
8,12104,10,100,1e-05,0.01,0.956,0.9843027098479842,6085,6019
8,12204,10,100,1e-05,0.01,0.95,0.9821370042608981,6134,6070
8,12304,10,100,1e-05,0.01,0.96,0.9904908972691807,6183,6121
8,12404,10,100,1e-05,0.01,0.976,0.9940341825217671,6229,6175
8,12504,10,100,1e-05,0.01,0.964,0.9905630198336532,6269,6235
8,12604,10,100,1e-05,0.01,0.968,0.993732148524278,6324,6280
8,12704,10,100,1e-05,0.01,0.966,0.9902392947103275,6365,6339
8,12804,10,100,1e-05,0.01,0.972,0.988987816307404,6410,6394
8,12904,10,100,1e-05,0.01,0.966,0.9881432114073155,6464,6440
8,13004,10,100,1e-05,0.01,0.966,0.9906951707167025,6512,6492
8,13104,10,100,1e-05,0.01,0.97,0.9916056166056166,6558,6546
8,13204,10,100,1e-05,0.01,0.962,0.9869736443501969,6605,6599
8,13304,10,100,1e-05,0.01,0.972,0.990829825616356,6655,6649
8,13404,10,100,1e-05,0.01,0.968,0.9906744255446136,6704,6700
8,13504,10,100,1e-05,0.01,0.972,0.9914099526066351,6753,6751
8,13604,10,100,1e-05,0.01,0.962,0.9885327844751544,6810,6794
8,13704,10,100,1e-05,0.01,0.956,0.9857705779334501,6865,6839
8,13804,10,100,1e-05,0.01,0.972,0.988988698927847,6914,6890
8,13904,10,100,1e-05,0.01,0.964,0.9877733026467204,6964,6940
8,14004,10,100,1e-05,0.01,0.972,0.9882176520994002,7008,6996
8,14104,10,100,1e-05,0.01,0.972,0.992484401588202,7058,7046
8,14204,10,100,1e-05,0.01,0.974,0.9934525485778654,7104,7100
8,14304,10,100,1e-05,0.01,0.972,0.9936381431767338,7151,7153
8,14404,10,100,1e-05,0.01,0.97,0.9914607053596223,7195,7209
8,14504,10,100,1e-05,0.01,0.97,0.9895201323772752,7250,7254
8,14604,10,100,1e-05,0.01,0.972,0.9925362914270063,7306,7298
8,14704,10,100,1e-05,0.01,0.98,0.9936751904243744,7355,7349
8,14804,10,100,1e-05,0.01,0.974,0.9944609564982437,7402,7402
8,14904,10,100,1e-05,0.01,0.978,0.9946323134728932,7447,7457
8,15004,10,100,1e-05,0.01,0.972,0.9944014929352173,7503,7501
9,104,10,100,1e-05,0.01,0.506,0.5384615384615384,55,49
9,204,10,100,1e-05,0.01,0.488,0.5980392156862745,107,97
9,304,10,100,1e-05,0.01,0.476,0.6019736842105263,156,148
9,404,10,100,1e-05,0.01,0.48,0.6336633663366337,211,193
9,504,10,100,1e-05,0.01,0.516,0.6190476190476191,257,247
9,604,10,100,1e-05,0.01,0.522,0.6605960264900662,297,307
9,704,10,100,1e-05,0.01,0.512,0.6789772727272727,346,358
9,804,10,100,1e-05,0.01,0.514,0.6766169154228856,397,407
9,904,10,100,1e-05,0.01,0.486,0.6692477876106194,450,454
9,1004,10,100,1e-05,0.01,0.462,0.6952191235059761,496,508
9,1104,10,100,1e-05,0.01,0.46,0.6757246376811594,554,550
9,1204,10,100,1e-05,0.01,0.48,0.696843853820598,610,594
9,1304,10,100,1e-05,0.01,0.502,0.7116564417177914,661,643
9,1404,10,100,1e-05,0.01,0.466,0.7129629629629629,719,685
9,1504,10,100,1e-05,0.01,0.478,0.7287234042553191,765,739
9,1604,10,100,1e-05,0.01,0.478,0.7244389027431422,811,793
9,1704,10,100,1e-05,0.01,0.51,0.7476525821596244,863,841
9,1804,10,100,1e-05,0.01,0.522,0.7350332594235033,924,880
9,1904,10,100,1e-05,0.01,0.496,0.7478991596638656,975,929
9,2004,10,100,1e-05,0.01,0.472,0.7435129740518962,1023,981
9,2104,10,100,1e-05,0.01,0.506,0.7366920152091255,1068,1036
9,2204,10,100,1e-05,0.01,0.51,0.7422867513611615,1113,1091
9,2304,10,100,1e-05,0.01,0.506,0.7482638888888888,1166,1138
9,2404,10,100,1e-05,0.01,0.522,0.7545757071547421,1221,1183
9,2504,10,100,1e-05,0.01,0.498,0.7695686900958466,1270,1234
9,2604,10,100,1e-05,0.01,0.506,0.7880184331797235,1315,1289
9,2704,10,100,1e-05,0.01,0.522,0.7821745562130178,1361,1343
9,2804,10,100,1e-05,0.01,0.502,0.7503566333808844,1403,1401
9,2904,10,100,1e-05,0.01,0.514,0.7768595041322314,1453,1451
9,3004,10,100,1e-05,0.01,0.508,0.7836218375499334,1503,1501
9,3104,10,100,1e-05,0.01,0.492,0.7564432989690721,1550,1554
9,3204,10,100,1e-05,0.01,0.512,0.7883895131086143,1595,1609
9,3304,10,100,1e-05,0.01,0.488,0.7826876513317191,1641,1663
9,3404,10,100,1e-05,0.01,0.514,0.799059929494712,1691,1713
9,3504,10,100,1e-05,0.01,0.526,0.8073630136986302,1739,1765
9,3604,10,100,1e-05,0.01,0.528,0.8138179800221975,1786,1818
9,3704,10,100,1e-05,0.01,0.544,0.7767278617710583,1840,1864
9,3804,10,100,1e-05,0.01,0.522,0.7941640378548895,1894,1910
9,3904,10,100,1e-05,0.01,0.516,0.7702356557377049,1943,1961
9,4004,10,100,1e-05,0.01,0.528,0.8031968031968032,2000,2004
9,4104,10,100,1e-05,0.01,0.5,0.7967836257309941,2052,2052
9,4204,10,100,1e-05,0.01,0.532,0.8163653663177926,2106,2098
9,4304,10,100,1e-05,0.01,0.536,0.7987918215613383,2153,2151
9,4404,10,100,1e-05,0.01,0.532,0.8099455040871935,2205,2199
9,4504,10,100,1e-05,0.01,0.522,0.8048401420959147,2248,2256
9,4604,10,100,1e-05,0.01,0.548,0.8129887054735013,2302,2302
9,4704,10,100,1e-05,0.01,0.538,0.8180272108843537,2351,2353
9,4804,10,100,1e-05,0.01,0.55,0.8343047460449625,2406,2398
9,4904,10,100,1e-05,0.01,0.55,0.8150489396411092,2455,2449
9,5004,10,100,1e-05,0.01,0.562,0.8255395683453237,2506,2498
9,5104,10,100,1e-05,0.01,0.554,0.8499216300940439,2565,2539
9,5204,10,100,1e-05,0.01,0.578,0.8489623366641046,2607,2597
9,5304,10,100,1e-05,0.01,0.588,0.8506787330316742,2662,2642
9,5404,10,100,1e-05,0.01,0.592,0.8567727609178386,2713,2691
9,5504,10,100,1e-05,0.01,0.604,0.8366642441860465,2760,2744
9,5604,10,100,1e-05,0.01,0.614,0.849214846538187,2822,2782
9,5704,10,100,1e-05,0.01,0.596,0.854312762973352,2879,2825
9,5804,10,100,1e-05,0.01,0.618,0.8824948311509304,2920,2884
9,5904,10,100,1e-05,0.01,0.578,0.8546747967479674,2967,2937
9,6004,10,100,1e-05,0.01,0.614,0.8652564956695536,3016,2988
9,6104,10,100,1e-05,0.01,0.608,0.8405963302752294,3070,3034
9,6204,10,100,1e-05,0.01,0.618,0.8676660219213411,3122,3082
9,6304,10,100,1e-05,0.01,0.624,0.8827728426395939,3171,3133
9,6404,10,100,1e-05,0.01,0.642,0.8672704559650218,3221,3183
9,6504,10,100,1e-05,0.01,0.618,0.8582410824108241,3274,3230
9,6604,10,100,1e-05,0.01,0.614,0.881435493640218,3323,3281
9,6704,10,100,1e-05,0.01,0.618,0.8532219570405728,3374,3330
9,6804,10,100,1e-05,0.01,0.626,0.8772780717225162,3427,3377
9,6904,10,100,1e-05,0.01,0.644,0.8822421784472769,3470,3434
9,7004,10,100,1e-05,0.01,0.648,0.886065105653912,3524,3480
9,7104,10,100,1e-05,0.01,0.646,0.8841497747747747,3569,3535
9,7204,10,100,1e-05,0.01,0.652,0.8904775124930594,3619,3585
9,7304,10,100,1e-05,0.01,0.622,0.8693866374589266,3663,3641
9,7404,10,100,1e-05,0.01,0.654,0.8799297676931388,3711,3693
9,7504,10,100,1e-05,0.01,0.65,0.8899253731343284,3759,3745
9,7604,10,100,1e-05,0.01,0.634,0.8921620199894792,3809,3795
9,7704,10,100,1e-05,0.01,0.668,0.8936915887850467,3861,3843
9,7804,10,100,1e-05,0.01,0.674,0.8990261404407995,3922,3882
9,7904,10,100,1e-05,0.01,0.676,0.9030870445344129,3979,3925
9,8004,10,100,1e-05,0.01,0.66,0.9031734132933533,4032,3972
9,8104,10,100,1e-05,0.01,0.66,0.8838845014807503,4074,4030
9,8204,10,100,1e-05,0.01,0.662,0.893466601657728,4134,4070
9,8304,10,100,1e-05,0.01,0.652,0.9047447013487476,4182,4122
9,8404,10,100,1e-05,0.01,0.66,0.904569252736792,4240,4164
9,8504,10,100,1e-05,0.01,0.654,0.9071025399811853,4289,4215
9,8604,10,100,1e-05,0.01,0.684,0.904463040446304,4339,4265
9,8704,10,100,1e-05,0.01,0.656,0.890625,4390,4314
9,8804,10,100,1e-05,0.01,0.668,0.8934575193094049,4427,4377
9,8904,10,100,1e-05,0.01,0.702,0.9042003593890386,4471,4433
9,9004,10,100,1e-05,0.01,0.696,0.9147045757441137,4524,4480
9,9104,10,100,1e-05,0.01,0.698,0.9126757469244289,4575,4529
9,9204,10,100,1e-05,0.01,0.692,0.9144936983920035,4636,4568
9,9304,10,100,1e-05,0.01,0.694,0.907566638005159,4693,4611
9,9404,10,100,1e-05,0.01,0.7,0.9165248830284985,4741,4663
9,9504,10,100,1e-05,0.01,0.7,0.8722643097643098,4786,4718
9,9604,10,100,1e-05,0.01,0.716,0.9022282382340692,4840,4764
9,9704,10,100,1e-05,0.01,0.716,0.9031327287716405,4895,4809
9,9804,10,100,1e-05,0.01,0.698,0.9052427580579355,4940,4864
9,9904,10,100,1e-05,0.01,0.71,0.9050888529886915,4982,4922
9,10004,10,100,1e-05,0.01,0.718,0.9091363454618153,5033,4971
9,10104,10,100,1e-05,0.01,0.7,0.9161718131433095,5086,5018
9,10204,10,100,1e-05,0.01,0.694,0.9208153665229322,5139,5065
9,10304,10,100,1e-05,0.01,0.71,0.9243012422360248,5198,5106
9,10404,10,100,1e-05,0.01,0.73,0.919838523644752,5244,5160
9,10504,10,100,1e-05,0.01,0.718,0.9127951256664127,5298,5206
9,10604,10,100,1e-05,0.01,0.712,0.9152206714447378,5353,5251
9,10704,10,100,1e-05,0.01,0.74,0.9112481315396114,5406,5298
9,10804,10,100,1e-05,0.01,0.734,0.9117919289152165,5460,5344
9,10904,10,100,1e-05,0.01,0.706,0.8714233308877476,5513,5391
9,11004,10,100,1e-05,0.01,0.724,0.8940385314431116,5567,5437
9,11104,10,100,1e-05,0.01,0.726,0.8984149855907781,5608,5496
9,11204,10,100,1e-05,0.01,0.724,0.8985183862906105,5643,5561
9,11304,10,100,1e-05,0.01,0.712,0.8872965322009908,5696,5608
9,11404,10,100,1e-05,0.01,0.734,0.8959137144861452,5743,5661
9,11504,10,100,1e-05,0.01,0.732,0.9182892906815021,5785,5719
9,11604,10,100,1e-05,0.01,0.746,0.917614615649776,5833,5771
9,11704,10,100,1e-05,0.01,0.714,0.911825017088175,5880,5824
9,11804,10,100,1e-05,0.01,0.726,0.9139274822094205,5924,5880
9,11904,10,100,1e-05,0.01,0.734,0.9283434139784946,5977,5927
9,12004,10,100,1e-05,0.01,0.73,0.9111129623458847,6028,5976
9,12104,10,100,1e-05,0.01,0.73,0.9214309319233311,6081,6023
9,12204,10,100,1e-05,0.01,0.76,0.9117502458210422,6130,6074
9,12304,10,100,1e-05,0.01,0.752,0.8988946684005201,6177,6127
9,12404,10,100,1e-05,0.01,0.75,0.9143824572718477,6222,6182
9,12504,10,100,1e-05,0.01,0.768,0.9187460012795905,6267,6237
9,12604,10,100,1e-05,0.01,0.762,0.9273246588384639,6321,6283
9,12704,10,100,1e-05,0.01,0.75,0.9201039042821159,6381,6323
9,12804,10,100,1e-05,0.01,0.77,0.9208059981255857,6428,6376
9,12904,10,100,1e-05,0.01,0.78,0.921264724116553,6478,6426
9,13004,10,100,1e-05,0.01,0.784,0.9262534604737004,6514,6490
9,13104,10,100,1e-05,0.01,0.752,0.9161324786324786,6554,6550
9,13204,10,100,1e-05,0.01,0.77,0.9245683126325356,6612,6592
9,13304,10,100,1e-05,0.01,0.774,0.9205502104630187,6658,6646
9,13404,10,100,1e-05,0.01,0.774,0.928379588182632,6701,6703
9,13504,10,100,1e-05,0.01,0.77,0.9376481042654028,6755,6749
9,13604,10,100,1e-05,0.01,0.762,0.9234048809173773,6807,6797
9,13704,10,100,1e-05,0.01,0.8,0.9366608289550497,6861,6843
9,13804,10,100,1e-05,0.01,0.768,0.9324108953926398,6911,6893
9,13904,10,100,1e-05,0.01,0.764,0.9133342922899885,6966,6938
9,14004,10,100,1e-05,0.01,0.774,0.9351613824621536,7017,6987
9,14104,10,100,1e-05,0.01,0.806,0.9177538287010777,7066,7038
9,14204,10,100,1e-05,0.01,0.744,0.903266685440721,7113,7091
9,14304,10,100,1e-05,0.01,0.796,0.9209312080536913,7160,7144
9,14404,10,100,1e-05,0.01,0.776,0.9332129963898917,7206,7198
9,14504,10,100,1e-05,0.01,0.808,0.9269856591285163,7254,7250
9,14604,10,100,1e-05,0.01,0.8,0.9301561216105176,7302,7302
9,14704,10,100,1e-05,0.01,0.794,0.9430767138193689,7354,7350
9,14804,10,100,1e-05,0.01,0.79,0.9301540124290733,7405,7399
9,14904,10,100,1e-05,0.01,0.81,0.9431696188942565,7451,7453
9,15004,10,100,1e-05,0.01,0.8,0.9333511063716342,7507,7497
10,104,10,100,1e-05,0.01,0.472,0.7596153846153846,39,65
10,204,10,100,1e-05,0.01,0.466,0.6813725490196079,93,111
10,304,10,100,1e-05,0.01,0.478,0.6644736842105263,148,156
10,404,10,100,1e-05,0.01,0.48,0.6336633663366337,197,207
10,504,10,100,1e-05,0.01,0.48,0.6428571428571429,253,251
10,604,10,100,1e-05,0.01,0.48,0.6605960264900662,303,301
10,704,10,100,1e-05,0.01,0.464,0.6690340909090909,360,344
10,804,10,100,1e-05,0.01,0.48,0.6927860696517413,411,393
10,904,10,100,1e-05,0.01,0.508,0.7013274336283186,453,451
10,1004,10,100,1e-05,0.01,0.496,0.6862549800796812,508,496
10,1104,10,100,1e-05,0.01,0.494,0.6902173913043478,554,550
10,1204,10,100,1e-05,0.01,0.52,0.6951827242524917,602,602
10,1304,10,100,1e-05,0.01,0.484,0.7292944785276073,650,654
10,1404,10,100,1e-05,0.01,0.51,0.6972934472934473,705,699
10,1504,10,100,1e-05,0.01,0.508,0.7513297872340425,758,746
10,1604,10,100,1e-05,0.01,0.5,0.6652119700748129,816,788
10,1704,10,100,1e-05,0.01,0.524,0.7640845070422535,872,832
10,1804,10,100,1e-05,0.01,0.526,0.8098669623059866,915,889
10,1904,10,100,1e-05,0.01,0.518,0.7904411764705882,975,929
10,2004,10,100,1e-05,0.01,0.542,0.8163672654690619,1022,982
10,2104,10,100,1e-05,0.01,0.544,0.7880228136882129,1070,1034
10,2204,10,100,1e-05,0.01,0.536,0.7994555353901996,1117,1087
10,2304,10,100,1e-05,0.01,0.566,0.8342013888888888,1169,1135
10,2404,10,100,1e-05,0.01,0.564,0.858153078202995,1209,1195
10,2504,10,100,1e-05,0.01,0.598,0.8366613418530351,1268,1236
10,2604,10,100,1e-05,0.01,0.574,0.8325652841781874,1322,1282
10,2704,10,100,1e-05,0.01,0.598,0.8106508875739645,1380,1324
10,2804,10,100,1e-05,0.01,0.6,0.8281027104136948,1425,1379
10,2904,10,100,1e-05,0.01,0.658,0.8174931129476584,1480,1424
10,3004,10,100,1e-05,0.01,0.662,0.8551930758988016,1531,1473
10,3104,10,100,1e-05,0.01,0.638,0.8672680412371134,1578,1526
10,3204,10,100,1e-05,0.01,0.662,0.8948189762796505,1636,1568
10,3304,10,100,1e-05,0.01,0.694,0.8813559322033898,1676,1628
10,3404,10,100,1e-05,0.01,0.674,0.9042303172737955,1729,1675
10,3504,10,100,1e-05,0.01,0.694,0.9155251141552512,1776,1728
10,3604,10,100,1e-05,0.01,0.72,0.9253607103218646,1822,1782
10,3704,10,100,1e-05,0.01,0.744,0.9260259179265659,1874,1830
10,3804,10,100,1e-05,0.01,0.732,0.9413774973711883,1927,1877
10,3904,10,100,1e-05,0.01,0.692,0.9344262295081968,1977,1927
10,4004,10,100,1e-05,0.01,0.712,0.9408091908091908,2034,1970
10,4104,10,100,1e-05,0.01,0.746,0.9351851851851852,2089,2015
10,4204,10,100,1e-05,0.01,0.728,0.922930542340628,2141,2063
10,4304,10,100,1e-05,0.01,0.75,0.9421468401486989,2188,2116
10,4404,10,100,1e-05,0.01,0.752,0.9439146230699365,2245,2159
10,4504,10,100,1e-05,0.01,0.756,0.9511545293072824,2300,2204
10,4604,10,100,1e-05,0.01,0.766,0.9609035621198957,2341,2263
10,4704,10,100,1e-05,0.01,0.744,0.9432397959183674,2400,2304
10,4804,10,100,1e-05,0.01,0.788,0.9612822647793505,2448,2356
10,4904,10,100,1e-05,0.01,0.758,0.939437194127243,2503,2401
10,5004,10,100,1e-05,0.01,0.754,0.9286570743405276,2558,2446
10,5104,10,100,1e-05,0.01,0.788,0.9547413793103449,2601,2503
10,5204,10,100,1e-05,0.01,0.77,0.9448501152959262,2648,2556
10,5304,10,100,1e-05,0.01,0.784,0.9375942684766214,2695,2609
10,5404,10,100,1e-05,0.01,0.802,0.9352331606217616,2735,2669
10,5504,10,100,1e-05,0.01,0.782,0.889171511627907,2787,2717
10,5604,10,100,1e-05,0.01,0.798,0.9236259814418273,2836,2768
10,5704,10,100,1e-05,0.01,0.762,0.8786816269284713,2887,2817
10,5804,10,100,1e-05,0.01,0.804,0.9169538249483115,2934,2870
10,5904,10,100,1e-05,0.01,0.8,0.9154810298102981,2986,2918
10,6004,10,100,1e-05,0.01,0.824,0.9200532978014657,3038,2966
10,6104,10,100,1e-05,0.01,0.81,0.9182503276539974,3077,3027
10,6204,10,100,1e-05,0.01,0.808,0.943745970341715,3127,3077
10,6304,10,100,1e-05,0.01,0.808,0.9527284263959391,3170,3134
10,6404,10,100,1e-05,0.01,0.858,0.9643972517176764,3224,3180
10,6504,10,100,1e-05,0.01,0.846,0.9618696186961869,3271,3233
10,6604,10,100,1e-05,0.01,0.862,0.9713809812235009,3323,3281
10,6704,10,100,1e-05,0.01,0.836,0.9647971360381862,3373,3331
10,6804,10,100,1e-05,0.01,0.862,0.96222810111699,3423,3381
10,6904,10,100,1e-05,0.01,0.816,0.9665411355735806,3474,3430
10,7004,10,100,1e-05,0.01,0.858,0.9690177041690463,3520,3484
10,7104,10,100,1e-05,0.01,0.822,0.9642454954954955,3571,3533
10,7204,10,100,1e-05,0.01,0.836,0.9437812326485286,3620,3584
10,7304,10,100,1e-05,0.01,0.794,0.8847207009857613,3671,3633
10,7404,10,100,1e-05,0.01,0.834,0.9219340896812533,3715,3689
10,7504,10,100,1e-05,0.01,0.85,0.9361673773987207,3765,3739
10,7604,10,100,1e-05,0.01,0.87,0.9512098895318254,3808,3796
10,7704,10,100,1e-05,0.01,0.842,0.9456126687435099,3865,3839
10,7804,10,100,1e-05,0.01,0.864,0.9488723731419785,3908,3896
10,7904,10,100,1e-05,0.01,0.85,0.9593876518218624,3945,3959
10,8004,10,100,1e-05,0.01,0.852,0.9687656171914043,3993,4011
10,8104,10,100,1e-05,0.01,0.866,0.9531095755182626,4045,4059
10,8204,10,100,1e-05,0.01,0.874,0.970014627011214,4087,4117
10,8304,10,100,1e-05,0.01,0.858,0.9725433526011561,4127,4177
10,8404,10,100,1e-05,0.01,0.886,0.9770347453593526,4178,4226
10,8504,10,100,1e-05,0.01,0.864,0.9793038570084666,4231,4273
10,8604,10,100,1e-05,0.01,0.86,0.955718270571827,4277,4327
10,8704,10,100,1e-05,0.01,0.872,0.9619715073529411,4337,4367
10,8804,10,100,1e-05,0.01,0.818,0.9299182189913675,4389,4415
10,8904,10,100,1e-05,0.01,0.854,0.9524932614555256,4432,4472
10,9004,10,100,1e-05,0.01,0.886,0.9609062638827188,4489,4515
10,9104,10,100,1e-05,0.01,0.888,0.9594683655536028,4543,4561
10,9204,10,100,1e-05,0.01,0.892,0.9650152107779226,4594,4610
10,9304,10,100,1e-05,0.01,0.896,0.9773215821152192,4651,4653
10,9404,10,100,1e-05,0.01,0.894,0.976286686516376,4703,4701
10,9504,10,100,1e-05,0.01,0.888,0.9815867003367004,4739,4765
10,9604,10,100,1e-05,0.01,0.884,0.9765722615576843,4787,4817
10,9704,10,100,1e-05,0.01,0.89,0.9808326463314098,4843,4861
10,9804,10,100,1e-05,0.01,0.904,0.9796001631986944,4892,4912
10,9904,10,100,1e-05,0.01,0.894,0.9813206785137318,4947,4957
10,10004,10,100,1e-05,0.01,0.9,0.9787085165933627,4994,5010
10,10104,10,100,1e-05,0.01,0.908,0.9839667458432304,5038,5066
10,10204,10,100,1e-05,0.01,0.916,0.9797138377107016,5091,5113
10,10304,10,100,1e-05,0.01,0.888,0.9778726708074534,5137,5167
10,10404,10,100,1e-05,0.01,0.912,0.9782775855440216,5185,5219
10,10504,10,100,1e-05,0.01,0.904,0.9525894897182026,5234,5270
10,10604,10,100,1e-05,0.01,0.91,0.9771784232365145,5278,5326
10,10704,10,100,1e-05,0.01,0.92,0.9793535127055306,5332,5372
10,10804,10,100,1e-05,0.01,0.924,0.9830618289522399,5384,5420
10,10904,10,100,1e-05,0.01,0.942,0.9889031548055759,5443,5461
10,11004,10,100,1e-05,0.01,0.884,0.9532897128316976,5495,5509
10,11104,10,100,1e-05,0.01,0.91,0.954971181556196,5547,5557
10,11204,10,100,1e-05,0.01,0.92,0.9843805783648697,5599,5605
10,11304,10,100,1e-05,0.01,0.916,0.9854918612880397,5646,5658
10,11404,10,100,1e-05,0.01,0.918,0.9894773763591722,5693,5711
10,11504,10,100,1e-05,0.01,0.924,0.9873956884561892,5747,5757
10,11604,10,100,1e-05,0.01,0.932,0.9864701826956221,5790,5814
10,11704,10,100,1e-05,0.01,0.93,0.9917122351332878,5839,5865
10,11804,10,100,1e-05,0.01,0.928,0.9800067773636055,5892,5912
10,11904,10,100,1e-05,0.01,0.936,0.9856350806451613,5939,5965
10,12004,10,100,1e-05,0.01,0.936,0.9841719426857715,5983,6021
10,12104,10,100,1e-05,0.01,0.934,0.9823198942498348,6036,6068
10,12204,10,100,1e-05,0.01,0.94,0.9872992461488037,6089,6115
10,12304,10,100,1e-05,0.01,0.934,0.9835825747724317,6131,6173
10,12404,10,100,1e-05,0.01,0.942,0.9888745565946468,6183,6221
10,12504,10,100,1e-05,0.01,0.94,0.9846449136276392,6230,6274
10,12604,10,100,1e-05,0.01,0.952,0.9862741986670898,6284,6320
10,12704,10,100,1e-05,0.01,0.944,0.9840994962216625,6337,6367
10,12804,10,100,1e-05,0.01,0.926,0.9749297094657919,6388,6416
10,12904,10,100,1e-05,0.01,0.94,0.9856633601983881,6437,6467
10,13004,10,100,1e-05,0.01,0.948,0.9908489695478314,6488,6516
10,13104,10,100,1e-05,0.01,0.94,0.9896978021978022,6533,6571
10,13204,10,100,1e-05,0.01,0.958,0.9901544986367767,6580,6624
10,13304,10,100,1e-05,0.01,0.96,0.996241731809982,6620,6684
10,13404,10,100,1e-05,0.01,0.954,0.9915696806923306,6661,6743
10,13504,10,100,1e-05,0.01,0.95,0.9911137440758294,6722,6782
10,13604,10,100,1e-05,0.01,0.93,0.9775801234930903,6768,6836
10,13704,10,100,1e-05,0.01,0.948,0.9908056042031523,6822,6882
10,13804,10,100,1e-05,0.01,0.948,0.9893509127789046,6873,6931
10,13904,10,100,1e-05,0.01,0.956,0.9910097813578826,6919,6985
10,14004,10,100,1e-05,0.01,0.952,0.9910739788631819,6979,7025
10,14104,10,100,1e-05,0.01,0.964,0.992484401588202,7029,7075
10,14204,10,100,1e-05,0.01,0.966,0.9895803998873557,7088,7116
10,14304,10,100,1e-05,0.01,0.944,0.9804250559284117,7134,7170
10,14404,10,100,1e-05,0.01,0.964,0.9879894473757289,7186,7218
10,14504,10,100,1e-05,0.01,0.95,0.9871759514616657,7243,7261
10,14604,10,100,1e-05,0.01,0.974,0.9937688304574089,7291,7313
10,14704,10,100,1e-05,0.01,0.966,0.9958514689880305,7342,7362
10,14804,10,100,1e-05,0.01,0.98,0.9964874358281546,7399,7405
10,14904,10,100,1e-05,0.01,0.978,0.9957729468599034,7448,7456
10,15004,10,100,1e-05,0.01,0.974,0.9921354305518528,7498,7506
11,104,10,100,1e-05,0.01,0.486,0.5096153846153846,53,51
11,204,10,100,1e-05,0.01,0.514,0.6568627450980392,104,100
11,304,10,100,1e-05,0.01,0.53,0.6348684210526315,161,143
11,404,10,100,1e-05,0.01,0.488,0.7103960396039604,213,191
11,504,10,100,1e-05,0.01,0.504,0.6329365079365079,265,239
11,604,10,100,1e-05,0.01,0.514,0.6605960264900662,310,294
11,704,10,100,1e-05,0.01,0.536,0.6306818181818182,364,340
11,804,10,100,1e-05,0.01,0.524,0.6529850746268657,414,390
11,904,10,100,1e-05,0.01,0.502,0.6227876106194691,468,436
11,1004,10,100,1e-05,0.01,0.5,0.649402390438247,523,481
11,1104,10,100,1e-05,0.01,0.516,0.6702898550724637,572,532
11,1204,10,100,1e-05,0.01,0.52,0.675249169435216,623,581
11,1304,10,100,1e-05,0.01,0.528,0.6771472392638037,677,627
11,1404,10,100,1e-05,0.01,0.534,0.7029914529914529,725,679
11,1504,10,100,1e-05,0.01,0.516,0.6675531914893617,787,717
11,1604,10,100,1e-05,0.01,0.5,0.6988778054862843,839,765
11,1704,10,100,1e-05,0.01,0.526,0.6713615023474179,891,813
11,1804,10,100,1e-05,0.01,0.516,0.6912416851441242,949,855
11,1904,10,100,1e-05,0.01,0.494,0.6932773109243697,994,910
11,2004,10,100,1e-05,0.01,0.53,0.7200598802395209,1033,971
11,2104,10,100,1e-05,0.01,0.514,0.7076996197718631,1088,1016
11,2204,10,100,1e-05,0.01,0.504,0.6810344827586207,1140,1064
11,2304,10,100,1e-05,0.01,0.51,0.7269965277777778,1193,1111
11,2404,10,100,1e-05,0.01,0.49,0.7483361064891847,1241,1163
11,2504,10,100,1e-05,0.01,0.498,0.740814696485623,1293,1211
11,2604,10,100,1e-05,0.01,0.516,0.7680491551459293,1339,1265
11,2704,10,100,1e-05,0.01,0.508,0.7577662721893491,1395,1309
11,2804,10,100,1e-05,0.01,0.494,0.7567760342368046,1445,1359
11,2904,10,100,1e-05,0.01,0.51,0.7834022038567493,1503,1401
11,3004,10,100,1e-05,0.01,0.532,0.7826231691078562,1555,1449
11,3104,10,100,1e-05,0.01,0.534,0.7464561855670103,1605,1499
11,3204,10,100,1e-05,0.01,0.576,0.7696629213483146,1656,1548
11,3304,10,100,1e-05,0.01,0.556,0.773910411622276,1706,1598
11,3404,10,100,1e-05,0.01,0.52,0.7905405405405406,1752,1652
11,3504,10,100,1e-05,0.01,0.536,0.7674086757990868,1796,1708
11,3604,10,100,1e-05,0.01,0.56,0.7869034406215316,1856,1748
11,3704,10,100,1e-05,0.01,0.524,0.8034557235421166,1903,1801
11,3804,10,100,1e-05,0.01,0.538,0.78732912723449,1951,1853
11,3904,10,100,1e-05,0.01,0.57,0.7996926229508197,1999,1905
11,4004,10,100,1e-05,0.01,0.52,0.7967032967032966,2051,1953
11,4104,10,100,1e-05,0.01,0.52,0.7982456140350878,2098,2006
11,4204,10,100,1e-05,0.01,0.54,0.8168411037107517,2153,2051
11,4304,10,100,1e-05,0.01,0.554,0.8350371747211895,2208,2096
11,4404,10,100,1e-05,0.01,0.538,0.8315168029064487,2265,2139
11,4504,10,100,1e-05,0.01,0.542,0.8448046181172292,2318,2186
11,4604,10,100,1e-05,0.01,0.528,0.8460034752389227,2361,2243
11,4704,10,100,1e-05,0.01,0.548,0.82546768707483,2416,2288
11,4804,10,100,1e-05,0.01,0.552,0.8149458784346378,2467,2337
11,4904,10,100,1e-05,0.01,0.526,0.8372756933115824,2528,2376
11,5004,10,100,1e-05,0.01,0.548,0.8245403677058354,2587,2417
11,5104,10,100,1e-05,0.01,0.524,0.83326802507837,2639,2465
11,5204,10,100,1e-05,0.01,0.56,0.846272098385857,2695,2509
11,5304,10,100,1e-05,0.01,0.576,0.8489819004524887,2742,2562
11,5404,10,100,1e-05,0.01,0.556,0.8480754996299038,2794,2610
11,5504,10,100,1e-05,0.01,0.568,0.8522892441860465,2851,2653
11,5604,10,100,1e-05,0.01,0.572,0.8458244111349036,2902,2702
11,5704,10,100,1e-05,0.01,0.556,0.8257363253856943,2950,2754
11,5804,10,100,1e-05,0.01,0.586,0.857512060647829,2996,2808
11,5904,10,100,1e-05,0.01,0.588,0.861619241192412,3047,2857
11,6004,10,100,1e-05,0.01,0.562,0.8524317121918721,3099,2905
11,6104,10,100,1e-05,0.01,0.584,0.8517365661861075,3150,2954
11,6204,10,100,1e-05,0.01,0.58,0.8368794326241135,3199,3005
11,6304,10,100,1e-05,0.01,0.582,0.8125,3253,3051
11,6404,10,100,1e-05,0.01,0.576,0.8282323547782636,3305,3099
11,6504,10,100,1e-05,0.01,0.582,0.8242619926199262,3354,3150
11,6604,10,100,1e-05,0.01,0.59,0.8461538461538461,3415,3189
11,6704,10,100,1e-05,0.01,0.6,0.8250298329355609,3462,3242
11,6804,10,100,1e-05,0.01,0.598,0.8465608465608465,3499,3305
11,6904,10,100,1e-05,0.01,0.628,0.8384994206257242,3551,3353
11,7004,10,100,1e-05,0.01,0.614,0.8462307252998287,3596,3408
11,7104,10,100,1e-05,0.01,0.608,0.8543074324324325,3644,3460
11,7204,10,100,1e-05,0.01,0.646,0.8602165463631316,3696,3508
11,7304,10,100,1e-05,0.01,0.6,0.8118838992332968,3748,3556
11,7404,10,100,1e-05,0.01,0.616,0.855213398163155,3796,3608
11,7504,10,100,1e-05,0.01,0.628,0.8587420042643923,3843,3661
11,7604,10,100,1e-05,0.01,0.63,0.8625723303524461,3889,3715
11,7704,10,100,1e-05,0.01,0.632,0.8647455867082036,3939,3765
11,7804,10,100,1e-05,0.01,0.654,0.8769861609431061,3996,3808
11,7904,10,100,1e-05,0.01,0.634,0.8806933198380567,4045,3859
11,8004,10,100,1e-05,0.01,0.624,0.8834332833583208,4093,3911
11,8104,10,100,1e-05,0.01,0.654,0.8863524185587365,4152,3952
11,8204,10,100,1e-05,0.01,0.628,0.8804241833252072,4205,3999
11,8304,10,100,1e-05,0.01,0.634,0.8829479768786127,4254,4050
11,8404,10,100,1e-05,0.01,0.632,0.8788672060923369,4301,4103
11,8504,10,100,1e-05,0.01,0.61,0.8225540921919097,4352,4152
11,8604,10,100,1e-05,0.01,0.63,0.8615760111576011,4411,4193
11,8704,10,100,1e-05,0.01,0.652,0.8527113970588235,4455,4249
11,8804,10,100,1e-05,0.01,0.632,0.8495002271694684,4498,4306
11,8904,10,100,1e-05,0.01,0.646,0.8497304582210242,4541,4363
11,9004,10,100,1e-05,0.01,0.67,0.8601732563305198,4589,4415
11,9104,10,100,1e-05,0.01,0.674,0.8730228471001757,4636,4468
11,9204,10,100,1e-05,0.01,0.67,0.8878748370273793,4691,4513
11,9304,10,100,1e-05,0.01,0.684,0.8835984522785899,4748,4556
11,9404,10,100,1e-05,0.01,0.69,0.8945129732028924,4794,4610
11,9504,10,100,1e-05,0.01,0.698,0.8953072390572391,4839,4665
11,9604,10,100,1e-05,0.01,0.67,0.9059766763848397,4884,4720
11,9704,10,100,1e-05,0.01,0.682,0.9038540807914263,4939,4765
11,9804,10,100,1e-05,0.01,0.698,0.901468788249694,4988,4816
11,9904,10,100,1e-05,0.01,0.688,0.909935379644588,5031,4873
11,10004,10,100,1e-05,0.01,0.692,0.8982407037185126,5084,4920
11,10104,10,100,1e-05,0.01,0.678,0.8833135391923991,5125,4979
11,10204,10,100,1e-05,0.01,0.694,0.9061152489219914,5173,5031
11,10304,10,100,1e-05,0.01,0.716,0.906541149068323,5224,5080
11,10404,10,100,1e-05,0.01,0.698,0.8907151095732411,5272,5132
11,10504,10,100,1e-05,0.01,0.688,0.8964204112718964,5316,5188
11,10604,10,100,1e-05,0.01,0.722,0.9064503960769521,5370,5234
11,10704,10,100,1e-05,0.01,0.722,0.914144245142003,5422,5282
11,10804,10,100,1e-05,0.01,0.708,0.910958904109589,5472,5332
11,10904,10,100,1e-05,0.01,0.7,0.9200293470286134,5522,5382
11,11004,10,100,1e-05,0.01,0.726,0.928117048346056,5579,5425
11,11104,10,100,1e-05,0.01,0.726,0.9282240634005764,5631,5473
11,11204,10,100,1e-05,0.01,0.698,0.9246697607997144,5682,5522
11,11304,10,100,1e-05,0.01,0.74,0.9321479122434536,5721,5583
11,11404,10,100,1e-05,0.01,0.708,0.9211680112241318,5766,5638
11,11504,10,100,1e-05,0.01,0.712,0.9268080667593881,5815,5689
11,11604,10,100,1e-05,0.01,0.72,0.938728024819028,5855,5749
11,11704,10,100,1e-05,0.01,0.746,0.942241968557758,5906,5798
11,11804,10,100,1e-05,0.01,0.72,0.9423924093527618,5956,5848
11,11904,10,100,1e-05,0.01,0.716,0.9415322580645161,6008,5896
11,12004,10,100,1e-05,0.01,0.742,0.9366877707430856,6051,5953
11,12104,10,100,1e-05,0.01,0.732,0.9379543952412426,6100,6004
11,12204,10,100,1e-05,0.01,0.76,0.9302687643395608,6146,6058
11,12304,10,100,1e-05,0.01,0.748,0.9474967490247074,6193,6111
11,12404,10,100,1e-05,0.01,0.75,0.9413092550790068,6239,6165
11,12504,10,100,1e-05,0.01,0.75,0.943937939859245,6289,6215
11,12604,10,100,1e-05,0.01,0.748,0.9288321167883211,6339,6265
11,12704,10,100,1e-05,0.01,0.762,0.9456076826196473,6389,6315
11,12804,10,100,1e-05,0.01,0.756,0.9465791940018744,6434,6370
11,12904,10,100,1e-05,0.01,0.784,0.9493180409175449,6480,6424
11,13004,10,100,1e-05,0.01,0.776,0.9413257459243309,6532,6472
11,13104,10,100,1e-05,0.01,0.774,0.9484126984126984,6582,6522
11,13204,10,100,1e-05,0.01,0.758,0.9407755225689185,6631,6573
11,13304,10,100,1e-05,0.01,0.796,0.9588093806374023,6676,6628
11,13404,10,100,1e-05,0.01,0.808,0.955162638018502,6729,6675
11,13504,10,100,1e-05,0.01,0.79,0.949422393364929,6778,6726
11,13604,10,100,1e-05,0.01,0.772,0.9569979417818288,6827,6777
11,13704,10,100,1e-05,0.01,0.772,0.9416958552247519,6874,6830
11,13804,10,100,1e-05,0.01,0.804,0.9518980005795422,6917,6887
11,13904,10,100,1e-05,0.01,0.764,0.945771001150748,6962,6942
11,14004,10,100,1e-05,0.01,0.802,0.9565124250214224,7018,6986
11,14104,10,100,1e-05,0.01,0.804,0.9619965967101531,7065,7039
11,14204,10,100,1e-05,0.01,0.792,0.9600112644325542,7107,7097
11,14304,10,100,1e-05,0.01,0.81,0.9497343400447428,7159,7145
11,14404,10,100,1e-05,0.01,0.814,0.9486253818383782,7216,7188
11,14504,10,100,1e-05,0.01,0.812,0.9493243243243243,7269,7235
11,14604,10,100,1e-05,0.01,0.814,0.9624075595727198,7311,7293
11,14704,10,100,1e-05,0.01,0.816,0.9581746463547334,7356,7348
11,14804,10,100,1e-05,0.01,0.81,0.9487976222642529,7403,7401
11,14904,10,100,1e-05,0.01,0.766,0.9216317767042405,7453,7451
11,15004,10,100,1e-05,0.01,0.798,0.9354172220741136,7509,7495
12,104,10,100,1e-05,0.01,0.522,0.5288461538461539,55,49
12,204,10,100,1e-05,0.01,0.506,0.6764705882352942,102,102
12,304,10,100,1e-05,0.01,0.48,0.506578947368421,153,151
12,404,10,100,1e-05,0.01,0.518,0.6064356435643564,206,198
12,504,10,100,1e-05,0.01,0.532,0.5297619047619048,258,246
12,604,10,100,1e-05,0.01,0.544,0.5894039735099338,316,288
12,704,10,100,1e-05,0.01,0.536,0.640625,363,341
12,804,10,100,1e-05,0.01,0.508,0.5895522388059702,420,384
12,904,10,100,1e-05,0.01,0.486,0.6084070796460177,477,427
12,1004,10,100,1e-05,0.01,0.55,0.6653386454183267,530,474
12,1104,10,100,1e-05,0.01,0.502,0.6784420289855072,579,525
12,1204,10,100,1e-05,0.01,0.508,0.686046511627907,626,578
12,1304,10,100,1e-05,0.01,0.526,0.683282208588957,669,635
12,1404,10,100,1e-05,0.01,0.518,0.6965811965811965,724,680
12,1504,10,100,1e-05,0.01,0.5,0.6968085106382979,775,729
12,1604,10,100,1e-05,0.01,0.508,0.7288029925187033,820,784
12,1704,10,100,1e-05,0.01,0.484,0.7282863849765259,873,831
12,1804,10,100,1e-05,0.01,0.504,0.7649667405764967,918,886
12,1904,10,100,1e-05,0.01,0.524,0.7689075630252101,971,933
12,2004,10,100,1e-05,0.01,0.548,0.7974051896207585,1019,985
12,2104,10,100,1e-05,0.01,0.518,0.8098859315589354,1063,1041
12,2204,10,100,1e-05,0.01,0.54,0.8248638838475499,1114,1090
12,2304,10,100,1e-05,0.01,0.518,0.8159722222222222,1172,1132
12,2404,10,100,1e-05,0.01,0.546,0.8261231281198004,1218,1186
12,2504,10,100,1e-05,0.01,0.548,0.8502396166134185,1265,1239
12,2604,10,100,1e-05,0.01,0.582,0.859062980030722,1314,1290
12,2704,10,100,1e-05,0.01,0.578,0.8502218934911243,1363,1341
12,2804,10,100,1e-05,0.01,0.62,0.8798145506419401,1409,1395
12,2904,10,100,1e-05,0.01,0.61,0.8684573002754821,1458,1446
12,3004,10,100,1e-05,0.01,0.604,0.8332223701731025,1503,1501
12,3104,10,100,1e-05,0.01,0.658,0.8872422680412371,1548,1556
12,3204,10,100,1e-05,0.01,0.654,0.9073033707865169,1602,1602
12,3304,10,100,1e-05,0.01,0.692,0.9013317191283293,1649,1655
12,3404,10,100,1e-05,0.01,0.708,0.9391891891891891,1697,1707
12,3504,10,100,1e-05,0.01,0.724,0.940068493150685,1744,1760
12,3604,10,100,1e-05,0.01,0.742,0.9508879023307436,1792,1812
12,3704,10,100,1e-05,0.01,0.794,0.9595032397408207,1836,1868
12,3804,10,100,1e-05,0.01,0.8,0.9647739221871714,1889,1915
12,3904,10,100,1e-05,0.01,0.812,0.975922131147541,1936,1968
12,4004,10,100,1e-05,0.01,0.824,0.9812687312687313,1982,2022
12,4104,10,100,1e-05,0.01,0.856,0.98635477582846,2027,2077
12,4204,10,100,1e-05,0.01,0.86,0.9793054234062797,2074,2130
12,4304,10,100,1e-05,0.01,0.842,0.9765334572490706,2118,2186
12,4404,10,100,1e-05,0.01,0.876,0.970708446866485,2175,2229
12,4504,10,100,1e-05,0.01,0.89,0.9842362344582594,2224,2280
12,4604,10,100,1e-05,0.01,0.88,0.9630755864465682,2279,2325
12,4704,10,100,1e-05,0.01,0.786,0.8735119047619048,2330,2374
12,4804,10,100,1e-05,0.01,0.888,0.9554537885095754,2376,2428
12,4904,10,100,1e-05,0.01,0.926,0.9759380097879282,2425,2479
12,5004,10,100,1e-05,0.01,0.916,0.9774180655475619,2474,2530
12,5104,10,100,1e-05,0.01,0.932,0.9911833855799373,2525,2579
12,5204,10,100,1e-05,0.01,0.94,0.9921214450422752,2576,2628
12,5304,10,100,1e-05,0.01,0.954,0.9950980392156863,2618,2686
12,5404,10,100,1e-05,0.01,0.954,0.9944485566247224,2669,2735
12,5504,10,100,1e-05,0.01,0.954,0.9967296511627907,2720,2784
12,5604,10,100,1e-05,0.01,0.954,0.9960742326909351,2766,2838
12,5704,10,100,1e-05,0.01,0.95,0.9968443197755961,2821,2883
12,5804,10,100,1e-05,0.01,0.954,0.9970709855272226,2864,2940
12,5904,10,100,1e-05,0.01,0.956,0.9974593495934959,2917,2987
12,6004,10,100,1e-05,0.01,0.954,0.9965023317788141,2963,3041
12,6104,10,100,1e-05,0.01,0.948,0.991480996068152,3017,3087
12,6204,10,100,1e-05,0.01,0.95,0.9937137330754352,3074,3130
12,6304,10,100,1e-05,0.01,0.96,0.9830266497461929,3133,3171
12,6404,10,100,1e-05,0.01,0.962,0.9910993129294191,3182,3222
12,6504,10,100,1e-05,0.01,0.952,0.9896986469864698,3236,3268
12,6604,10,100,1e-05,0.01,0.952,0.9918231374924288,3297,3307
12,6704,10,100,1e-05,0.01,0.962,0.9897076372315036,3346,3358
12,6804,10,100,1e-05,0.01,0.958,0.9950029394473839,3391,3413
12,6904,10,100,1e-05,0.01,0.964,0.9975376593279258,3439,3465
12,7004,10,100,1e-05,0.01,0.968,0.9970017133066819,3485,3519
12,7104,10,100,1e-05,0.01,0.97,0.9902871621621622,3537,3567
12,7204,10,100,1e-05,0.01,0.962,0.9904219877845641,3593,3611
12,7304,10,100,1e-05,0.01,0.976,0.9954819277108434,3647,3657
12,7404,10,100,1e-05,0.01,0.972,0.9948676391139925,3694,3710
12,7504,10,100,1e-05,0.01,0.964,0.9940031982942431,3751,3753
12,7604,10,100,1e-05,0.01,0.956,0.9892162019989479,3804,3800
12,7704,10,100,1e-05,0.01,0.974,0.995846313603323,3849,3855
12,7804,10,100,1e-05,0.01,0.97,0.9941055868785238,3901,3903
12,7904,10,100,1e-05,0.01,0.968,0.992661943319838,3955,3949
12,8004,10,100,1e-05,0.01,0.968,0.993128435782109,4003,4001
12,8104,10,100,1e-05,0.01,0.97,0.995187561697927,4063,4041
12,8204,10,100,1e-05,0.01,0.966,0.9932959531935641,4120,4084
12,8304,10,100,1e-05,0.01,0.972,0.9919315992292871,4163,4141
12,8404,10,100,1e-05,0.01,0.96,0.9789386006663494,4212,4192
12,8504,10,100,1e-05,0.01,0.956,0.9740122295390404,4256,4248
12,8604,10,100,1e-05,0.01,0.98,0.9879125987912599,4309,4295
12,8704,10,100,1e-05,0.01,0.976,0.9877068014705882,4364,4340
12,8804,10,100,1e-05,0.01,0.986,0.9942071785552021,4413,4391
12,8904,10,100,1e-05,0.01,0.984,0.9944968553459119,4462,4442
12,9004,10,100,1e-05,0.01,0.98,0.9951132829853399,4511,4493
12,9104,10,100,1e-05,0.01,0.984,0.9909929701230229,4558,4546
12,9204,10,100,1e-05,0.01,0.986,0.9935897435897436,4606,4598
12,9304,10,100,1e-05,0.01,0.978,0.99365864144454,4655,4649
12,9404,10,100,1e-05,0.01,0.986,0.9965971926839643,4711,4693
12,9504,10,100,1e-05,0.01,0.984,0.9969486531986532,4764,4740
12,9604,10,100,1e-05,0.01,0.988,0.9973969179508538,4820,4784
12,9704,10,100,1e-05,0.01,0.984,0.9974237427864798,4866,4838
12,9804,10,100,1e-05,0.01,0.982,0.9964300285597715,4909,4895
12,9904,10,100,1e-05,0.01,0.98,0.993235056542811,4963,4941
12,10004,10,100,1e-05,0.01,0.974,0.9914034386245502,5007,4997
12,10104,10,100,1e-05,0.01,0.98,0.9947545526524149,5062,5042
12,10204,10,100,1e-05,0.01,0.988,0.9934339474715798,5104,5100
12,10304,10,100,1e-05,0.01,0.986,0.9960209627329193,5160,5144
12,10404,10,100,1e-05,0.01,0.984,0.9983660130718954,5211,5193
12,10504,10,100,1e-05,0.01,0.986,0.9980959634424981,5253,5251
12,10604,10,100,1e-05,0.01,0.976,0.9934930215013202,5304,5300
12,10704,10,100,1e-05,0.01,0.98,0.9883221225710015,5357,5347
12,10804,10,100,1e-05,0.01,0.988,0.9939837097371343,5409,5395
12,10904,10,100,1e-05,0.01,0.99,0.9962399119589141,5455,5449
12,11004,10,100,1e-05,0.01,0.942,0.9681933842239185,5509,5495
12,11104,10,100,1e-05,0.01,0.984,0.9876621037463977,5552,5552
12,11204,10,100,1e-05,0.01,0.988,0.9933059621563727,5603,5601
12,11304,10,100,1e-05,0.01,0.986,0.995930644019816,5653,5651
12,11404,10,100,1e-05,0.01,0.982,0.9963170817257103,5694,5710
12,11504,10,100,1e-05,0.01,0.984,0.9970445062586927,5750,5754
12,11604,10,100,1e-05,0.01,0.988,0.9969837986901069,5795,5809
12,11704,10,100,1e-05,0.01,0.99,0.9962406015037594,5843,5861
12,11804,10,100,1e-05,0.01,0.988,0.9983903761436801,5896,5908
12,11904,10,100,1e-05,0.01,0.988,0.9971438172043011,5940,5964
12,12004,10,100,1e-05,0.01,0.988,0.9905031656114629,5979,6025
12,12104,10,100,1e-05,0.01,0.982,0.9930601454064772,6029,6075
12,12204,10,100,1e-05,0.01,0.988,0.9942641756801048,6071,6133
12,12304,10,100,1e-05,0.01,0.984,0.9926853055916776,6115,6189
12,12404,10,100,1e-05,0.01,0.986,0.994598516607546,6169,6235
12,12504,10,100,1e-05,0.01,0.99,0.997680742162508,6214,6290
12,12604,10,100,1e-05,0.01,0.98,0.995318946366233,6260,6344
12,12704,10,100,1e-05,0.01,0.978,0.9923646095717884,6306,6398
12,12804,10,100,1e-05,0.01,0.986,0.9953920649796938,6357,6447
12,12904,10,100,1e-05,0.01,0.992,0.9928704277743335,6407,6497
12,13004,10,100,1e-05,0.01,0.988,0.9982313134420179,6459,6545
12,13104,10,100,1e-05,0.01,0.99,0.9971764346764347,6508,6596
12,13204,10,100,1e-05,0.01,0.966,0.9747046349591033,6557,6647
12,13304,10,100,1e-05,0.01,0.986,0.9891761876127481,6610,6694
12,13404,10,100,1e-05,0.01,0.984,0.9940316323485526,6670,6734
12,13504,10,100,1e-05,0.01,0.994,0.996149289099526,6716,6788
12,13604,10,100,1e-05,0.01,0.99,0.9956630402822699,6769,6835
12,13704,10,100,1e-05,0.01,0.986,0.9934325744308231,6825,6879
12,13804,10,100,1e-05,0.01,0.984,0.9971747319617502,6875,6929
12,13904,10,100,1e-05,0.01,0.994,0.9969792865362486,6923,6981
12,14004,10,100,1e-05,0.01,0.992,0.9965009997143673,6968,7036
12,14104,10,100,1e-05,0.01,0.988,0.996242200794101,7015,7089
12,14204,10,100,1e-05,0.01,0.986,0.9956350323852436,7067,7137
12,14304,10,100,1e-05,0.01,0.992,0.9966442953020134,7130,7174
12,14404,10,100,1e-05,0.01,0.99,0.9959733407386837,7176,7228
12,14504,10,100,1e-05,0.01,0.98,0.997173193601765,7224,7280
12,14604,10,100,1e-05,0.01,0.994,0.9980827170638181,7277,7327
12,14704,10,100,1e-05,0.01,0.992,0.9980277475516867,7328,7376
12,14804,10,100,1e-05,0.01,0.988,0.9981086192920832,7385,7419
12,14904,10,100,1e-05,0.01,0.994,0.9971148684916801,7437,7467
12,15004,10,100,1e-05,0.01,0.978,0.9913356438283124,7491,7513
13,104,10,100,1e-05,0.01,0.482,0.5192307692307693,51,53
13,204,10,100,1e-05,0.01,0.524,0.5343137254901961,105,99
13,304,10,100,1e-05,0.01,0.514,0.5361842105263158,162,142
13,404,10,100,1e-05,0.01,0.48,0.6138613861386139,206,198
13,504,10,100,1e-05,0.01,0.47,0.5654761904761905,264,240
13,604,10,100,1e-05,0.01,0.488,0.6506622516556292,314,290
13,704,10,100,1e-05,0.01,0.502,0.6548295454545454,364,340
13,804,10,100,1e-05,0.01,0.482,0.6703980099502488,408,396
13,904,10,100,1e-05,0.01,0.484,0.6670353982300885,460,444
13,1004,10,100,1e-05,0.01,0.508,0.6922310756972112,513,491
13,1104,10,100,1e-05,0.01,0.512,0.6856884057971014,568,536
13,1204,10,100,1e-05,0.01,0.512,0.7300664451827242,622,582
13,1304,10,100,1e-05,0.01,0.502,0.7254601226993865,668,636
13,1404,10,100,1e-05,0.01,0.522,0.7250712250712251,708,696
13,1504,10,100,1e-05,0.01,0.504,0.7460106382978723,760,744
13,1604,10,100,1e-05,0.01,0.536,0.7780548628428927,813,791
13,1704,10,100,1e-05,0.01,0.516,0.7717136150234741,860,844
13,1804,10,100,1e-05,0.01,0.518,0.7921286031042128,908,896
13,1904,10,100,1e-05,0.01,0.54,0.7589285714285714,959,945
13,2004,10,100,1e-05,0.01,0.524,0.7639720558882236,1013,991
13,2104,10,100,1e-05,0.01,0.534,0.7756653992395437,1064,1040
13,2204,10,100,1e-05,0.01,0.532,0.7885662431941923,1124,1080
13,2304,10,100,1e-05,0.01,0.546,0.8003472222222222,1173,1131
13,2404,10,100,1e-05,0.01,0.554,0.8007487520798668,1219,1185
13,2504,10,100,1e-05,0.01,0.522,0.7863418530351438,1274,1230
13,2604,10,100,1e-05,0.01,0.528,0.7692012288786483,1316,1288
13,2704,10,100,1e-05,0.01,0.536,0.7540680473372781,1366,1338
13,2804,10,100,1e-05,0.01,0.534,0.7689015691868759,1413,1391
13,2904,10,100,1e-05,0.01,0.516,0.7837465564738292,1460,1444
13,3004,10,100,1e-05,0.01,0.528,0.7852862849533955,1516,1488
13,3104,10,100,1e-05,0.01,0.542,0.8150773195876289,1560,1544
13,3204,10,100,1e-05,0.01,0.534,0.8205368289637952,1615,1589
13,3304,10,100,1e-05,0.01,0.552,0.8389830508474576,1670,1634
13,3404,10,100,1e-05,0.01,0.544,0.8155111633372503,1723,1681
13,3504,10,100,1e-05,0.01,0.54,0.788527397260274,1783,1721
13,3604,10,100,1e-05,0.01,0.534,0.8251942286348501,1838,1766
13,3704,10,100,1e-05,0.01,0.516,0.8480021598272138,1882,1822
13,3804,10,100,1e-05,0.01,0.534,0.8362250262881178,1935,1869
13,3904,10,100,1e-05,0.01,0.528,0.8563012295081968,1985,1919
13,4004,10,100,1e-05,0.01,0.546,0.8638861138861139,2033,1971
13,4104,10,100,1e-05,0.01,0.554,0.8608674463937622,2085,2019
13,4204,10,100,1e-05,0.01,0.57,0.8613225499524263,2142,2062
13,4304,10,100,1e-05,0.01,0.568,0.8787174721189591,2189,2115
13,4404,10,100,1e-05,0.01,0.56,0.8830608537693007,2238,2166
13,4504,10,100,1e-05,0.01,0.55,0.8545737122557726,2286,2218
13,4604,10,100,1e-05,0.01,0.532,0.8290616854908774,2332,2272
13,4704,10,100,1e-05,0.01,0.542,0.7429846938775511,2388,2316
13,4804,10,100,1e-05,0.01,0.532,0.7812239800166528,2436,2368
13,4904,10,100,1e-05,0.01,0.528,0.781810766721044,2482,2422
13,5004,10,100,1e-05,0.01,0.558,0.8091526778577138,2524,2480
13,5104,10,100,1e-05,0.01,0.542,0.8191614420062696,2574,2530
13,5204,10,100,1e-05,0.01,0.572,0.8274404304381245,2626,2578
13,5304,10,100,1e-05,0.01,0.55,0.8580316742081447,2676,2628
13,5404,10,100,1e-05,0.01,0.56,0.862139156180607,2725,2679
13,5504,10,100,1e-05,0.01,0.59,0.8666424418604651,2775,2729
13,5604,10,100,1e-05,0.01,0.586,0.8709850107066381,2822,2782
13,5704,10,100,1e-05,0.01,0.576,0.8266129032258065,2867,2837
13,5804,10,100,1e-05,0.01,0.58,0.853893866299104,2918,2886
13,5904,10,100,1e-05,0.01,0.6,0.8545054200542005,2970,2934
13,6004,10,100,1e-05,0.01,0.6,0.879746835443038,3017,2987
13,6104,10,100,1e-05,0.01,0.596,0.8774574049803407,3070,3034
13,6204,10,100,1e-05,0.01,0.618,0.8884590586718246,3116,3088
13,6304,10,100,1e-05,0.01,0.638,0.8954631979695431,3169,3135
13,6404,10,100,1e-05,0.01,0.624,0.8761711430356027,3218,3186
13,6504,10,100,1e-05,0.01,0.63,0.8388683886838868,3264,3240
13,6604,10,100,1e-05,0.01,0.64,0.8658388855239249,3309,3295
13,6704,10,100,1e-05,0.01,0.644,0.8826073985680191,3354,3350
13,6804,10,100,1e-05,0.01,0.642,0.8909465020576132,3403,3401
13,6904,10,100,1e-05,0.01,0.668,0.889774044032445,3456,3448
13,7004,10,100,1e-05,0.01,0.632,0.8927755568246716,3508,3496
13,7104,10,100,1e-05,0.01,0.662,0.9082207207207207,3553,3551
13,7204,10,100,1e-05,0.01,0.664,0.8995002776235425,3607,3597
13,7304,10,100,1e-05,0.01,0.678,0.8681544359255202,3662,3642
13,7404,10,100,1e-05,0.01,0.664,0.8770934629929767,3717,3687
13,7504,10,100,1e-05,0.01,0.672,0.9016524520255863,3766,3738
13,7604,10,100,1e-05,0.01,0.672,0.8996580746975276,3818,3786
13,7704,10,100,1e-05,0.01,0.68,0.8999221183800623,3867,3837
13,7804,10,100,1e-05,0.01,0.668,0.9100461301896463,3922,3882
13,7904,10,100,1e-05,0.01,0.672,0.8743674089068826,3978,3926
13,8004,10,100,1e-05,0.01,0.692,0.8974262868565717,4027,3977
13,8104,10,100,1e-05,0.01,0.688,0.9047384007897334,4070,4034
13,8204,10,100,1e-05,0.01,0.702,0.9190638712823013,4123,4081
13,8304,10,100,1e-05,0.01,0.706,0.9172687861271677,4177,4127
13,8404,10,100,1e-05,0.01,0.734,0.9061161351737268,4236,4168
13,8504,10,100,1e-05,0.01,0.686,0.9089840075258702,4293,4211
13,8604,10,100,1e-05,0.01,0.714,0.9188749418874942,4336,4268
13,8704,10,100,1e-05,0.01,0.704,0.9172794117647058,4382,4322
13,8804,10,100,1e-05,0.01,0.706,0.9234438891412994,4425,4379
13,8904,10,100,1e-05,0.01,0.72,0.9295822102425876,4468,4436
13,9004,10,100,1e-05,0.01,0.724,0.9249222567747668,4519,4485
13,9104,10,100,1e-05,0.01,0.728,0.9309094903339191,4564,4540
13,9204,10,100,1e-05,0.01,0.692,0.9200347674923947,4615,4589
13,9304,10,100,1e-05,0.01,0.728,0.9102536543422184,4666,4638
13,9404,10,100,1e-05,0.01,0.732,0.921522756273926,4713,4691
13,9504,10,100,1e-05,0.01,0.744,0.9248737373737373,4757,4747
13,9604,10,100,1e-05,0.01,0.732,0.9319033735943357,4802,4802
13,9704,10,100,1e-05,0.01,0.758,0.9389942291838417,4857,4847
13,9804,10,100,1e-05,0.01,0.732,0.92890656874745,4913,4891
13,9904,10,100,1e-05,0.01,0.748,0.9485056542810986,4962,4942
13,10004,10,100,1e-05,0.01,0.756,0.9336265493802479,5015,4989
13,10104,10,100,1e-05,0.01,0.746,0.9464568487727633,5062,5042
13,10204,10,100,1e-05,0.01,0.786,0.9460015680125441,5107,5097
13,10304,10,100,1e-05,0.01,0.76,0.9400232919254659,5156,5148
13,10404,10,100,1e-05,0.01,0.746,0.9302191464821222,5201,5203
13,10504,10,100,1e-05,0.01,0.77,0.9255521706016756,5242,5262
13,10604,10,100,1e-05,0.01,0.786,0.9430403621274991,5293,5311
13,10704,10,100,1e-05,0.01,0.778,0.945440956651719,5347,5357
13,10804,10,100,1e-05,0.01,0.772,0.9489078119215105,5387,5417
13,10904,10,100,1e-05,0.01,0.778,0.9389214966984593,5431,5473
13,11004,10,100,1e-05,0.01,0.79,0.9397491821155943,5476,5528
13,11104,10,100,1e-05,0.01,0.786,0.950828530259366,5519,5585
13,11204,10,100,1e-05,0.01,0.776,0.9489468047126026,5569,5635
13,11304,10,100,1e-05,0.01,0.79,0.9495753715498938,5621,5683
13,11404,10,100,1e-05,0.01,0.774,0.9373027008067345,5668,5736
13,11504,10,100,1e-05,0.01,0.768,0.8914290681502086,5714,5790
13,11604,10,100,1e-05,0.01,0.786,0.9353671147880042,5770,5834
13,11704,10,100,1e-05,0.01,0.784,0.935663021189337,5819,5885
13,11804,10,100,1e-05,0.01,0.796,0.9510335479498475,5872,5932
13,11904,10,100,1e-05,0.01,0.792,0.9417002688172043,5926,5978
13,12004,10,100,1e-05,0.01,0.84,0.9575974675108297,5970,6034
13,12104,10,100,1e-05,0.01,0.812,0.9411764705882353,6025,6079
13,12204,10,100,1e-05,0.01,0.818,0.9597672894133071,6074,6130
13,12304,10,100,1e-05,0.01,0.816,0.9527795838751626,6119,6185
13,12404,10,100,1e-05,0.01,0.814,0.9613834247017091,6163,6241
13,12504,10,100,1e-05,0.01,0.836,0.9528950735764555,6217,6287
13,12604,10,100,1e-05,0.01,0.836,0.956125039669946,6260,6344
13,12704,10,100,1e-05,0.01,0.822,0.9559193954659949,6318,6386
13,12804,10,100,1e-05,0.01,0.846,0.9624336144954702,6358,6446
13,12904,10,100,1e-05,0.01,0.828,0.9648171109733416,6410,6494
13,13004,10,100,1e-05,0.01,0.826,0.9612426945555214,6467,6537
13,13104,10,100,1e-05,0.01,0.836,0.9648962148962149,6519,6585
13,13204,10,100,1e-05,0.01,0.84,0.9616782793093002,6563,6641
13,13304,10,100,1e-05,0.01,0.852,0.9582832230907997,6615,6689
13,13404,10,100,1e-05,0.01,0.854,0.9635929573261713,6667,6737
13,13504,10,100,1e-05,0.01,0.848,0.9606042654028436,6718,6786
13,13604,10,100,1e-05,0.01,0.832,0.9350191120258747,6769,6835
13,13704,10,100,1e-05,0.01,0.81,0.9206800934033859,6822,6882
13,13804,10,100,1e-05,0.01,0.844,0.9399449434946392,6872,6932
13,13904,10,100,1e-05,0.01,0.852,0.952819332566168,6925,6979
13,14004,10,100,1e-05,0.01,0.854,0.9601542416452442,6985,7019
13,14104,10,100,1e-05,0.01,0.858,0.9551191151446398,7037,7067
13,14204,10,100,1e-05,0.01,0.874,0.9603632779498733,7086,7118
13,14304,10,100,1e-05,0.01,0.88,0.9652544742729307,7137,7167
13,14404,10,100,1e-05,0.01,0.868,0.9534157178561511,7185,7219
13,14504,10,100,1e-05,0.01,0.894,0.972904026475455,7240,7264
13,14604,10,100,1e-05,0.01,0.854,0.9505614900027389,7293,7311
13,14704,10,100,1e-05,0.01,0.81,0.9076441784548422,7340,7364
13,14804,10,100,1e-05,0.01,0.842,0.9325182383139692,7391,7413
13,14904,10,100,1e-05,0.01,0.842,0.9496779388083736,7445,7459
13,15004,10,100,1e-05,0.01,0.86,0.9580778459077579,7493,7511
14,104,10,100,1e-05,0.01,0.52,0.5865384615384616,43,61
14,204,10,100,1e-05,0.01,0.516,0.696078431372549,97,107
14,304,10,100,1e-05,0.01,0.49,0.5657894736842105,142,162
14,404,10,100,1e-05,0.01,0.536,0.693069306930693,185,219
14,504,10,100,1e-05,0.01,0.536,0.6607142857142857,242,262
14,604,10,100,1e-05,0.01,0.534,0.6655629139072847,294,310
14,704,10,100,1e-05,0.01,0.544,0.6519886363636364,335,369
14,804,10,100,1e-05,0.01,0.538,0.667910447761194,381,423
14,904,10,100,1e-05,0.01,0.548,0.6769911504424779,434,470
14,1004,10,100,1e-05,0.01,0.548,0.6892430278884463,477,527
14,1104,10,100,1e-05,0.01,0.554,0.6865942028985508,523,581
14,1204,10,100,1e-05,0.01,0.532,0.6818936877076412,566,638
14,1304,10,100,1e-05,0.01,0.56,0.696319018404908,616,688
14,1404,10,100,1e-05,0.01,0.522,0.7186609686609686,667,737
14,1504,10,100,1e-05,0.01,0.542,0.6728723404255319,726,778
14,1604,10,100,1e-05,0.01,0.534,0.7119700748129676,776,828
14,1704,10,100,1e-05,0.01,0.518,0.7235915492957746,823,881
14,1804,10,100,1e-05,0.01,0.564,0.738359201773836,880,924
14,1904,10,100,1e-05,0.01,0.536,0.7358193277310925,923,981
14,2004,10,100,1e-05,0.01,0.538,0.7684630738522954,982,1022
14,2104,10,100,1e-05,0.01,0.512,0.7153041825095057,1034,1070
14,2204,10,100,1e-05,0.01,0.51,0.7382032667876588,1088,1116
14,2304,10,100,1e-05,0.01,0.52,0.7586805555555556,1136,1168
14,2404,10,100,1e-05,0.01,0.526,0.7903494176372712,1191,1213
14,2504,10,100,1e-05,0.01,0.544,0.7975239616613419,1240,1264
14,2604,10,100,1e-05,0.01,0.55,0.7991551459293394,1298,1306
14,2704,10,100,1e-05,0.01,0.532,0.7714497041420119,1354,1350
14,2804,10,100,1e-05,0.01,0.558,0.7927960057061341,1410,1394
14,2904,10,100,1e-05,0.01,0.558,0.7575757575757576,1454,1450
14,3004,10,100,1e-05,0.01,0.54,0.8062583222370173,1498,1506
14,3104,10,100,1e-05,0.01,0.562,0.8253865979381443,1557,1547
14,3204,10,100,1e-05,0.01,0.57,0.8149188514357054,1606,1598
14,3304,10,100,1e-05,0.01,0.546,0.809322033898305,1646,1658
14,3404,10,100,1e-05,0.01,0.566,0.8093419506462984,1690,1714
14,3504,10,100,1e-05,0.01,0.588,0.8159246575342466,1733,1771
14,3604,10,100,1e-05,0.01,0.602,0.8265815760266371,1777,1827
14,3704,10,100,1e-05,0.01,0.6,0.8393628509719222,1821,1883
14,3804,10,100,1e-05,0.01,0.586,0.8196635120925342,1877,1927
14,3904,10,100,1e-05,0.01,0.598,0.8381147540983607,1936,1968
14,4004,10,100,1e-05,0.01,0.632,0.8583916083916084,1995,2009
14,4104,10,100,1e-05,0.01,0.618,0.844785575048733,2049,2055
14,4204,10,100,1e-05,0.01,0.622,0.8720266412940058,2105,2099
14,4304,10,100,1e-05,0.01,0.644,0.8633828996282528,2146,2158
14,4404,10,100,1e-05,0.01,0.64,0.8474114441416893,2193,2211
14,4504,10,100,1e-05,0.01,0.634,0.8363676731793961,2240,2264
14,4604,10,100,1e-05,0.01,0.64,0.8564291920069504,2286,2318
14,4704,10,100,1e-05,0.01,0.6,0.8405612244897959,2334,2370
14,4804,10,100,1e-05,0.01,0.64,0.8634471273938384,2385,2419
14,4904,10,100,1e-05,0.01,0.644,0.8735725938009788,2440,2464
14,5004,10,100,1e-05,0.01,0.668,0.8585131894484412,2498,2506
14,5104,10,100,1e-05,0.01,0.624,0.8622648902821317,2541,2563
14,5204,10,100,1e-05,0.01,0.632,0.8491544965411222,2581,2623
14,5304,10,100,1e-05,0.01,0.65,0.8699095022624435,2639,2665
14,5404,10,100,1e-05,0.01,0.638,0.8880458919319023,2687,2717
14,5504,10,100,1e-05,0.01,0.66,0.8937136627906976,2735,2769
14,5604,10,100,1e-05,0.01,0.676,0.8984653818700928,2788,2816
14,5704,10,100,1e-05,0.01,0.642,0.8923562412342216,2838,2866
14,5804,10,100,1e-05,0.01,0.644,0.888869745003446,2892,2912
14,5904,10,100,1e-05,0.01,0.682,0.8719512195121951,2942,2962
14,6004,10,100,1e-05,0.01,0.7,0.8890739506995337,2990,3014
14,6104,10,100,1e-05,0.01,0.686,0.8669724770642202,3036,3068
14,6204,10,100,1e-05,0.01,0.668,0.8858800773694391,3095,3109
14,6304,10,100,1e-05,0.01,0.676,0.8870558375634517,3141,3163
14,6404,10,100,1e-05,0.01,0.672,0.9083385384134915,3184,3220
14,6504,10,100,1e-05,0.01,0.672,0.9017527675276753,3229,3275
14,6604,10,100,1e-05,0.01,0.692,0.9085402786190188,3278,3326
14,6704,10,100,1e-05,0.01,0.71,0.9127386634844868,3332,3372
14,6804,10,100,1e-05,0.01,0.694,0.9146090534979424,3371,3433
14,6904,10,100,1e-05,0.01,0.658,0.9088933951332561,3417,3487
14,7004,10,100,1e-05,0.01,0.702,0.9167618503712165,3468,3536
14,7104,10,100,1e-05,0.01,0.712,0.9311655405405406,3515,3589
14,7204,10,100,1e-05,0.01,0.704,0.9217101610216546,3561,3643
14,7304,10,100,1e-05,0.01,0.702,0.9296276013143483,3611,3693
14,7404,10,100,1e-05,0.01,0.718,0.9307131280388979,3665,3739
14,7504,10,100,1e-05,0.01,0.704,0.9144456289978679,3707,3797
14,7604,10,100,1e-05,0.01,0.722,0.9259600210415571,3753,3851
14,7704,10,100,1e-05,0.01,0.694,0.8961578400830738,3794,3910
14,7804,10,100,1e-05,0.01,0.712,0.9183751922091236,3841,3963
14,7904,10,100,1e-05,0.01,0.732,0.9262398785425101,3897,4007
14,8004,10,100,1e-05,0.01,0.73,0.9212893553223388,3948,4056
14,8104,10,100,1e-05,0.01,0.72,0.9195459032576505,3999,4105
14,8204,10,100,1e-05,0.01,0.738,0.9277181862506094,4048,4156
14,8304,10,100,1e-05,0.01,0.704,0.8995664739884393,4092,4212
14,8404,10,100,1e-05,0.01,0.748,0.9162303664921466,4144,4260
14,8504,10,100,1e-05,0.01,0.714,0.9199200376293509,4186,4318
14,8604,10,100,1e-05,0.01,0.724,0.9257322175732218,4234,4370
14,8704,10,100,1e-05,0.01,0.736,0.9245174632352942,4282,4422
14,8804,10,100,1e-05,0.01,0.762,0.9320763289413903,4329,4475
14,8904,10,100,1e-05,0.01,0.746,0.9433962264150944,4378,4526
14,9004,10,100,1e-05,0.01,0.736,0.9344735673034207,4423,4581
14,9104,10,100,1e-05,0.01,0.74,0.906195079086116,4476,4628
14,9204,10,100,1e-05,0.01,0.732,0.9352455454150369,4534,4670
14,9304,10,100,1e-05,0.01,0.746,0.9331470335339639,4592,4712
14,9404,10,100,1e-05,0.01,0.752,0.9368353891960868,4649,4755
14,9504,10,100,1e-05,0.01,0.738,0.9271885521885522,4692,4812
14,9604,10,100,1e-05,0.01,0.752,0.926905456059975,4733,4871
14,9704,10,100,1e-05,0.01,0.78,0.9342539159109645,4780,4924
14,9804,10,100,1e-05,0.01,0.788,0.9363525091799265,4842,4962
14,9904,10,100,1e-05,0.01,0.774,0.9255856219709209,4896,5008
14,10004,10,100,1e-05,0.01,0.764,0.9380247900839664,4947,5057
14,10104,10,100,1e-05,0.01,0.768,0.9399247822644498,5008,5096
14,10204,10,100,1e-05,0.01,0.766,0.9395335162681302,5060,5144
14,10304,10,100,1e-05,0.01,0.762,0.9362383540372671,5119,5185
14,10404,10,100,1e-05,0.01,0.75,0.9180123029603998,5169,5235
14,10504,10,100,1e-05,0.01,0.75,0.931930693069307,5215,5289
14,10604,10,100,1e-05,0.01,0.738,0.9375707280271596,5258,5346
14,10704,10,100,1e-05,0.01,0.764,0.9150784753363229,5318,5386
14,10804,10,100,1e-05,0.01,0.754,0.9252128841169938,5371,5433
14,10904,10,100,1e-05,0.01,0.76,0.9384629493763756,5422,5482
14,11004,10,100,1e-05,0.01,0.778,0.9401126862958924,5471,5533
14,11104,10,100,1e-05,0.01,0.766,0.9381304034582133,5528,5576
14,11204,10,100,1e-05,0.01,0.754,0.9227061763655837,5579,5625
14,11304,10,100,1e-05,0.01,0.776,0.9395789101203114,5635,5669
14,11404,10,100,1e-05,0.01,0.76,0.9456331111890565,5684,5720
14,11504,10,100,1e-05,0.01,0.796,0.9415855354659249,5736,5768
14,11604,10,100,1e-05,0.01,0.748,0.9186487418131679,5778,5826
14,11704,10,100,1e-05,0.01,0.768,0.9481373889268626,5838,5866
14,11804,10,100,1e-05,0.01,0.772,0.9424771263978312,5887,5917
14,11904,10,100,1e-05,0.01,0.78,0.9369959677419355,5942,5962
14,12004,10,100,1e-05,0.01,0.788,0.9465178273908698,5994,6010
14,12104,10,100,1e-05,0.01,0.786,0.9508426966292135,6050,6054
14,12204,10,100,1e-05,0.01,0.786,0.9491150442477876,6097,6107
14,12304,10,100,1e-05,0.01,0.758,0.9508289986996099,6148,6156
14,12404,10,100,1e-05,0.01,0.786,0.9342147694292163,6189,6215
14,12504,10,100,1e-05,0.01,0.79,0.951935380678183,6252,6252
14,12604,10,100,1e-05,0.01,0.794,0.944858774992066,6309,6295
14,12704,10,100,1e-05,0.01,0.782,0.9488350125944585,6350,6354
14,12804,10,100,1e-05,0.01,0.792,0.9450171821305842,6395,6409
14,12904,10,100,1e-05,0.01,0.794,0.9404060756354619,6454,6450
14,13004,10,100,1e-05,0.01,0.814,0.9573977237772993,6510,6494
14,13104,10,100,1e-05,0.01,0.83,0.9574175824175825,6556,6548
14,13204,10,100,1e-05,0.01,0.792,0.9341108754922751,6609,6595
14,13304,10,100,1e-05,0.01,0.804,0.9382892363199038,6659,6645
14,13404,10,100,1e-05,0.01,0.818,0.9249477767830498,6716,6688
14,13504,10,100,1e-05,0.01,0.814,0.9416469194312796,6768,6736
14,13604,10,100,1e-05,0.01,0.822,0.9553807703616584,6831,6773
14,13704,10,100,1e-05,0.01,0.8,0.9487011091652072,6871,6833
14,13804,10,100,1e-05,0.01,0.804,0.9544334975369458,6922,6882
14,13904,10,100,1e-05,0.01,0.83,0.9420310701956272,6974,6930
14,14004,10,100,1e-05,0.01,0.754,0.8816052556412454,7021,6983
14,14104,10,100,1e-05,0.01,0.782,0.9052750992626205,7071,7033
14,14204,10,100,1e-05,0.01,0.822,0.9367783722894959,7129,7075
14,14304,10,100,1e-05,0.01,0.804,0.9480564876957495,7176,7128
14,14404,10,100,1e-05,0.01,0.826,0.9598722577061928,7223,7181
14,14504,10,100,1e-05,0.01,0.832,0.957046332046332,7266,7238
14,14604,10,100,1e-05,0.01,0.812,0.9374144070117776,7313,7291
14,14704,10,100,1e-05,0.01,0.83,0.9610990206746464,7358,7346
14,14804,10,100,1e-05,0.01,0.796,0.9600783572007565,7415,7389
14,14904,10,100,1e-05,0.01,0.84,0.9656468062265163,7466,7438
14,15004,10,100,1e-05,0.01,0.828,0.9536123700346574,7512,7492
15,104,10,100,1e-05,0.01,0.464,0.5096153846153846,49,55
15,204,10,100,1e-05,0.01,0.506,0.6274509803921569,100,104
15,304,10,100,1e-05,0.01,0.512,0.625,147,157
15,404,10,100,1e-05,0.01,0.504,0.5915841584158416,185,219
15,504,10,100,1e-05,0.01,0.492,0.5476190476190477,245,259
15,604,10,100,1e-05,0.01,0.552,0.6009933774834437,300,304
15,704,10,100,1e-05,0.01,0.552,0.6349431818181818,350,354
15,804,10,100,1e-05,0.01,0.518,0.6106965174129353,400,404
15,904,10,100,1e-05,0.01,0.502,0.6415929203539823,455,449
15,1004,10,100,1e-05,0.01,0.498,0.6334661354581673,504,500
15,1104,10,100,1e-05,0.01,0.506,0.6394927536231884,549,555
15,1204,10,100,1e-05,0.01,0.508,0.6661129568106312,599,605
15,1304,10,100,1e-05,0.01,0.496,0.6763803680981595,652,652
15,1404,10,100,1e-05,0.01,0.506,0.6937321937321937,703,701
15,1504,10,100,1e-05,0.01,0.504,0.692154255319149,760,744
15,1604,10,100,1e-05,0.01,0.49,0.713216957605985,807,797
15,1704,10,100,1e-05,0.01,0.492,0.6977699530516432,858,846
15,1804,10,100,1e-05,0.01,0.516,0.7056541019955654,912,892
15,1904,10,100,1e-05,0.01,0.492,0.7064075630252101,971,933
15,2004,10,100,1e-05,0.01,0.528,0.7445109780439122,1025,979
15,2104,10,100,1e-05,0.01,0.522,0.7404942965779467,1076,1028
15,2204,10,100,1e-05,0.01,0.522,0.7531760435571688,1121,1083
15,2304,10,100,1e-05,0.01,0.506,0.765625,1175,1129
15,2404,10,100,1e-05,0.01,0.546,0.7420965058236273,1225,1179
15,2504,10,100,1e-05,0.01,0.534,0.7655750798722045,1268,1236
15,2604,10,100,1e-05,0.01,0.566,0.7603686635944701,1328,1276
15,2704,10,100,1e-05,0.01,0.558,0.794008875739645,1375,1329
15,2804,10,100,1e-05,0.01,0.562,0.8052781740370899,1427,1377
15,2904,10,100,1e-05,0.01,0.586,0.7878787878787878,1481,1423
15,3004,10,100,1e-05,0.01,0.55,0.7709720372836218,1529,1475
15,3104,10,100,1e-05,0.01,0.558,0.7519329896907216,1588,1516
15,3204,10,100,1e-05,0.01,0.548,0.7740324594257179,1644,1560
15,3304,10,100,1e-05,0.01,0.58,0.7842009685230025,1691,1613
15,3404,10,100,1e-05,0.01,0.576,0.818448883666275,1737,1667
15,3504,10,100,1e-05,0.01,0.582,0.783675799086758,1784,1720
15,3604,10,100,1e-05,0.01,0.596,0.8085460599334073,1830,1774
15,3704,10,100,1e-05,0.01,0.608,0.8053455723542117,1878,1826
15,3804,10,100,1e-05,0.01,0.622,0.823080967402734,1928,1876
15,3904,10,100,1e-05,0.01,0.622,0.8299180327868853,1981,1923
15,4004,10,100,1e-05,0.01,0.618,0.8189310689310689,2021,1983
15,4104,10,100,1e-05,0.01,0.61,0.844541910331384,2071,2033
15,4204,10,100,1e-05,0.01,0.634,0.8411037107516651,2117,2087
15,4304,10,100,1e-05,0.01,0.646,0.8513011152416357,2166,2138
15,4404,10,100,1e-05,0.01,0.616,0.8505903723887375,2212,2192
15,4504,10,100,1e-05,0.01,0.606,0.8290408525754884,2263,2241
15,4604,10,100,1e-05,0.01,0.65,0.8377497827975673,2320,2284
15,4704,10,100,1e-05,0.01,0.626,0.8101615646258503,2371,2333
15,4804,10,100,1e-05,0.01,0.646,0.8382597835137385,2416,2388
15,4904,10,100,1e-05,0.01,0.656,0.8611337683523654,2463,2441
15,5004,10,100,1e-05,0.01,0.656,0.8515187849720224,2511,2493
15,5104,10,100,1e-05,0.01,0.69,0.8438479623824452,2560,2544
15,5204,10,100,1e-05,0.01,0.672,0.8330130668716372,2617,2587
15,5304,10,100,1e-05,0.01,0.688,0.8499245852187028,2670,2634
15,5404,10,100,1e-05,0.01,0.688,0.8469652109548482,2722,2682
15,5504,10,100,1e-05,0.01,0.684,0.8392078488372093,2762,2742
15,5604,10,100,1e-05,0.01,0.724,0.8527837259100642,2810,2794
15,5704,10,100,1e-05,0.01,0.722,0.8764025245441796,2860,2844
15,5804,10,100,1e-05,0.01,0.71,0.8774982770503101,2913,2891
15,5904,10,100,1e-05,0.01,0.722,0.8909214092140921,2961,2943
15,6004,10,100,1e-05,0.01,0.724,0.8819120586275816,3014,2990
15,6104,10,100,1e-05,0.01,0.718,0.8761467889908257,3061,3043
15,6204,10,100,1e-05,0.01,0.696,0.8923275306254029,3117,3087
15,6304,10,100,1e-05,0.01,0.716,0.9011738578680203,3168,3136
15,6404,10,100,1e-05,0.01,0.72,0.90053091817614,3225,3179
15,6504,10,100,1e-05,0.01,0.74,0.9100553505535055,3272,3232
15,6604,10,100,1e-05,0.01,0.73,0.8977892186553604,3323,3281
15,6704,10,100,1e-05,0.01,0.726,0.9078162291169452,3368,3336
15,6804,10,100,1e-05,0.01,0.732,0.9063786008230452,3415,3389
15,6904,10,100,1e-05,0.01,0.756,0.9087485515643106,3464,3440
15,7004,10,100,1e-05,0.01,0.752,0.8886350656767561,3512,3492
15,7104,10,100,1e-05,0.01,0.716,0.8619087837837838,3559,3545
15,7204,10,100,1e-05,0.01,0.752,0.9021377012770683,3604,3600
15,7304,10,100,1e-05,0.01,0.73,0.8986856516976999,3652,3652
15,7404,10,100,1e-05,0.01,0.724,0.9008643976229065,3707,3697
15,7504,10,100,1e-05,0.01,0.728,0.9040511727078892,3755,3749
15,7604,10,100,1e-05,0.01,0.738,0.9075486586007364,3803,3801
15,7704,10,100,1e-05,0.01,0.756,0.9008307372793354,3854,3850
15,7804,10,100,1e-05,0.01,0.74,0.9218349564325987,3903,3901
15,7904,10,100,1e-05,0.01,0.768,0.9280111336032388,3952,3952
15,8004,10,100,1e-05,0.01,0.756,0.9132933533233384,4003,4001
15,8104,10,100,1e-05,0.01,0.73,0.920533070088845,4051,4053
15,8204,10,100,1e-05,0.01,0.748,0.9045587518283764,4106,4098
15,8304,10,100,1e-05,0.01,0.73,0.8097302504816956,4153,4151
15,8404,10,100,1e-05,0.01,0.754,0.856853879105188,4207,4197
15,8504,10,100,1e-05,0.01,0.768,0.8604186265286924,4257,4247
15,8604,10,100,1e-05,0.01,0.762,0.8891213389121339,4309,4295
15,8704,10,100,1e-05,0.01,0.748,0.8923483455882353,4354,4350
15,8804,10,100,1e-05,0.01,0.756,0.8951612903225806,4395,4409
15,8904,10,100,1e-05,0.01,0.788,0.9037511230907457,4447,4457
15,9004,10,100,1e-05,0.01,0.77,0.91003998223012,4501,4503
15,9104,10,100,1e-05,0.01,0.778,0.9243189806678384,4558,4546
15,9204,10,100,1e-05,0.01,0.764,0.916232073011734,4607,4597
15,9304,10,100,1e-05,0.01,0.778,0.9170249355116079,4652,4652
15,9404,10,100,1e-05,0.01,0.786,0.9182262866865164,4698,4706
15,9504,10,100,1e-05,0.01,0.794,0.9186658249158249,4744,4760
15,9604,10,100,1e-05,0.01,0.786,0.8967097042898792,4800,4804
15,9704,10,100,1e-05,0.01,0.778,0.9198268755152514,4852,4852
15,9804,10,100,1e-05,0.01,0.806,0.9186046511627907,4896,4908
15,9904,10,100,1e-05,0.01,0.74,0.8870153473344103,4941,4963
15,10004,10,100,1e-05,0.01,0.766,0.9114354258296681,4994,5010
15,10104,10,100,1e-05,0.01,0.798,0.9355700712589073,5045,5059
15,10204,10,100,1e-05,0.01,0.784,0.9094472755782046,5098,5106
15,10304,10,100,1e-05,0.01,0.798,0.9127523291925466,5149,5155
15,10404,10,100,1e-05,0.01,0.784,0.9214725105728566,5202,5202
15,10504,10,100,1e-05,0.01,0.804,0.9355483625285606,5257,5247
15,10604,10,100,1e-05,0.01,0.806,0.9296491889852886,5318,5286
15,10704,10,100,1e-05,0.01,0.8,0.9326420029895366,5363,5341
15,10804,10,100,1e-05,0.01,0.808,0.9259533506108849,5406,5398
15,10904,10,100,1e-05,0.01,0.798,0.9297505502567865,5459,5445
15,11004,10,100,1e-05,0.01,0.814,0.9283896764812796,5513,5491
15,11104,10,100,1e-05,0.01,0.816,0.9336275216138329,5558,5546
15,11204,10,100,1e-05,0.01,0.814,0.9399321670831846,5614,5590
15,11304,10,100,1e-05,0.01,0.818,0.9341825902335457,5657,5647
15,11404,10,100,1e-05,0.01,0.796,0.9209049456331112,5706,5698
15,11504,10,100,1e-05,0.01,0.824,0.9422809457579973,5763,5741
15,11604,10,100,1e-05,0.01,0.81,0.927266459841434,5811,5793
15,11704,10,100,1e-05,0.01,0.836,0.9441216678058784,5864,5840
15,11804,10,100,1e-05,0.01,0.812,0.9308708912233141,5921,5883
15,11904,10,100,1e-05,0.01,0.826,0.9379200268817204,5972,5932
15,12004,10,100,1e-05,0.01,0.818,0.9315228257247584,6022,5982
15,12104,10,100,1e-05,0.01,0.81,0.9370456047587574,6078,6026
15,12204,10,100,1e-05,0.01,0.834,0.9448541461815798,6124,6080
15,12304,10,100,1e-05,0.01,0.826,0.9281534460338101,6167,6137
15,12404,10,100,1e-05,0.01,0.842,0.9395356336665591,6215,6189
15,12504,10,100,1e-05,0.01,0.834,0.9470569417786309,6258,6246
15,12604,10,100,1e-05,0.01,0.838,0.9523167248492542,6315,6289
15,12704,10,100,1e-05,0.01,0.83,0.9359256926952141,6361,6343
15,12804,10,100,1e-05,0.01,0.82,0.9465791940018744,6400,6404
15,12904,10,100,1e-05,0.01,0.824,0.9372287662740235,6452,6452
15,13004,10,100,1e-05,0.01,0.8,0.9015687480775146,6499,6505
15,13104,10,100,1e-05,0.01,0.718,0.8415750915750916,6554,6550
15,13204,10,100,1e-05,0.01,0.774,0.8791275371099667,6612,6592
15,13304,10,100,1e-05,0.01,0.772,0.8925886951292844,6668,6636
15,13404,10,100,1e-05,0.01,0.78,0.8954789615040286,6724,6680
15,13504,10,100,1e-05,0.01,0.79,0.9105450236966824,6770,6734
15,13604,10,100,1e-05,0.01,0.778,0.8915024992649221,6821,6783
15,13704,10,100,1e-05,0.01,0.792,0.9094424985405721,6859,6845
15,13804,10,100,1e-05,0.01,0.798,0.913141118516372,6905,6899
15,13904,10,100,1e-05,0.01,0.802,0.905638665132336,6949,6955
15,14004,10,100,1e-05,0.01,0.8,0.8998143387603542,7002,7002
15,14104,10,100,1e-05,0.01,0.78,0.8840754395916052,7051,7053
15,14204,10,100,1e-05,0.01,0.792,0.9097437341593917,7107,7097
15,14304,10,100,1e-05,0.01,0.808,0.9093959731543624,7159,7145
15,14404,10,100,1e-05,0.01,0.83,0.9203693418494863,7210,7194
15,14504,10,100,1e-05,0.01,0.812,0.9355350248207391,7261,7243
15,14604,10,100,1e-05,0.01,0.82,0.9443987948507259,7312,7292
15,14704,10,100,1e-05,0.01,0.828,0.9481093579978237,7362,7342
15,14804,10,100,1e-05,0.01,0.832,0.9425155363415293,7405,7399
15,14904,10,100,1e-05,0.01,0.826,0.9477321524422974,7461,7443
15,15004,10,100,1e-05,0.01,0.83,0.949346840842442,7520,7484
16,104,10,100,1e-05,0.01,0.482,0.5576923076923077,58,46
16,204,10,100,1e-05,0.01,0.498,0.5735294117647058,118,86
16,304,10,100,1e-05,0.01,0.492,0.625,173,131
16,404,10,100,1e-05,0.01,0.476,0.6460396039603961,210,194
16,504,10,100,1e-05,0.01,0.488,0.6071428571428571,256,248
16,604,10,100,1e-05,0.01,0.51,0.6473509933774835,305,299
16,704,10,100,1e-05,0.01,0.492,0.6150568181818182,348,356
16,804,10,100,1e-05,0.01,0.502,0.6728855721393034,401,403
16,904,10,100,1e-05,0.01,0.496,0.6581858407079646,447,457
16,1004,10,100,1e-05,0.01,0.512,0.6743027888446215,489,515
16,1104,10,100,1e-05,0.01,0.52,0.6648550724637681,553,551
16,1204,10,100,1e-05,0.01,0.514,0.6677740863787376,596,608
16,1304,10,100,1e-05,0.01,0.53,0.6748466257668712,652,652
16,1404,10,100,1e-05,0.01,0.518,0.7072649572649573,696,708
16,1504,10,100,1e-05,0.01,0.522,0.6954787234042553,748,756
16,1604,10,100,1e-05,0.01,0.536,0.7493765586034913,799,805
16,1704,10,100,1e-05,0.01,0.558,0.7288732394366197,847,857
16,1804,10,100,1e-05,0.01,0.53,0.7549889135254989,892,912
16,1904,10,100,1e-05,0.01,0.546,0.7857142857142857,941,963
16,2004,10,100,1e-05,0.01,0.538,0.7829341317365269,992,1012
16,2104,10,100,1e-05,0.01,0.506,0.7200570342205324,1047,1057
16,2204,10,100,1e-05,0.01,0.534,0.764065335753176,1095,1109
16,2304,10,100,1e-05,0.01,0.548,0.7586805555555556,1149,1155
16,2404,10,100,1e-05,0.01,0.524,0.7458402662229617,1197,1207
16,2504,10,100,1e-05,0.01,0.518,0.7667731629392971,1237,1267
16,2604,10,100,1e-05,0.01,0.522,0.7711213517665131,1280,1324
16,2704,10,100,1e-05,0.01,0.518,0.7954881656804734,1325,1379
16,2804,10,100,1e-05,0.01,0.54,0.8134807417974322,1367,1437
16,2904,10,100,1e-05,0.01,0.522,0.8037190082644629,1417,1487
16,3004,10,100,1e-05,0.01,0.546,0.7989347536617842,1474,1530
16,3104,10,100,1e-05,0.01,0.53,0.8025128865979382,1518,1586
16,3204,10,100,1e-05,0.01,0.52,0.8264669163545568,1564,1640
16,3304,10,100,1e-05,0.01,0.544,0.822639225181598,1617,1687
16,3404,10,100,1e-05,0.01,0.558,0.8437132784958872,1668,1736
16,3504,10,100,1e-05,0.01,0.522,0.8184931506849316,1708,1796
16,3604,10,100,1e-05,0.01,0.536,0.8329633740288568,1767,1837
16,3704,10,100,1e-05,0.01,0.516,0.8480021598272138,1819,1885
16,3804,10,100,1e-05,0.01,0.542,0.8625131440588854,1870,1934
16,3904,10,100,1e-05,0.01,0.518,0.8655225409836066,1923,1981
16,4004,10,100,1e-05,0.01,0.528,0.8543956043956044,1972,2032
16,4104,10,100,1e-05,0.01,0.556,0.8433235867446394,2028,2076
16,4204,10,100,1e-05,0.01,0.55,0.8608468125594672,2070,2134
16,4304,10,100,1e-05,0.01,0.546,0.8531598513011153,2121,2183
16,4404,10,100,1e-05,0.01,0.558,0.8710263396911898,2176,2228
16,4504,10,100,1e-05,0.01,0.536,0.8736678507992895,2227,2277
16,4604,10,100,1e-05,0.01,0.56,0.8716333622936577,2283,2321
16,4704,10,100,1e-05,0.01,0.572,0.8864795918367347,2329,2375
16,4804,10,100,1e-05,0.01,0.578,0.8813488759367194,2387,2417
16,4904,10,100,1e-05,0.01,0.576,0.8688825448613376,2434,2470
16,5004,10,100,1e-05,0.01,0.578,0.8739008792965628,2482,2522
16,5104,10,100,1e-05,0.01,0.59,0.8448275862068966,2539,2565
16,5204,10,100,1e-05,0.01,0.566,0.847425057647963,2587,2617
16,5304,10,100,1e-05,0.01,0.616,0.8538838612368024,2644,2660
16,5404,10,100,1e-05,0.01,0.606,0.8898963730569949,2707,2697
16,5504,10,100,1e-05,0.01,0.604,0.8948037790697675,2761,2743
16,5604,10,100,1e-05,0.01,0.608,0.8890078515346181,2809,2795
16,5704,10,100,1e-05,0.01,0.628,0.8164446002805049,2857,2847
16,5804,10,100,1e-05,0.01,0.604,0.8506202618883528,2903,2901
16,5904,10,100,1e-05,0.01,0.612,0.863990514905149,2955,2949
16,6004,10,100,1e-05,0.01,0.614,0.8720852764823451,3004,3000
16,6104,10,100,1e-05,0.01,0.606,0.8573066841415465,3060,3044
16,6204,10,100,1e-05,0.01,0.61,0.8855577047066409,3120,3084
16,6304,10,100,1e-05,0.01,0.616,0.8735723350253807,3169,3135
16,6404,10,100,1e-05,0.01,0.602,0.8953778888194878,3213,3191
16,6504,10,100,1e-05,0.01,0.61,0.8916051660516605,3260,3244
16,6604,10,100,1e-05,0.01,0.628,0.8947607510599637,3317,3287
16,6704,10,100,1e-05,0.01,0.64,0.905727923627685,3361,3343
16,6804,10,100,1e-05,0.01,0.634,0.9032921810699589,3415,3389
16,6904,10,100,1e-05,0.01,0.606,0.8842699884125145,3465,3439
16,7004,10,100,1e-05,0.01,0.632,0.9001998857795546,3517,3487
16,7104,10,100,1e-05,0.01,0.642,0.9148367117117117,3564,3540
16,7204,10,100,1e-05,0.01,0.614,0.9121321488062187,3618,3586
16,7304,10,100,1e-05,0.01,0.63,0.8833515881708652,3668,3636
16,7404,10,100,1e-05,0.01,0.628,0.9039708265802269,3718,3686
16,7504,10,100,1e-05,0.01,0.634,0.8988539445628998,3769,3735
16,7604,10,100,1e-05,0.01,0.644,0.9078116780641767,3827,3777
16,7704,10,100,1e-05,0.01,0.644,0.9236760124610592,3880,3824
16,7804,10,100,1e-05,0.01,0.662,0.9236289082521784,3927,3877
16,7904,10,100,1e-05,0.01,0.628,0.9333248987854251,3971,3933
16,8004,10,100,1e-05,0.01,0.658,0.9239130434782609,4024,3980
16,8104,10,100,1e-05,0.01,0.662,0.9249753208292202,4084,4020
16,8204,10,100,1e-05,0.01,0.66,0.9288152120916626,4123,4081
16,8304,10,100,1e-05,0.01,0.644,0.9203998073217726,4174,4130
16,8404,10,100,1e-05,0.01,0.658,0.9183722037125178,4229,4175
16,8504,10,100,1e-05,0.01,0.642,0.9086312323612418,4273,4231
16,8604,10,100,1e-05,0.01,0.67,0.9235239423523942,4321,4283
16,8704,10,100,1e-05,0.01,0.67,0.9273897058823529,4368,4336
16,8804,10,100,1e-05,0.01,0.676,0.9237846433439346,4411,4393
16,8904,10,100,1e-05,0.01,0.654,0.9321653189577718,4464,4440
16,9004,10,100,1e-05,0.01,0.662,0.9240337627721013,4511,4493
16,9104,10,100,1e-05,0.01,0.658,0.9290421792618629,4555,4549
16,9204,10,100,1e-05,0.01,0.68,0.9350282485875706,4604,4600
16,9304,10,100,1e-05,0.01,0.692,0.9424978503869303,4663,4641
16,9404,10,100,1e-05,0.01,0.662,0.9289663972777541,4717,4687
16,9504,10,100,1e-05,0.01,0.682,0.8993055555555556,4768,4736
16,9604,10,100,1e-05,0.01,0.682,0.9199291961682632,4820,4784
16,9704,10,100,1e-05,0.01,0.71,0.9286892003297609,4877,4827
16,9804,10,100,1e-05,0.01,0.714,0.9384944920440637,4926,4878
16,9904,10,100,1e-05,0.01,0.674,0.908218901453958,4974,4930
16,10004,10,100,1e-05,0.01,0.706,0.9239304278288685,5023,4981
16,10104,10,100,1e-05,0.01,0.71,0.9359659540775931,5078,5026
16,10204,10,100,1e-05,0.01,0.736,0.9410035280282242,5125,5079
16,10304,10,100,1e-05,0.01,0.698,0.93847049689441,5177,5127
16,10404,10,100,1e-05,0.01,0.718,0.9256055363321799,5229,5175
16,10504,10,100,1e-05,0.01,0.72,0.9363099771515613,5286,5218
16,10604,10,100,1e-05,0.01,0.734,0.9458694832138815,5340,5264
16,10704,10,100,1e-05,0.01,0.728,0.9427316890881914,5390,5314
16,10804,10,100,1e-05,0.01,0.736,0.942891521658645,5445,5359
16,10904,10,100,1e-05,0.01,0.754,0.947450476889215,5494,5410
16,11004,10,100,1e-05,0.01,0.748,0.9317520901490367,5530,5474
16,11104,10,100,1e-05,0.01,0.704,0.8822046109510087,5584,5520
16,11204,10,100,1e-05,0.01,0.724,0.917707961442342,5642,5562
16,11304,10,100,1e-05,0.01,0.742,0.9054317055909412,5695,5609
16,11404,10,100,1e-05,0.01,0.756,0.9316029463346195,5744,5660
16,11504,10,100,1e-05,0.01,0.754,0.9356745479833102,5790,5714
16,11604,10,100,1e-05,0.01,0.764,0.9488969320923819,5850,5754
16,11704,10,100,1e-05,0.01,0.732,0.9321599453178401,5903,5801
16,11804,10,100,1e-05,0.01,0.75,0.9396814639105388,5946,5858
16,11904,10,100,1e-05,0.01,0.75,0.9363239247311828,5994,5910
16,12004,10,100,1e-05,0.01,0.786,0.9549316894368544,6042,5962
16,12104,10,100,1e-05,0.01,0.77,0.9441506939854594,6085,6019
16,12204,10,100,1e-05,0.01,0.76,0.9478039986889545,6130,6074
16,12304,10,100,1e-05,0.01,0.78,0.9581436931079323,6183,6121
16,12404,10,100,1e-05,0.01,0.8,0.9560625604643663,6232,6172
16,12504,10,100,1e-05,0.01,0.808,0.9485764555342291,6273,6231
16,12604,10,100,1e-05,0.01,0.778,0.939543002221517,6331,6273
16,12704,10,100,1e-05,0.01,0.786,0.9175850125944585,6380,6324
16,12804,10,100,1e-05,0.01,0.778,0.9393939393939394,6423,6381
16,12904,10,100,1e-05,0.01,0.802,0.9454432734035958,6470,6434
16,13004,10,100,1e-05,0.01,0.798,0.9555521378037527,6522,6482
16,13104,10,100,1e-05,0.01,0.814,0.9586385836385837,6570,6534
16,13204,10,100,1e-05,0.01,0.806,0.947364435019691,6619,6585
16,13304,10,100,1e-05,0.01,0.808,0.9320505111244738,6665,6639
16,13404,10,100,1e-05,0.01,0.83,0.9447179946284691,6712,6692
16,13504,10,100,1e-05,0.01,0.84,0.9277251184834123,6766,6738
16,13604,10,100,1e-05,0.01,0.84,0.9506027638929726,6814,6790
16,13704,10,100,1e-05,0.01,0.818,0.9568739054290718,6868,6836
16,13804,10,100,1e-05,0.01,0.826,0.9558823529411765,6912,6892
16,13904,10,100,1e-05,0.01,0.838,0.9601553509781358,6959,6945
16,14004,10,100,1e-05,0.01,0.796,0.9458726078263353,7013,6991
16,14104,10,100,1e-05,0.01,0.854,0.9656125921724333,7072,7032
16,14204,10,100,1e-05,0.01,0.836,0.9693044212897776,7118,7086
16,14304,10,100,1e-05,0.01,0.836,0.9649049217002237,7167,7137
16,14404,10,100,1e-05,0.01,0.836,0.9546653707303526,7216,7188
16,14504,10,100,1e-05,0.01,0.84,0.9340182018753447,7272,7232
16,14604,10,100,1e-05,0.01,0.848,0.9534374144070118,7326,7278
16,14704,10,100,1e-05,0.01,0.858,0.9574265505984766,7375,7329
16,14804,10,100,1e-05,0.01,0.866,0.9518373412591191,7423,7381
16,14904,10,100,1e-05,0.01,0.868,0.9565217391304348,7459,7445
16,15004,10,100,1e-05,0.01,0.878,0.9564116235670488,7511,7493
17,104,10,100,1e-05,0.01,0.508,0.7115384615384616,55,49
17,204,10,100,1e-05,0.01,0.494,0.6617647058823529,109,95
17,304,10,100,1e-05,0.01,0.51,0.6282894736842105,158,146
17,404,10,100,1e-05,0.01,0.518,0.6410891089108911,200,204
17,504,10,100,1e-05,0.01,0.526,0.6170634920634921,250,254
17,604,10,100,1e-05,0.01,0.506,0.5794701986754967,310,294
17,704,10,100,1e-05,0.01,0.502,0.5681818181818182,367,337
17,804,10,100,1e-05,0.01,0.506,0.6144278606965174,420,384
17,904,10,100,1e-05,0.01,0.494,0.6039823008849557,476,428
17,1004,10,100,1e-05,0.01,0.524,0.6185258964143426,524,480
17,1104,10,100,1e-05,0.01,0.506,0.654891304347826,573,531
17,1204,10,100,1e-05,0.01,0.478,0.6486710963455149,626,578
17,1304,10,100,1e-05,0.01,0.502,0.6464723926380368,677,627
17,1404,10,100,1e-05,0.01,0.518,0.6673789173789174,722,682
17,1504,10,100,1e-05,0.01,0.494,0.6622340425531915,772,732
17,1604,10,100,1e-05,0.01,0.506,0.6826683291770573,814,790
17,1704,10,100,1e-05,0.01,0.512,0.6830985915492958,864,840
17,1804,10,100,1e-05,0.01,0.518,0.6890243902439024,908,896
17,1904,10,100,1e-05,0.01,0.526,0.6917016806722689,954,950
17,2004,10,100,1e-05,0.01,0.512,0.6936127744510978,1005,999
17,2104,10,100,1e-05,0.01,0.484,0.7195817490494296,1055,1049
17,2204,10,100,1e-05,0.01,0.504,0.7273139745916516,1109,1095
17,2304,10,100,1e-05,0.01,0.528,0.7274305555555556,1158,1146
17,2404,10,100,1e-05,0.01,0.52,0.7296173044925125,1207,1197
17,2504,10,100,1e-05,0.01,0.538,0.7232428115015974,1264,1240
17,2604,10,100,1e-05,0.01,0.524,0.7580645161290323,1306,1298
17,2704,10,100,1e-05,0.01,0.522,0.7303994082840237,1348,1356
17,2804,10,100,1e-05,0.01,0.498,0.7403708987161198,1398,1406
17,2904,10,100,1e-05,0.01,0.492,0.7400137741046832,1449,1455
17,3004,10,100,1e-05,0.01,0.508,0.7509986684420772,1500,1504
17,3104,10,100,1e-05,0.01,0.52,0.7603092783505154,1553,1551
17,3204,10,100,1e-05,0.01,0.506,0.7524968789013733,1601,1603
17,3304,10,100,1e-05,0.01,0.554,0.7835956416464891,1649,1655
17,3404,10,100,1e-05,0.01,0.528,0.7523501762632198,1700,1704
17,3504,10,100,1e-05,0.01,0.548,0.7799657534246576,1750,1754
17,3604,10,100,1e-05,0.01,0.554,0.7999445061043285,1797,1807
17,3704,10,100,1e-05,0.01,0.534,0.785097192224622,1851,1853
17,3804,10,100,1e-05,0.01,0.546,0.7996845425867508,1902,1902
17,3904,10,100,1e-05,0.01,0.552,0.7963627049180327,1948,1956
17,4004,10,100,1e-05,0.01,0.554,0.8159340659340659,2005,1999
17,4104,10,100,1e-05,0.01,0.598,0.8313840155945419,2061,2043
17,4204,10,100,1e-05,0.01,0.578,0.8199333967649858,2112,2092
17,4304,10,100,1e-05,0.01,0.566,0.7894981412639405,2156,2148
17,4404,10,100,1e-05,0.01,0.556,0.7867847411444142,2191,2213
17,4504,10,100,1e-05,0.01,0.576,0.7808614564831261,2247,2257
17,4604,10,100,1e-05,0.01,0.59,0.8231972198088618,2296,2308
17,4704,10,100,1e-05,0.01,0.578,0.8222789115646258,2347,2357
17,4804,10,100,1e-05,0.01,0.598,0.8328476269775187,2399,2405
17,4904,10,100,1e-05,0.01,0.59,0.8250407830342578,2442,2462
17,5004,10,100,1e-05,0.01,0.582,0.841726618705036,2484,2520
17,5104,10,100,1e-05,0.01,0.59,0.8524686520376176,2541,2563
17,5204,10,100,1e-05,0.01,0.59,0.8401229823212913,2588,2616
17,5304,10,100,1e-05,0.01,0.632,0.8248491704374057,2636,2668
17,5404,10,100,1e-05,0.01,0.606,0.8584381939304219,2687,2717
17,5504,10,100,1e-05,0.01,0.61,0.857921511627907,2731,2773
17,5604,10,100,1e-05,0.01,0.602,0.8508208422555318,2770,2834
17,5704,10,100,1e-05,0.01,0.66,0.8213534361851332,2828,2876
17,5804,10,100,1e-05,0.01,0.622,0.8621640248104755,2887,2917
17,5904,10,100,1e-05,0.01,0.618,0.856029810298103,2933,2971
17,6004,10,100,1e-05,0.01,0.634,0.8192871419053964,2986,3018
17,6104,10,100,1e-05,0.01,0.632,0.8266710353866317,3047,3057
17,6204,10,100,1e-05,0.01,0.634,0.8450999355254675,3096,3108
17,6304,10,100,1e-05,0.01,0.67,0.8580266497461929,3142,3162
17,6404,10,100,1e-05,0.01,0.658,0.8878825733916302,3207,3197
17,6504,10,100,1e-05,0.01,0.674,0.8653136531365314,3249,3255
17,6604,10,100,1e-05,0.01,0.658,0.8784070260448213,3306,3298
17,6704,10,100,1e-05,0.01,0.666,0.8857398568019093,3345,3359
17,6804,10,100,1e-05,0.01,0.672,0.8849206349206349,3393,3411
17,6904,10,100,1e-05,0.01,0.688,0.8719582850521437,3450,3454
17,7004,10,100,1e-05,0.01,0.682,0.8909194745859509,3503,3501
17,7104,10,100,1e-05,0.01,0.684,0.897240990990991,3553,3551
17,7204,10,100,1e-05,0.01,0.67,0.8913103831204886,3606,3598
17,7304,10,100,1e-05,0.01,0.698,0.8969058050383352,3652,3652
17,7404,10,100,1e-05,0.01,0.66,0.8476499189627229,3707,3697
17,7504,10,100,1e-05,0.01,0.688,0.8383528784648188,3750,3754
17,7604,10,100,1e-05,0.01,0.666,0.8574434508153603,3802,3802
17,7704,10,100,1e-05,0.01,0.664,0.8639667705088265,3857,3847
17,7804,10,100,1e-05,0.01,0.69,0.8769861609431061,3914,3890
17,7904,10,100,1e-05,0.01,0.66,0.8461538461538461,3958,3946
17,8004,10,100,1e-05,0.01,0.702,0.8768115942028986,4010,3994
17,8104,10,100,1e-05,0.01,0.682,0.8672260612043435,4068,4036
17,8204,10,100,1e-05,0.01,0.674,0.8733544612384203,4118,4086
17,8304,10,100,1e-05,0.01,0.692,0.8658477842003853,4173,4131
17,8404,10,100,1e-05,0.01,0.684,0.8925511661113755,4221,4183
17,8504,10,100,1e-05,0.01,0.682,0.8948730009407337,4264,4240
17,8604,10,100,1e-05,0.01,0.672,0.8851696885169689,4307,4297
17,8704,10,100,1e-05,0.01,0.686,0.8934972426470589,4357,4347
17,8804,10,100,1e-05,0.01,0.672,0.8834620626987733,4410,4394
17,8904,10,100,1e-05,0.01,0.682,0.8891509433962265,4468,4436
17,9004,10,100,1e-05,0.01,0.692,0.8728342958685029,4522,4482
17,9104,10,100,1e-05,0.01,0.68,0.8610500878734623,4570,4534
17,9204,10,100,1e-05,0.01,0.702,0.8784224250325945,4624,4580
17,9304,10,100,1e-05,0.01,0.696,0.8748925193465176,4677,4627
17,9404,10,100,1e-05,0.01,0.692,0.8949383241173968,4723,4681
17,9504,10,100,1e-05,0.01,0.698,0.8898358585858586,4772,4732
17,9604,10,100,1e-05,0.01,0.7,0.8944189920866306,4819,4785
17,9704,10,100,1e-05,0.01,0.69,0.8941673536685902,4873,4831
17,9804,10,100,1e-05,0.01,0.718,0.893920848633211,4928,4876
17,9904,10,100,1e-05,0.01,0.712,0.8866114701130856,4982,4922
17,10004,10,100,1e-05,0.01,0.696,0.8814474210315874,5027,4977
17,10104,10,100,1e-05,0.01,0.71,0.8819279493269992,5084,5020
17,10204,10,100,1e-05,0.01,0.73,0.8820070560564485,5137,5067
17,10304,10,100,1e-05,0.01,0.746,0.8813082298136646,5180,5124
17,10404,10,100,1e-05,0.01,0.724,0.8891772395232603,5226,5178
17,10504,10,100,1e-05,0.01,0.704,0.8937547600913938,5271,5233
17,10604,10,100,1e-05,0.01,0.712,0.9025839305922293,5323,5281
17,10704,10,100,1e-05,0.01,0.746,0.9119020926756353,5372,5332
17,10804,10,100,1e-05,0.01,0.758,0.9130877452795261,5420,5384
17,10904,10,100,1e-05,0.01,0.73,0.9105832721936904,5471,5433
17,11004,10,100,1e-05,0.01,0.736,0.9168484187568157,5525,5479
17,11104,10,100,1e-05,0.01,0.744,0.9112932276657061,5565,5539
17,11204,10,100,1e-05,0.01,0.73,0.9156551231702963,5620,5584
17,11304,10,100,1e-05,0.01,0.758,0.9033970276008493,5671,5633
17,11404,10,100,1e-05,0.01,0.746,0.9009119607155384,5721,5683
17,11504,10,100,1e-05,0.01,0.742,0.8980354659248957,5775,5729
17,11604,10,100,1e-05,0.01,0.738,0.909944846604619,5821,5783
17,11704,10,100,1e-05,0.01,0.702,0.893796992481203,5870,5834
17,11804,10,100,1e-05,0.01,0.728,0.9051169095221958,5928,5876
17,11904,10,100,1e-05,0.01,0.738,0.9007056451612904,5980,5924
17,12004,10,100,1e-05,0.01,0.746,0.9081139620126625,6030,5974
17,12104,10,100,1e-05,0.01,0.738,0.9099471249173827,6074,6030
17,12204,10,100,1e-05,0.01,0.726,0.9001147164863978,6128,6076
17,12304,10,100,1e-05,0.01,0.756,0.9050715214564369,6178,6126
17,12404,10,100,1e-05,0.01,0.762,0.9059980651402774,6227,6177
17,12504,10,100,1e-05,0.01,0.75,0.9155470249520153,6279,6225
17,12604,10,100,1e-05,0.01,0.786,0.9177245318946367,6323,6281
17,12704,10,100,1e-05,0.01,0.77,0.9156958438287154,6380,6324
17,12804,10,100,1e-05,0.01,0.756,0.9196344892221181,6436,6368
17,12904,10,100,1e-05,0.01,0.786,0.9243645381277124,6481,6423
17,13004,10,100,1e-05,0.01,0.78,0.9181021224238696,6534,6470
17,13104,10,100,1e-05,0.01,0.784,0.9326923076923077,6584,6520
17,13204,10,100,1e-05,0.01,0.778,0.9117691608603453,6644,6560
17,13304,10,100,1e-05,0.01,0.762,0.8843205051112447,6689,6615
17,13404,10,100,1e-05,0.01,0.782,0.9156968069233065,6744,6660
17,13504,10,100,1e-05,0.01,0.78,0.9183204976303317,6792,6712
17,13604,10,100,1e-05,0.01,0.776,0.9230373419582476,6838,6766
17,13704,10,100,1e-05,0.01,0.784,0.9070344424985406,6887,6817
17,13804,10,100,1e-05,0.01,0.756,0.9025644740654882,6947,6857
17,13904,10,100,1e-05,0.01,0.804,0.9089470655926352,6990,6914
17,14004,10,100,1e-05,0.01,0.78,0.9116680948300485,7037,6967
17,14104,10,100,1e-05,0.01,0.824,0.9346284741917187,7087,7017
17,14204,10,100,1e-05,0.01,0.772,0.9204449450858913,7134,7070
17,14304,10,100,1e-05,0.01,0.782,0.9154781879194631,7176,7128
17,14404,10,100,1e-05,0.01,0.782,0.929950013885032,7226,7178
17,14504,10,100,1e-05,0.01,0.802,0.9293987865416437,7267,7237
17,14604,10,100,1e-05,0.01,0.788,0.9192002191180498,7308,7296
17,14704,10,100,1e-05,0.01,0.776,0.9186615886833515,7357,7347
17,14804,10,100,1e-05,0.01,0.802,0.932112942447987,7405,7399
17,14904,10,100,1e-05,0.01,0.816,0.9317632850241546,7457,7447
17,15004,10,100,1e-05,0.01,0.816,0.9262196747533991,7500,7504
18,104,10,100,1e-05,0.01,0.48,0.5865384615384616,43,61
18,204,10,100,1e-05,0.01,0.476,0.5735294117647058,88,116
18,304,10,100,1e-05,0.01,0.474,0.5460526315789473,132,172
18,404,10,100,1e-05,0.01,0.476,0.6163366336633663,172,232
18,504,10,100,1e-05,0.01,0.488,0.6051587301587301,224,280
18,604,10,100,1e-05,0.01,0.486,0.6192052980132451,278,326
18,704,10,100,1e-05,0.01,0.514,0.5823863636363636,333,371
18,804,10,100,1e-05,0.01,0.47,0.6243781094527363,382,422
18,904,10,100,1e-05,0.01,0.468,0.6404867256637168,432,472
18,1004,10,100,1e-05,0.01,0.496,0.651394422310757,482,522
18,1104,10,100,1e-05,0.01,0.482,0.6277173913043478,530,574
18,1204,10,100,1e-05,0.01,0.484,0.6586378737541528,576,628
18,1304,10,100,1e-05,0.01,0.466,0.6434049079754601,624,680
18,1404,10,100,1e-05,0.01,0.498,0.6645299145299145,674,730
18,1504,10,100,1e-05,0.01,0.496,0.6788563829787234,720,784
18,1604,10,100,1e-05,0.01,0.488,0.7051122194513716,774,830
18,1704,10,100,1e-05,0.01,0.506,0.7089201877934272,823,881
18,1804,10,100,1e-05,0.01,0.51,0.7444567627494457,871,933
18,1904,10,100,1e-05,0.01,0.508,0.7715336134453782,928,976
18,2004,10,100,1e-05,0.01,0.51,0.751996007984032,977,1027
18,2104,10,100,1e-05,0.01,0.522,0.7666349809885932,1026,1078
18,2204,10,100,1e-05,0.01,0.524,0.8039927404718693,1072,1132
18,2304,10,100,1e-05,0.01,0.504,0.7786458333333334,1116,1188
18,2404,10,100,1e-05,0.01,0.552,0.8049084858569051,1163,1241
18,2504,10,100,1e-05,0.01,0.582,0.7519968051118211,1216,1288
18,2604,10,100,1e-05,0.01,0.586,0.8091397849462365,1278,1326
18,2704,10,100,1e-05,0.01,0.608,0.8206360946745562,1322,1382
18,2804,10,100,1e-05,0.01,0.636,0.8573466476462197,1376,1428
18,2904,10,100,1e-05,0.01,0.652,0.8632920110192838,1434,1470
18,3004,10,100,1e-05,0.01,0.646,0.8558588548601864,1473,1531
18,3104,10,100,1e-05,0.01,0.656,0.8443943298969072,1512,1592
18,3204,10,100,1e-05,0.01,0.68,0.8589263420724095,1567,1637
18,3304,10,100,1e-05,0.01,0.698,0.8689467312348669,1611,1693
18,3404,10,100,1e-05,0.01,0.708,0.8904230317273796,1656,1748
18,3504,10,100,1e-05,0.01,0.75,0.8998287671232876,1710,1794
18,3604,10,100,1e-05,0.01,0.708,0.8881798002219756,1748,1856
18,3704,10,100,1e-05,0.01,0.694,0.8393628509719222,1803,1901
18,3804,10,100,1e-05,0.01,0.708,0.8840694006309149,1856,1948
18,3904,10,100,1e-05,0.01,0.742,0.9047131147540983,1910,1994
18,4004,10,100,1e-05,0.01,0.738,0.9028471528471529,1968,2036
18,4104,10,100,1e-05,0.01,0.72,0.8455165692007798,2020,2084
18,4204,10,100,1e-05,0.01,0.754,0.8877259752616555,2069,2135
18,4304,10,100,1e-05,0.01,0.774,0.9114776951672863,2112,2192
18,4404,10,100,1e-05,0.01,0.766,0.9241598546775659,2163,2241
18,4504,10,100,1e-05,0.01,0.784,0.9249555950266429,2206,2298
18,4604,10,100,1e-05,0.01,0.804,0.9365768896611643,2250,2354
18,4704,10,100,1e-05,0.01,0.792,0.9368622448979592,2300,2404
18,4804,10,100,1e-05,0.01,0.798,0.9356786011656952,2356,2448
18,4904,10,100,1e-05,0.01,0.808,0.9537112561174551,2404,2500
18,5004,10,100,1e-05,0.01,0.79,0.9280575539568345,2452,2552
18,5104,10,100,1e-05,0.01,0.816,0.9433777429467085,2500,2604
18,5204,10,100,1e-05,0.01,0.802,0.9496541122213682,2549,2655
18,5304,10,100,1e-05,0.01,0.83,0.9547511312217195,2598,2706
18,5404,10,100,1e-05,0.01,0.814,0.9489267209474463,2650,2754
18,5504,10,100,1e-05,0.01,0.812,0.9375,2702,2802
18,5604,10,100,1e-05,0.01,0.818,0.9527123483226267,2754,2850
18,5704,10,100,1e-05,0.01,0.838,0.9542426367461431,2804,2900
18,5804,10,100,1e-05,0.01,0.848,0.9600275671950379,2847,2957
18,5904,10,100,1e-05,0.01,0.83,0.9644308943089431,2901,3003
18,6004,10,100,1e-05,0.01,0.82,0.9593604263824117,2949,3055
18,6104,10,100,1e-05,0.01,0.828,0.9303735255570118,2992,3112
18,6204,10,100,1e-05,0.01,0.822,0.9434235976789168,3039,3165
18,6304,10,100,1e-05,0.01,0.838,0.9473350253807107,3095,3209
18,6404,10,100,1e-05,0.01,0.832,0.9564334790755777,3149,3255
18,6504,10,100,1e-05,0.01,0.862,0.9554120541205412,3204,3300
18,6604,10,100,1e-05,0.01,0.856,0.9574500302846759,3262,3342
18,6704,10,100,1e-05,0.01,0.846,0.9588305489260143,3307,3397
18,6804,10,100,1e-05,0.01,0.816,0.9385655496766608,3365,3439
18,6904,10,100,1e-05,0.01,0.802,0.9375724217844728,3430,3474
18,7004,10,100,1e-05,0.01,0.824,0.950456881781839,3478,3526
18,7104,10,100,1e-05,0.01,0.844,0.964527027027027,3527,3577
18,7204,10,100,1e-05,0.01,0.838,0.95988339811216,3577,3627
18,7304,10,100,1e-05,0.01,0.858,0.9701533406352684,3631,3673
18,7404,10,100,1e-05,0.01,0.858,0.9724473257698542,3677,3727
18,7504,10,100,1e-05,0.01,0.846,0.960820895522388,3730,3774
18,7604,10,100,1e-05,0.01,0.838,0.9550236717517097,3778,3826
18,7704,10,100,1e-05,0.01,0.86,0.9653426791277259,3835,3869
18,7804,10,100,1e-05,0.01,0.84,0.9648898001025116,3884,3920
18,7904,10,100,1e-05,0.01,0.868,0.9581224696356275,3929,3975
18,8004,10,100,1e-05,0.01,0.86,0.9647676161919041,3980,4024
18,8104,10,100,1e-05,0.01,0.876,0.9659427443237907,4029,4075
18,8204,10,100,1e-05,0.01,0.844,0.9494149195514383,4076,4128
18,8304,10,100,1e-05,0.01,0.856,0.9685693641618497,4129,4175
18,8404,10,100,1e-05,0.01,0.87,0.96573060447406,4174,4230
18,8504,10,100,1e-05,0.01,0.88,0.9714252116650988,4222,4282
18,8604,10,100,1e-05,0.01,0.858,0.9645513714551371,4272,4332
18,8704,10,100,1e-05,0.01,0.828,0.9366957720588235,4328,4376
18,8804,10,100,1e-05,0.01,0.854,0.9552476147205815,4380,4424
18,8904,10,100,1e-05,0.01,0.852,0.9481132075471698,4430,4474
18,9004,10,100,1e-05,0.01,0.872,0.9660151043980453,4486,4518
18,9104,10,100,1e-05,0.01,0.862,0.9663884007029877,4534,4570
18,9204,10,100,1e-05,0.01,0.868,0.9666449369839201,4579,4625
18,9304,10,100,1e-05,0.01,0.878,0.9735597592433362,4629,4675
18,9404,10,100,1e-05,0.01,0.838,0.9351339855380689,4676,4728
18,9504,10,100,1e-05,0.01,0.858,0.9269781144781145,4718,4786
18,9604,10,100,1e-05,0.01,0.878,0.9509579341940858,4772,4832
18,9704,10,100,1e-05,0.01,0.858,0.9619744435284419,4824,4880
18,9804,10,100,1e-05,0.01,0.874,0.9660342717258262,4870,4934
18,9904,10,100,1e-05,0.01,0.872,0.9705169628432956,4919,4985
18,10004,10,100,1e-05,0.01,0.89,0.9703118752499,4965,5039
18,10104,10,100,1e-05,0.01,0.874,0.9766429136975455,5016,5088
18,10204,10,100,1e-05,0.01,0.854,0.9455115640925127,5069,5135
18,10304,10,100,1e-05,0.01,0.85,0.936626552795031,5116,5188
18,10404,10,100,1e-05,0.01,0.868,0.960399846212995,5161,5243
18,10504,10,100,1e-05,0.01,0.888,0.9708682406702208,5209,5295
18,10604,10,100,1e-05,0.01,0.88,0.9684081478687288,5264,5340
18,10704,10,100,1e-05,0.01,0.892,0.9754297458893871,5318,5386
18,10804,10,100,1e-05,0.01,0.876,0.9614031840059237,5363,5441
18,10904,10,100,1e-05,0.01,0.878,0.9712032281731474,5415,5489
18,11004,10,100,1e-05,0.01,0.894,0.97264631043257,5469,5535
18,11104,10,100,1e-05,0.01,0.874,0.9587536023054755,5516,5588
18,11204,10,100,1e-05,0.01,0.876,0.9706354873259551,5571,5633
18,11304,10,100,1e-05,0.01,0.884,0.9739030431705591,5624,5680
18,11404,10,100,1e-05,0.01,0.878,0.9682567520168363,5665,5739
18,11504,10,100,1e-05,0.01,0.884,0.969923504867872,5716,5788
18,11604,10,100,1e-05,0.01,0.88,0.9772492244053774,5757,5847
18,11704,10,100,1e-05,0.01,0.894,0.9787252221462748,5815,5889
18,11804,10,100,1e-05,0.01,0.894,0.9761945103354795,5862,5942
18,11904,10,100,1e-05,0.01,0.882,0.9718581989247311,5913,5991
18,12004,10,100,1e-05,0.01,0.908,0.9801732755748084,5957,6047
18,12104,10,100,1e-05,0.01,0.882,0.9787673496364838,6007,6097
18,12204,10,100,1e-05,0.01,0.894,0.9749262536873157,6059,6145
18,12304,10,100,1e-05,0.01,0.892,0.97870611183355,6106,6198
18,12404,10,100,1e-05,0.01,0.904,0.9755723960012899,6153,6251
18,12504,10,100,1e-05,0.01,0.906,0.9849648112603967,6197,6307
18,12604,10,100,1e-05,0.01,0.884,0.9597746747064424,6245,6359
18,12704,10,100,1e-05,0.01,0.9,0.9771725440806045,6302,6402
18,12804,10,100,1e-05,0.01,0.908,0.9837550765385817,6357,6447
18,12904,10,100,1e-05,0.01,0.904,0.9803936763794172,6412,6492
18,13004,10,100,1e-05,0.01,0.914,0.9812365426022762,6464,6540
18,13104,10,100,1e-05,0.01,0.902,0.9821428571428571,6512,6592
18,13204,10,100,1e-05,0.01,0.9,0.9757649197212965,6561,6643
18,13304,10,100,1e-05,0.01,0.9,0.972714972940469,6613,6691
18,13404,10,100,1e-05,0.01,0.888,0.9719486720381976,6663,6741
18,13504,10,100,1e-05,0.01,0.898,0.9774140995260664,6711,6793
18,13604,10,100,1e-05,0.01,0.902,0.9830197000882094,6772,6832
18,13704,10,100,1e-05,0.01,0.904,0.9808814944541739,6825,6879
18,13804,10,100,1e-05,0.01,0.902,0.975804114749348,6873,6931
18,13904,10,100,1e-05,0.01,0.902,0.9745397008055235,6927,6977
18,14004,10,100,1e-05,0.01,0.898,0.9735789774350185,6976,7028
18,14104,10,100,1e-05,0.01,0.92,0.9809982983550766,7026,7078
18,14204,10,100,1e-05,0.01,0.906,0.9788791889608561,7077,7127
18,14304,10,100,1e-05,0.01,0.916,0.9841303131991052,7133,7171
18,14404,10,100,1e-05,0.01,0.904,0.9797278533740628,7183,7221
18,14504,10,100,1e-05,0.01,0.904,0.9753861003861004,7240,7264
18,14604,10,100,1e-05,0.01,0.892,0.9710353327855382,7300,7304
18,14704,10,100,1e-05,0.01,0.898,0.9779651795429815,7351,7353
18,14804,10,100,1e-05,0.01,0.91,0.975749797352067,7396,7408
18,14904,10,100,1e-05,0.01,0.906,0.9853059581320451,7436,7468
18,15004,10,100,1e-05,0.01,0.906,0.9793388429752066,7492,7512
19,104,10,100,1e-05,0.01,0.506,0.7211538461538461,55,49
19,204,10,100,1e-05,0.01,0.514,0.4950980392156863,113,91
19,304,10,100,1e-05,0.01,0.482,0.6710526315789473,151,153
19,404,10,100,1e-05,0.01,0.498,0.6113861386138614,204,200
19,504,10,100,1e-05,0.01,0.498,0.6369047619047619,259,245
19,604,10,100,1e-05,0.01,0.516,0.6672185430463576,318,286
19,704,10,100,1e-05,0.01,0.508,0.6221590909090909,366,338
19,804,10,100,1e-05,0.01,0.494,0.6455223880597015,412,392
19,904,10,100,1e-05,0.01,0.496,0.6426991150442478,463,441
19,1004,10,100,1e-05,0.01,0.512,0.6743027888446215,514,490
19,1104,10,100,1e-05,0.01,0.526,0.6811594202898551,561,543
19,1204,10,100,1e-05,0.01,0.492,0.6893687707641196,610,594
19,1304,10,100,1e-05,0.01,0.514,0.6771472392638037,659,645
19,1404,10,100,1e-05,0.01,0.536,0.6944444444444444,704,700
19,1504,10,100,1e-05,0.01,0.52,0.6795212765957447,763,741
19,1604,10,100,1e-05,0.01,0.542,0.6701995012468828,812,792
19,1704,10,100,1e-05,0.01,0.536,0.7241784037558685,863,841
19,1804,10,100,1e-05,0.01,0.55,0.7488913525498891,918,886
19,1904,10,100,1e-05,0.01,0.536,0.7552521008403361,967,937
19,2004,10,100,1e-05,0.01,0.528,0.7854291417165669,1016,988
19,2104,10,100,1e-05,0.01,0.536,0.7813688212927756,1068,1036
19,2204,10,100,1e-05,0.01,0.54,0.8044464609800362,1105,1099
19,2304,10,100,1e-05,0.01,0.58,0.8233506944444444,1160,1144
19,2404,10,100,1e-05,0.01,0.572,0.7795341098169717,1208,1196
19,2504,10,100,1e-05,0.01,0.628,0.8170926517571885,1251,1253
19,2604,10,100,1e-05,0.01,0.612,0.8218125960061444,1306,1298
19,2704,10,100,1e-05,0.01,0.624,0.834319526627219,1357,1347
19,2804,10,100,1e-05,0.01,0.638,0.8495007132667618,1410,1394
19,2904,10,100,1e-05,0.01,0.684,0.8601928374655647,1457,1447
19,3004,10,100,1e-05,0.01,0.664,0.8648468708388815,1510,1494
19,3104,10,100,1e-05,0.01,0.644,0.8698453608247423,1560,1544
19,3204,10,100,1e-05,0.01,0.674,0.8517478152309613,1611,1593
19,3304,10,100,1e-05,0.01,0.688,0.8550242130750605,1657,1647
19,3404,10,100,1e-05,0.01,0.666,0.8663337250293772,1717,1687
19,3504,10,100,1e-05,0.01,0.668,0.8815639269406392,1766,1738
19,3604,10,100,1e-05,0.01,0.662,0.8781908990011099,1815,1789
19,3704,10,100,1e-05,0.01,0.726,0.9033477321814255,1866,1838
19,3804,10,100,1e-05,0.01,0.674,0.8882754994742377,1918,1886
19,3904,10,100,1e-05,0.01,0.692,0.8767930327868853,1967,1937
19,4004,10,100,1e-05,0.01,0.716,0.8968531468531469,2018,1986
19,4104,10,100,1e-05,0.01,0.724,0.9039961013645225,2082,2022
19,4204,10,100,1e-05,0.01,0.712,0.852045670789724,2127,2077
19,4304,10,100,1e-05,0.01,0.682,0.8643122676579925,2173,2131
19,4404,10,100,1e-05,0.01,0.708,0.8807901907356949,2222,2182
19,4504,10,100,1e-05,0.01,0.73,0.8925399644760214,2273,2231
19,4604,10,100,1e-05,0.01,0.74,0.9020417028670721,2318,2286
19,4704,10,100,1e-05,0.01,0.742,0.9153911564625851,2366,2338
19,4804,10,100,1e-05,0.01,0.694,0.8963363863447127,2424,2380
19,4904,10,100,1e-05,0.01,0.718,0.8780587275693311,2472,2432
19,5004,10,100,1e-05,0.01,0.722,0.8890887290167866,2522,2482
19,5104,10,100,1e-05,0.01,0.72,0.8665752351097179,2569,2535
19,5204,10,100,1e-05,0.01,0.75,0.8777863182167563,2629,2575
19,5304,10,100,1e-05,0.01,0.758,0.9138386123680241,2674,2630
19,5404,10,100,1e-05,0.01,0.756,0.9095114729829755,2724,2680
19,5504,10,100,1e-05,0.01,0.746,0.9156976744186046,2785,2719
19,5604,10,100,1e-05,0.01,0.78,0.9163097787294789,2830,2774
19,5704,10,100,1e-05,0.01,0.748,0.9151472650771388,2877,2827
19,5804,10,100,1e-05,0.01,0.748,0.9143694004135079,2921,2883
19,5904,10,100,1e-05,0.01,0.776,0.9305555555555556,2970,2934
19,6004,10,100,1e-05,0.01,0.762,0.9230512991339107,3015,2989
19,6104,10,100,1e-05,0.01,0.774,0.927916120576671,3064,3040
19,6204,10,100,1e-05,0.01,0.774,0.9171502256608639,3115,3089
19,6304,10,100,1e-05,0.01,0.792,0.9267131979695431,3168,3136
19,6404,10,100,1e-05,0.01,0.784,0.9392567145534041,3208,3196
19,6504,10,100,1e-05,0.01,0.786,0.9309655596555966,3258,3246
19,6604,10,100,1e-05,0.01,0.742,0.9147486371895821,3300,3304
19,6704,10,100,1e-05,0.01,0.792,0.9198985680190931,3360,3344
19,6804,10,100,1e-05,0.01,0.76,0.9050558495002939,3413,3391
19,6904,10,100,1e-05,0.01,0.8,0.9238122827346466,3464,3440
19,7004,10,100,1e-05,0.01,0.78,0.9207595659623072,3510,3494
19,7104,10,100,1e-05,0.01,0.812,0.9235641891891891,3564,3540
19,7204,10,100,1e-05,0.01,0.804,0.9315657967795669,3616,3588
19,7304,10,100,1e-05,0.01,0.708,0.8411829134720701,3661,3643
19,7404,10,100,1e-05,0.01,0.752,0.9024851431658563,3712,3692
19,7504,10,100,1e-05,0.01,0.748,0.8968550106609808,3768,3736
19,7604,10,100,1e-05,0.01,0.798,0.9176749079431878,3815,3789
19,7704,10,100,1e-05,0.01,0.796,0.9347092419522326,3871,3833
19,7804,10,100,1e-05,0.01,0.8,0.935545873910815,3921,3883
19,7904,10,100,1e-05,0.01,0.8,0.94040991902834,3970,3934
19,8004,10,100,1e-05,0.01,0.798,0.9230384807596201,4015,3989
19,8104,10,100,1e-05,0.01,0.782,0.9025172754195459,4058,4046
19,8204,10,100,1e-05,0.01,0.798,0.9058995611896635,4108,4096
19,8304,10,100,1e-05,0.01,0.762,0.8931840077071291,4165,4139
19,8404,10,100,1e-05,0.01,0.794,0.9218229414564493,4213,4191
19,8504,10,100,1e-05,0.01,0.774,0.9198024459078081,4261,4243
19,8604,10,100,1e-05,0.01,0.8,0.9317759181775919,4305,4299
19,8704,10,100,1e-05,0.01,0.812,0.9526654411764706,4350,4354
19,8804,10,100,1e-05,0.01,0.804,0.9327578373466606,4398,4406
19,8904,10,100,1e-05,0.01,0.752,0.8808400718778078,4448,4456
19,9004,10,100,1e-05,0.01,0.784,0.929253665037761,4501,4503
19,9104,10,100,1e-05,0.01,0.8,0.9391476274165202,4545,4559
19,9204,10,100,1e-05,0.01,0.816,0.9465449804432855,4586,4618
19,9304,10,100,1e-05,0.01,0.814,0.9538907996560619,4643,4661
19,9404,10,100,1e-05,0.01,0.808,0.9523606975754998,4700,4704
19,9504,10,100,1e-05,0.01,0.826,0.9545454545454546,4743,4761
19,9604,10,100,1e-05,0.01,0.816,0.952207413577676,4795,4809
19,9704,10,100,1e-05,0.01,0.816,0.9490931574608409,4843,4861
19,9804,10,100,1e-05,0.01,0.818,0.9556303549571603,4888,4916
19,9904,10,100,1e-05,0.01,0.838,0.9563812600969306,4943,4961
19,10004,10,100,1e-05,0.01,0.844,0.9528188724510196,4993,5011
19,10104,10,100,1e-05,0.01,0.832,0.9536817102137767,5045,5059
19,10204,10,100,1e-05,0.01,0.814,0.9375735005880047,5096,5108
19,10304,10,100,1e-05,0.01,0.76,0.8853843167701864,5149,5155
19,10404,10,100,1e-05,0.01,0.802,0.9206074586697424,5195,5209
19,10504,10,100,1e-05,0.01,0.83,0.9384996191926885,5245,5259
19,10604,10,100,1e-05,0.01,0.822,0.9470011316484346,5300,5304
19,10704,10,100,1e-05,0.01,0.846,0.9502989536621823,5341,5363
19,10804,10,100,1e-05,0.01,0.802,0.9286375416512402,5391,5413
19,10904,10,100,1e-05,0.01,0.83,0.9308510638297872,5440,5464
19,11004,10,100,1e-05,0.01,0.838,0.9434750999636495,5488,5516
19,11104,10,100,1e-05,0.01,0.83,0.954971181556196,5532,5572
19,11204,10,100,1e-05,0.01,0.87,0.961888611210282,5591,5613
19,11304,10,100,1e-05,0.01,0.862,0.9624911535739561,5650,5654
19,11404,10,100,1e-05,0.01,0.848,0.9485268326902841,5701,5703
19,11504,10,100,1e-05,0.01,0.858,0.9510605006954103,5745,5759
19,11604,10,100,1e-05,0.01,0.872,0.9669079627714581,5794,5810
19,11704,10,100,1e-05,0.01,0.848,0.9575358851674641,5851,5853
19,11804,10,100,1e-05,0.01,0.864,0.9649271433412403,5899,5905
19,11904,10,100,1e-05,0.01,0.86,0.9698420698924731,5943,5961
19,12004,10,100,1e-05,0.01,0.87,0.9656781072975674,5988,6016
19,12104,10,100,1e-05,0.01,0.88,0.9691011235955056,6046,6058
19,12204,10,100,1e-05,0.01,0.858,0.9482956407735169,6096,6108
19,12304,10,100,1e-05,0.01,0.878,0.9496098829648895,6149,6155
19,12404,10,100,1e-05,0.01,0.862,0.9279264753305385,6200,6204
19,12504,10,100,1e-05,0.01,0.884,0.9530550223928342,6245,6259
19,12604,10,100,1e-05,0.01,0.926,0.969612821326563,6294,6310
19,12704,10,100,1e-05,0.01,0.918,0.9675692695214105,6350,6354
19,12804,10,100,1e-05,0.01,0.926,0.9804748516088723,6402,6402
19,12904,10,100,1e-05,0.01,0.924,0.9799287042777434,6449,6455
19,13004,10,100,1e-05,0.01,0.894,0.9633189787757613,6495,6509
19,13104,10,100,1e-05,0.01,0.896,0.9686355311355311,6539,6565
19,13204,10,100,1e-05,0.01,0.926,0.9836413208118752,6587,6617
19,13304,10,100,1e-05,0.01,0.912,0.9816596512327119,6642,6662
19,13404,10,100,1e-05,0.01,0.932,0.9835123843628768,6696,6708
19,13504,10,100,1e-05,0.01,0.92,0.9814129146919431,6741,6763
19,13604,10,100,1e-05,0.01,0.912,0.9747133196118789,6798,6806
19,13704,10,100,1e-05,0.01,0.922,0.9842381786339754,6846,6858
19,13804,10,100,1e-05,0.01,0.93,0.9771805273833671,6899,6905
19,13904,10,100,1e-05,0.01,0.938,0.9696490218642118,6958,6946
19,14004,10,100,1e-05,0.01,0.946,0.983076263924593,7011,6993
19,14104,10,100,1e-05,0.01,0.938,0.9867413499716392,7070,7034
19,14204,10,100,1e-05,0.01,0.946,0.9853562376795268,7116,7088
19,14304,10,100,1e-05,0.01,0.95,0.9865072706935123,7165,7139
19,14404,10,100,1e-05,0.01,0.944,0.9870869202999167,7219,7185
19,14504,10,100,1e-05,0.01,0.928,0.975799779371208,7271,7233
19,14604,10,100,1e-05,0.01,0.934,0.9707614352232266,7309,7295
19,14704,10,100,1e-05,0.01,0.956,0.9872823721436343,7352,7352
19,14804,10,100,1e-05,0.01,0.948,0.9908808430154012,7404,7400
19,14904,10,100,1e-05,0.01,0.964,0.9905394524959742,7457,7447
19,15004,10,100,1e-05,0.01,0.936,0.9698080511863503,7510,7494
20,104,10,100,1e-05,0.01,0.496,0.47115384615384615,55,49
20,204,10,100,1e-05,0.01,0.49,0.6029411764705882,106,98
20,304,10,100,1e-05,0.01,0.52,0.6052631578947368,162,142
20,404,10,100,1e-05,0.01,0.5,0.6782178217821783,216,188
20,504,10,100,1e-05,0.01,0.49,0.6111111111111112,259,245
20,604,10,100,1e-05,0.01,0.522,0.6274834437086093,301,303
20,704,10,100,1e-05,0.01,0.488,0.6178977272727273,351,353
20,804,10,100,1e-05,0.01,0.502,0.6094527363184079,402,402
20,904,10,100,1e-05,0.01,0.514,0.6438053097345132,449,455
20,1004,10,100,1e-05,0.01,0.502,0.6832669322709163,496,508
20,1104,10,100,1e-05,0.01,0.496,0.7019927536231884,546,558
20,1204,10,100,1e-05,0.01,0.492,0.7225913621262459,594,610
20,1304,10,100,1e-05,0.01,0.498,0.7200920245398773,642,662
20,1404,10,100,1e-05,0.01,0.51,0.7364672364672364,692,712
20,1504,10,100,1e-05,0.01,0.494,0.7287234042553191,743,761
20,1604,10,100,1e-05,0.01,0.536,0.7256857855361596,800,804
20,1704,10,100,1e-05,0.01,0.482,0.7453051643192489,847,857
20,1804,10,100,1e-05,0.01,0.534,0.7976718403547672,897,907
20,1904,10,100,1e-05,0.01,0.508,0.8061974789915967,948,956
20,2004,10,100,1e-05,0.01,0.56,0.812874251497006,997,1007
20,2104,10,100,1e-05,0.01,0.534,0.810361216730038,1051,1053
20,2204,10,100,1e-05,0.01,0.542,0.8058076225045372,1102,1102
20,2304,10,100,1e-05,0.01,0.558,0.8129340277777778,1154,1150
20,2404,10,100,1e-05,0.01,0.568,0.8202995008319468,1202,1202
20,2504,10,100,1e-05,0.01,0.586,0.8458466453674122,1245,1259
20,2604,10,100,1e-05,0.01,0.612,0.8759600614439325,1289,1315
20,2704,10,100,1e-05,0.01,0.616,0.8809171597633136,1336,1368
20,2804,10,100,1e-05,0.01,0.636,0.8723252496433667,1391,1413
20,2904,10,100,1e-05,0.01,0.628,0.8040633608815427,1430,1474
20,3004,10,100,1e-05,0.01,0.692,0.8561917443408789,1473,1531
20,3104,10,100,1e-05,0.01,0.682,0.8914304123711341,1522,1582
20,3204,10,100,1e-05,0.01,0.72,0.900749063670412,1575,1629
20,3304,10,100,1e-05,0.01,0.766,0.9388619854721549,1623,1681
20,3404,10,100,1e-05,0.01,0.734,0.917743830787309,1676,1728
20,3504,10,100,1e-05,0.01,0.706,0.8687214611872146,1718,1786
20,3604,10,100,1e-05,0.01,0.712,0.9156492785793563,1771,1833
20,3704,10,100,1e-05,0.01,0.746,0.9538336933045356,1828,1876
20,3804,10,100,1e-05,0.01,0.792,0.9442691903259727,1872,1932
20,3904,10,100,1e-05,0.01,0.784,0.9585040983606558,1930,1974
20,4004,10,100,1e-05,0.01,0.794,0.9752747252747253,1984,2020
20,4104,10,100,1e-05,0.01,0.832,0.9907407407407407,2039,2065
20,4204,10,100,1e-05,0.01,0.818,0.9895337773549001,2090,2114
20,4304,10,100,1e-05,0.01,0.838,0.9881505576208178,2147,2157
20,4404,10,100,1e-05,0.01,0.826,0.9927338782924614,2197,2207
20,4504,10,100,1e-05,0.01,0.85,0.9873445825932504,2247,2257
20,4604,10,100,1e-05,0.01,0.852,0.9793657688966116,2295,2309
20,4704,10,100,1e-05,0.01,0.828,0.9840561224489796,2351,2353
20,4804,10,100,1e-05,0.01,0.864,0.9843880099916736,2392,2412
20,4904,10,100,1e-05,0.01,0.852,0.9877650897226754,2448,2456
20,5004,10,100,1e-05,0.01,0.89,0.9918065547561951,2494,2510
20,5104,10,100,1e-05,0.01,0.89,0.9954937304075235,2546,2558
20,5204,10,100,1e-05,0.01,0.878,0.9888547271329746,2599,2605
20,5304,10,100,1e-05,0.01,0.888,0.9973604826546003,2648,2656
20,5404,10,100,1e-05,0.01,0.858,0.9861213915618061,2688,2716
20,5504,10,100,1e-05,0.01,0.868,0.9801962209302325,2734,2770
20,5604,10,100,1e-05,0.01,0.86,0.9771591720199857,2790,2814
20,5704,10,100,1e-05,0.01,0.884,0.982468443197756,2840,2864
20,5804,10,100,1e-05,0.01,0.886,0.9763955892487939,2894,2910
20,5904,10,100,1e-05,0.01,0.91,0.9930555555555556,2943,2961
20,6004,10,100,1e-05,0.01,0.898,0.9888407728181212,2999,3005
20,6104,10,100,1e-05,0.01,0.904,0.9924639580602883,3052,3052
20,6204,10,100,1e-05,0.01,0.916,0.9859767891682786,3105,3099
20,6304,10,100,1e-05,0.01,0.91,0.9904822335025381,3151,3153
20,6404,10,100,1e-05,0.01,0.912,0.9912554653341662,3210,3194
20,6504,10,100,1e-05,0.01,0.912,0.9878536285362853,3267,3237
20,6604,10,100,1e-05,0.01,0.922,0.9959115687462144,3321,3283
20,6704,10,100,1e-05,0.01,0.902,0.9928400954653938,3368,3336
20,6804,10,100,1e-05,0.01,0.914,0.9894179894179894,3414,3390
20,6904,10,100,1e-05,0.01,0.91,0.9927578215527231,3460,3444
20,7004,10,100,1e-05,0.01,0.908,0.991290691033695,3506,3498
20,7104,10,100,1e-05,0.01,0.926,0.9950731981981982,3562,3542
20,7204,10,100,1e-05,0.01,0.93,0.9908384230982787,3609,3595
20,7304,10,100,1e-05,0.01,0.932,0.9923329682365827,3662,3642
20,7404,10,100,1e-05,0.01,0.912,0.9836574824419233,3720,3684
20,7504,10,100,1e-05,0.01,0.912,0.9710820895522388,3770,3734
20,7604,10,100,1e-05,0.01,0.94,0.9947396107311941,3822,3782
20,7704,10,100,1e-05,0.01,0.946,0.9949376947040498,3879,3825
20,7804,10,100,1e-05,0.01,0.942,0.993208610968734,3923,3881
20,7904,10,100,1e-05,0.01,0.962,0.9975961538461539,3975,3929
20,8004,10,100,1e-05,0.01,0.948,0.9948775612193903,4031,3973
20,8104,10,100,1e-05,0.01,0.946,0.9929664363277394,4082,4022
20,8204,10,100,1e-05,0.01,0.948,0.9960994636762555,4129,4075
20,8304,10,100,1e-05,0.01,0.962,0.9975915221579962,4176,4128
20,8404,10,100,1e-05,0.01,0.948,0.9923845787720134,4225,4179
20,8504,10,100,1e-05,0.01,0.958,0.9972953904045155,4278,4226
20,8604,10,100,1e-05,0.01,0.958,0.99767549976755,4326,4278
20,8704,10,100,1e-05,0.01,0.962,0.9986213235294118,4374,4330
20,8804,10,100,1e-05,0.01,0.97,0.999204906860518,4422,4382
20,8904,10,100,1e-05,0.01,0.964,0.9998876909254267,4475,4429
20,9004,10,100,1e-05,0.01,0.97,0.9994446912483341,4527,4477
20,9104,10,100,1e-05,0.01,0.966,0.999670474516696,4577,4527
20,9204,10,100,1e-05,0.01,0.968,0.99793568013907,4626,4578
20,9304,10,100,1e-05,0.01,0.956,0.9871023215821152,4672,4632
20,9404,10,100,1e-05,0.01,0.964,0.9901105912377711,4727,4677
20,9504,10,100,1e-05,0.01,0.974,0.9977904040404041,4777,4727
20,9604,10,100,1e-05,0.01,0.962,0.9969804248229904,4821,4783
20,9704,10,100,1e-05,0.01,0.936,0.9759892827699918,4877,4827
20,9804,10,100,1e-05,0.01,0.948,0.9839861281109751,4923,4881
20,9904,10,100,1e-05,0.01,0.97,0.9972738287560582,4969,4935
20,10004,10,100,1e-05,0.01,0.976,0.998500599760096,5020,4984
20,10104,10,100,1e-05,0.01,0.976,0.9983174980205859,5072,5032
20,10204,10,100,1e-05,0.01,0.976,0.9973539788318306,5117,5087
20,10304,10,100,1e-05,0.01,0.974,0.9978649068322981,5168,5136
20,10404,10,100,1e-05,0.01,0.978,0.999519415609381,5217,5187
20,10504,10,100,1e-05,0.01,0.966,0.9977151561309977,5261,5243
20,10604,10,100,1e-05,0.01,0.976,0.9967936627687665,5312,5292
20,10704,10,100,1e-05,0.01,0.972,0.9965433482810164,5361,5343
20,10804,10,100,1e-05,0.01,0.978,0.9975934838948538,5411,5393
20,10904,10,100,1e-05,0.01,0.982,0.9990829053558328,5464,5440
20,11004,10,100,1e-05,0.01,0.966,0.9947291893856779,5511,5493
20,11104,10,100,1e-05,0.01,0.982,0.9992795389048992,5564,5540
20,11204,10,100,1e-05,0.01,0.974,0.997054623348804,5610,5594
20,11304,10,100,1e-05,0.01,0.98,0.9974345364472753,5667,5637
20,11404,10,100,1e-05,0.01,0.982,0.9996492458786391,5708,5696
20,11504,10,100,1e-05,0.01,0.976,0.9986091794158554,5751,5753
20,11604,10,100,1e-05,0.01,0.982,0.9988796966563254,5800,5804
20,11704,10,100,1e-05,0.01,0.978,0.9992310321257689,5856,5848
20,11804,10,100,1e-05,0.01,0.976,0.9983056590986107,5900,5904
20,11904,10,100,1e-05,0.01,0.97,0.9937836021505376,5952,5952
20,12004,10,100,1e-05,0.01,0.966,0.9902532489170277,5996,6008
20,12104,10,100,1e-05,0.01,0.958,0.9767019167217449,6047,6057
20,12204,10,100,1e-05,0.01,0.984,0.9935267125532612,6099,6105
20,12304,10,100,1e-05,0.01,0.978,0.9947984395318595,6149,6155
20,12404,10,100,1e-05,0.01,0.98,0.9987100935182199,6204,6200
20,12504,10,100,1e-05,0.01,0.984,0.9991202815099168,6255,6249
20,12604,10,100,1e-05,0.01,0.984,0.999682640431609,6300,6304
20,12704,10,100,1e-05,0.01,0.988,0.9995277078085643,6349,6355
20,12804,10,100,1e-05,0.01,0.982,0.9995313964386129,6389,6415
20,12904,10,100,1e-05,0.01,0.984,0.9997675139491631,6436,6468
20,13004,10,100,1e-05,0.01,0.986,1.0,6487,6517
20,13104,10,100,1e-05,0.01,0.986,1.0,6533,6571
20,13204,10,100,1e-05,0.01,0.982,0.9998485307482581,6589,6615
20,13304,10,100,1e-05,0.01,0.98,0.9997745039085989,6645,6659
20,13404,10,100,1e-05,0.01,0.986,0.9997761862130707,6688,6716
20,13504,10,100,1e-05,0.01,0.984,0.9990373222748815,6737,6767
20,13604,10,100,1e-05,0.01,0.978,0.9979417818288738,6782,6822
20,13704,10,100,1e-05,0.01,0.984,0.9970081727962639,6823,6881
20,13804,10,100,1e-05,0.01,0.974,0.9938423645320197,6874,6930
20,13904,10,100,1e-05,0.01,0.986,0.9984177215189873,6924,6980
20,14004,10,100,1e-05,0.01,0.986,0.9982147957726364,6977,7027
20,14104,10,100,1e-05,0.01,0.99,0.9976602382302893,7023,7081
20,14204,10,100,1e-05,0.01,0.988,0.9988031540411152,7074,7130
20,14304,10,100,1e-05,0.01,0.988,0.9993708053691275,7113,7191
20,14404,10,100,1e-05,0.01,0.984,0.9996528742016106,7173,7231
20,14504,10,100,1e-05,0.01,0.99,0.9991726420297848,7227,7277
20,14604,10,100,1e-05,0.01,0.986,0.9950698438783895,7281,7323
20,14704,10,100,1e-05,0.01,0.984,0.9986398258977149,7336,7368
20,14804,10,100,1e-05,0.01,0.986,0.9991218589570386,7389,7415
20,14904,10,100,1e-05,0.01,0.988,0.9993290391841116,7443,7461
20,15004,10,100,1e-05,0.01,0.988,0.9981338309784058,7498,7506
1,104,10,100,0.0001,0.01,0.486,0.5480769230769231,57,47
1,204,10,100,0.0001,0.01,0.486,0.6323529411764706,101,103
1,304,10,100,0.0001,0.01,0.502,0.5657894736842105,145,159
1,404,10,100,0.0001,0.01,0.474,0.6311881188118812,205,199
1,504,10,100,0.0001,0.01,0.494,0.6190476190476191,251,253
1,604,10,100,0.0001,0.01,0.504,0.6291390728476821,298,306
1,704,10,100,0.0001,0.01,0.496,0.6392045454545454,343,361
1,804,10,100,0.0001,0.01,0.55,0.6554726368159204,386,418
1,904,10,100,0.0001,0.01,0.51,0.6393805309734514,437,467
1,1004,10,100,0.0001,0.01,0.498,0.6633466135458167,487,517
1,1104,10,100,0.0001,0.01,0.514,0.6422101449275363,542,562
1,1204,10,100,0.0001,0.01,0.514,0.6511627906976745,591,613
1,1304,10,100,0.0001,0.01,0.514,0.6487730061349694,646,658
1,1404,10,100,0.0001,0.01,0.548,0.6816239316239316,692,712
1,1504,10,100,0.0001,0.01,0.516,0.668218085106383,748,756
1,1604,10,100,0.0001,0.01,0.53,0.6957605985037406,810,794
1,1704,10,100,0.0001,0.01,0.538,0.7065727699530516,855,849
1,1804,10,100,0.0001,0.01,0.524,0.7145232815964523,905,899
1,1904,10,100,0.0001,0.01,0.51,0.7032563025210085,950,954
1,2004,10,100,0.0001,0.01,0.532,0.7025948103792415,992,1012
1,2104,10,100,0.0001,0.01,0.51,0.7186311787072244,1040,1064
1,2204,10,100,0.0001,0.01,0.502,0.7232304900181489,1099,1105
1,2304,10,100,0.0001,0.01,0.518,0.6983506944444444,1138,1166
1,2404,10,100,0.0001,0.01,0.522,0.7158901830282862,1194,1210
1,2504,10,100,0.0001,0.01,0.508,0.7456070287539937,1247,1257
1,2604,10,100,0.0001,0.01,0.524,0.7592165898617511,1292,1312
1,2704,10,100,0.0001,0.01,0.53,0.7544378698224852,1333,1371
1,2804,10,100,0.0001,0.01,0.522,0.7728245363766049,1391,1413
1,2904,10,100,0.0001,0.01,0.52,0.7589531680440771,1436,1468
1,3004,10,100,0.0001,0.01,0.514,0.7556591211717709,1479,1525
1,3104,10,100,0.0001,0.01,0.532,0.7538659793814433,1525,1579
1,3204,10,100,0.0001,0.01,0.538,0.784019975031211,1565,1639
1,3304,10,100,0.0001,0.01,0.532,0.7557506053268765,1616,1688
1,3404,10,100,0.0001,0.01,0.544,0.7931844888366627,1670,1734
1,3504,10,100,0.0001,0.01,0.548,0.7996575342465754,1723,1781
1,3604,10,100,0.0001,0.01,0.556,0.7741398446170921,1773,1831
1,3704,10,100,0.0001,0.01,0.552,0.7853671706263499,1823,1881
1,3804,10,100,0.0001,0.01,0.55,0.7978443743427971,1871,1933
1,3904,10,100,0.0001,0.01,0.548,0.7784323770491803,1920,1984
1,4004,10,100,0.0001,0.01,0.552,0.7992007992007992,1976,2028
1,4104,10,100,0.0001,0.01,0.592,0.8248050682261209,2024,2080
1,4204,10,100,0.0001,0.01,0.574,0.8351569933396765,2071,2133
1,4304,10,100,0.0001,0.01,0.592,0.841775092936803,2127,2177
1,4404,10,100,0.0001,0.01,0.58,0.8460490463215259,2186,2218
1,4504,10,100,0.0001,0.01,0.592,0.838809946714032,2232,2272
1,4604,10,100,0.0001,0.01,0.606,0.8507819287576021,2270,2334
1,4704,10,100,0.0001,0.01,0.594,0.8539540816326531,2315,2389
1,4804,10,100,0.0001,0.01,0.608,0.8567860116569526,2373,2431
1,4904,10,100,0.0001,0.01,0.606,0.8395187601957586,2424,2480
1,5004,10,100,0.0001,0.01,0.636,0.8439248601119105,2486,2518
1,5104,10,100,0.0001,0.01,0.638,0.8632445141065831,2546,2558
1,5204,10,100,0.0001,0.01,0.638,0.8595311299000769,2595,2609
1,5304,10,100,0.0001,0.01,0.626,0.8386123680241327,2646,2658
1,5404,10,100,0.0001,0.01,0.656,0.8615840118430792,2703,2701
1,5504,10,100,0.0001,0.01,0.64,0.8264898255813954,2744,2760
1,5604,10,100,0.0001,0.01,0.65,0.8597430406852249,2796,2808
1,5704,10,100,0.0001,0.01,0.664,0.875,2843,2861
1,5804,10,100,0.0001,0.01,0.666,0.8585458304617505,2899,2905
1,5904,10,100,0.0001,0.01,0.664,0.8516260162601627,2951,2953
1,6004,10,100,0.0001,0.01,0.686,0.869586942038641,2988,3016
1,6104,10,100,0.0001,0.01,0.7,0.8813892529488859,3044,3060
1,6204,10,100,0.0001,0.01,0.678,0.8776595744680851,3085,3119
1,6304,10,100,0.0001,0.01,0.666,0.858502538071066,3138,3166
1,6404,10,100,0.0001,0.01,0.698,0.8738288569643973,3186,3218
1,6504,10,100,0.0001,0.01,0.702,0.8857626076260763,3243,3261
1,6604,10,100,0.0001,0.01,0.68,0.8899152029073288,3299,3305
1,6704,10,100,0.0001,0.01,0.692,0.8832040572792362,3344,3360
1,6804,10,100,0.0001,0.01,0.67,0.8750734861845973,3392,3412
1,6904,10,100,0.0001,0.01,0.698,0.8474797219003476,3440,3464
1,7004,10,100,0.0001,0.01,0.702,0.8603655054254712,3491,3513
1,7104,10,100,0.0001,0.01,0.694,0.8871058558558559,3545,3559
1,7204,10,100,0.0001,0.01,0.712,0.8907551360355358,3596,3608
1,7304,10,100,0.0001,0.01,0.698,0.8777382256297919,3646,3658
1,7404,10,100,0.0001,0.01,0.712,0.8910048622366289,3692,3712
1,7504,10,100,0.0001,0.01,0.728,0.8923240938166311,3747,3757
1,7604,10,100,0.0001,0.01,0.738,0.9118884797475013,3799,3805
1,7704,10,100,0.0001,0.01,0.72,0.9110851505711319,3849,3855
1,7804,10,100,0.0001,0.01,0.75,0.910814966683752,3891,3913
1,7904,10,100,0.0001,0.01,0.77,0.9190283400809717,3944,3960
1,8004,10,100,0.0001,0.01,0.736,0.9161669165417291,3989,4015
1,8104,10,100,0.0001,0.01,0.728,0.9131293188548865,4044,4060
1,8204,10,100,0.0001,0.01,0.746,0.9278400780107264,4096,4108
1,8304,10,100,0.0001,0.01,0.73,0.9114884393063584,4144,4160
1,8404,10,100,0.0001,0.01,0.764,0.9181342217991433,4188,4216
1,8504,10,100,0.0001,0.01,0.744,0.9187441204139228,4232,4272
1,8604,10,100,0.0001,0.01,0.752,0.9155044165504417,4285,4319
1,8704,10,100,0.0001,0.01,0.764,0.9304917279411765,4335,4369
1,8804,10,100,0.0001,0.01,0.768,0.933439345751931,4381,4423
1,8904,10,100,0.0001,0.01,0.79,0.9380053908355795,4435,4469
1,9004,10,100,0.0001,0.01,0.762,0.9342514438027544,4490,4514
1,9104,10,100,0.0001,0.01,0.774,0.937609841827768,4540,4564
1,9204,10,100,0.0001,0.01,0.82,0.9470882225119513,4597,4607
1,9304,10,100,0.0001,0.01,0.776,0.9231513327601032,4646,4658
1,9404,10,100,0.0001,0.01,0.764,0.9202467035304126,4693,4711
1,9504,10,100,0.0001,0.01,0.796,0.9507575757575758,4746,4758
1,9604,10,100,0.0001,0.01,0.8,0.9482507288629738,4796,4808
1,9704,10,100,0.0001,0.01,0.808,0.9537304204451772,4844,4860
1,9804,10,100,0.0001,0.01,0.796,0.9557323541411669,4906,4898
1,9904,10,100,0.0001,0.01,0.806,0.9441639741518578,4955,4949
1,10004,10,100,0.0001,0.01,0.802,0.952718912435026,5006,4998
1,10104,10,100,0.0001,0.01,0.798,0.9519992082343627,5055,5049
1,10204,10,100,0.0001,0.01,0.828,0.9553116424931399,5109,5095
1,10304,10,100,0.0001,0.01,0.786,0.9295419254658385,5155,5149
1,10404,10,100,0.0001,0.01,0.788,0.8957131872356786,5208,5196
1,10504,10,100,0.0001,0.01,0.832,0.9314546839299315,5267,5237
1,10604,10,100,0.0001,0.01,0.816,0.9254055073557148,5320,5284
1,10704,10,100,0.0001,0.01,0.802,0.9068572496263079,5362,5342
1,10804,10,100,0.0001,0.01,0.772,0.927156608663458,5411,5393
1,10904,10,100,0.0001,0.01,0.766,0.9086573734409391,5459,5445
1,11004,10,100,0.0001,0.01,0.81,0.9352053798618684,5507,5497
1,11104,10,100,0.0001,0.01,0.826,0.9418227665706052,5559,5545
1,11204,10,100,0.0001,0.01,0.846,0.9561763655837201,5604,5600
1,11304,10,100,0.0001,0.01,0.85,0.9605449398443029,5663,5641
1,11404,10,100,0.0001,0.01,0.874,0.9642230796211856,5707,5697
1,11504,10,100,0.0001,0.01,0.858,0.961230876216968,5752,5752
1,11604,10,100,0.0001,0.01,0.84,0.9448466046190969,5795,5809
1,11704,10,100,0.0001,0.01,0.87,0.9487354750512645,5856,5848
1,11804,10,100,0.0001,0.01,0.844,0.9452727888851237,5909,5895
1,11904,10,100,0.0001,0.01,0.864,0.9647177419354839,5946,5958
1,12004,10,100,0.0001,0.01,0.874,0.9738420526491169,5997,6007
1,12104,10,100,0.0001,0.01,0.886,0.9756278916060807,6045,6059
1,12204,10,100,0.0001,0.01,0.872,0.9673877417240249,6085,6119
1,12304,10,100,0.0001,0.01,0.896,0.9820383615084526,6146,6158
1,12404,10,100,0.0001,0.01,0.876,0.9733150596581748,6201,6203
1,12504,10,100,0.0001,0.01,0.888,0.9740083173384517,6252,6252
1,12604,10,100,0.0001,0.01,0.894,0.9796096477308791,6299,6305
1,12704,10,100,0.0001,0.01,0.908,0.9871693954659949,6347,6357
1,12804,10,100,0.0001,0.01,0.918,0.9789909403311465,6393,6411
1,12904,10,100,0.0001,0.01,0.896,0.9714817110973342,6448,6456
1,13004,10,100,0.0001,0.01,0.9,0.980852045524454,6495,6509
1,13104,10,100,0.0001,0.01,0.914,0.9801587301587301,6552,6552
1,13204,10,100,0.0001,0.01,0.92,0.9842471978188427,6601,6603
1,13304,10,100,0.0001,0.01,0.932,0.9819603126879134,6665,6639
1,13404,10,100,0.0001,0.01,0.928,0.9753804834377797,6711,6693
1,13504,10,100,0.0001,0.01,0.848,0.9167654028436019,6760,6744
1,13604,10,100,0.0001,0.01,0.862,0.9461922963834166,6813,6791
1,13704,10,100,0.0001,0.01,0.894,0.9721249270286048,6863,6841
1,13804,10,100,0.0001,0.01,0.92,0.9729788467110982,6908,6896
1,13904,10,100,0.0001,0.01,0.928,0.9803653624856157,6958,6946
1,14004,10,100,0.0001,0.01,0.918,0.9747215081405313,6996,7008
1,14104,10,100,0.0001,0.01,0.92,0.9779495178672717,7049,7055
1,14204,10,100,0.0001,0.01,0.936,0.9813432835820896,7110,7094
1,14304,10,100,0.0001,0.01,0.926,0.9872762863534675,7161,7143
1,14404,10,100,0.0001,0.01,0.934,0.981185781727298,7212,7192
1,14504,10,100,0.0001,0.01,0.914,0.9829702151130723,7261,7243
1,14604,10,100,0.0001,0.01,0.934,0.9843193645576555,7309,7295
1,14704,10,100,0.0001,0.01,0.94,0.9896626768226333,7359,7345
1,14804,10,100,0.0001,0.01,0.92,0.9816941367198054,7407,7397
1,14904,10,100,0.0001,0.01,0.934,0.9845679012345679,7465,7439
1,15004,10,100,0.0001,0.01,0.934,0.9815382564649426,7509,7495
2,104,10,100,0.0001,0.01,0.486,0.5288461538461539,49,55
2,204,10,100,0.0001,0.01,0.51,0.6568627450980392,97,107
2,304,10,100,0.0001,0.01,0.518,0.6842105263157895,138,166
2,404,10,100,0.0001,0.01,0.508,0.6683168316831684,186,218
2,504,10,100,0.0001,0.01,0.508,0.6626984126984127,239,265
2,604,10,100,0.0001,0.01,0.504,0.6870860927152318,288,316
2,704,10,100,0.0001,0.01,0.49,0.6690340909090909,339,365
2,804,10,100,0.0001,0.01,0.514,0.6691542288557214,383,421
2,904,10,100,0.0001,0.01,0.52,0.6648230088495575,429,475
2,1004,10,100,0.0001,0.01,0.48,0.6613545816733067,480,524
2,1104,10,100,0.0001,0.01,0.492,0.6748188405797102,526,578
2,1204,10,100,0.0001,0.01,0.508,0.6710963455149501,582,622
2,1304,10,100,0.0001,0.01,0.484,0.6641104294478528,631,673
2,1404,10,100,0.0001,0.01,0.5,0.6552706552706553,688,716
2,1504,10,100,0.0001,0.01,0.514,0.6768617021276596,746,758
2,1604,10,100,0.0001,0.01,0.508,0.6751870324189526,796,808
2,1704,10,100,0.0001,0.01,0.514,0.6719483568075117,841,863
2,1804,10,100,0.0001,0.01,0.508,0.7045454545454546,893,911
2,1904,10,100,0.0001,0.01,0.5,0.7069327731092437,941,963
2,2004,10,100,0.0001,0.01,0.51,0.7070858283433133,990,1014
2,2104,10,100,0.0001,0.01,0.498,0.6920152091254753,1043,1061
2,2204,10,100,0.0001,0.01,0.506,0.691923774954628,1099,1105
2,2304,10,100,0.0001,0.01,0.512,0.6879340277777778,1151,1153
2,2404,10,100,0.0001,0.01,0.5,0.7175540765391015,1204,1200
2,2504,10,100,0.0001,0.01,0.512,0.7156549520766773,1247,1257
2,2604,10,100,0.0001,0.01,0.512,0.716973886328725,1303,1301
2,2704,10,100,0.0001,0.01,0.494,0.7181952662721893,1356,1348
2,2804,10,100,0.0001,0.01,0.5,0.7360912981455064,1398,1406
2,2904,10,100,0.0001,0.01,0.482,0.7252066115702479,1446,1458
2,3004,10,100,0.0001,0.01,0.484,0.7440079893475366,1494,1510
2,3104,10,100,0.0001,0.01,0.482,0.759020618556701,1547,1557
2,3204,10,100,0.0001,0.01,0.488,0.7521847690387016,1590,1614
2,3304,10,100,0.0001,0.01,0.478,0.7321428571428571,1639,1665
2,3404,10,100,0.0001,0.01,0.5,0.7259106933019976,1693,1711
2,3504,10,100,0.0001,0.01,0.498,0.6914954337899544,1745,1759
2,3604,10,100,0.0001,0.01,0.5,0.7205882352941176,1790,1814
2,3704,10,100,0.0001,0.01,0.49,0.7365010799136069,1836,1868
2,3804,10,100,0.0001,0.01,0.484,0.7613038906414301,1883,1921
2,3904,10,100,0.0001,0.01,0.504,0.7361680327868853,1935,1969
2,4004,10,100,0.0001,0.01,0.516,0.7502497502497503,1984,2020
2,4104,10,100,0.0001,0.01,0.524,0.7694931773879142,2041,2063
2,4204,10,100,0.0001,0.01,0.518,0.7809229305423406,2095,2109
2,4304,10,100,0.0001,0.01,0.528,0.7764869888475836,2147,2157
2,4404,10,100,0.0001,0.01,0.528,0.8022252497729337,2196,2208
2,4504,10,100,0.0001,0.01,0.518,0.8119449378330373,2249,2255
2,4604,10,100,0.0001,0.01,0.536,0.7943092962641182,2292,2312
2,4704,10,100,0.0001,0.01,0.562,0.8112244897959183,2349,2355
2,4804,10,100,0.0001,0.01,0.55,0.7858034970857619,2388,2416
2,4904,10,100,0.0001,0.01,0.544,0.7748776508972267,2447,2457
2,5004,10,100,0.0001,0.01,0.534,0.8117505995203836,2497,2507
2,5104,10,100,0.0001,0.01,0.572,0.817398119122257,2547,2557
2,5204,10,100,0.0001,0.01,0.568,0.82532667179093,2601,2603
2,5304,10,100,0.0001,0.01,0.572,0.8282428355957768,2650,2654
2,5404,10,100,0.0001,0.01,0.538,0.8417838638045891,2702,2702
2,5504,10,100,0.0001,0.01,0.582,0.8272165697674418,2757,2747
2,5604,10,100,0.0001,0.01,0.592,0.8488579586009993,2801,2803
2,5704,10,100,0.0001,0.01,0.566,0.8338008415147266,2854,2850
2,5804,10,100,0.0001,0.01,0.576,0.8368366643694004,2906,2898
2,5904,10,100,0.0001,0.01,0.604,0.815379403794038,2951,2953
2,6004,10,100,0.0001,0.01,0.62,0.8359427048634244,3003,3001
2,6104,10,100,0.0001,0.01,0.592,0.8261795543905636,3054,3050
2,6204,10,100,0.0001,0.01,0.6,0.8457446808510638,3106,3098
2,6304,10,100,0.0001,0.01,0.634,0.850729695431472,3157,3147
2,6404,10,100,0.0001,0.01,0.606,0.8572767020612118,3213,3191
2,6504,10,100,0.0001,0.01,0.59,0.8388683886838868,3264,3240
2,6604,10,100,0.0001,0.01,0.624,0.8738643246517263,3315,3289
2,6704,10,100,0.0001,0.01,0.604,0.8741050119331742,3366,3338
2,6804,10,100,0.0001,0.01,0.626,0.8935920047031158,3414,3390
2,6904,10,100,0.0001,0.01,0.616,0.8671784472769409,3459,3445
2,7004,10,100,0.0001,0.01,0.62,0.8727869788692176,3512,3492
2,7104,10,100,0.0001,0.01,0.636,0.8773930180180181,3570,3534
2,7204,10,100,0.0001,0.01,0.646,0.8882565241532482,3615,3589
2,7304,10,100,0.0001,0.01,0.65,0.8873220153340635,3661,3643
2,7404,10,100,0.0001,0.01,0.64,0.890194489465154,3715,3689
2,7504,10,100,0.0001,0.01,0.652,0.8722014925373134,3765,3739
2,7604,10,100,0.0001,0.01,0.67,0.8878221988427144,3812,3792
2,7704,10,100,0.0001,0.01,0.67,0.8965472481827622,3867,3837
2,7804,10,100,0.0001,0.01,0.646,0.8940287032291133,3929,3875
2,7904,10,100,0.0001,0.01,0.65,0.9014423076923077,3978,3926
2,8004,10,100,0.0001,0.01,0.666,0.8974262868565717,4031,3973
2,8104,10,100,0.0001,0.01,0.636,0.8905478775913129,4085,4019
2,8204,10,100,0.0001,0.01,0.674,0.893466601657728,4138,4066
2,8304,10,100,0.0001,0.01,0.658,0.8953516377649325,4187,4117
2,8404,10,100,0.0001,0.01,0.68,0.9062351261304141,4236,4168
2,8504,10,100,0.0001,0.01,0.706,0.910865475070555,4284,4220
2,8604,10,100,0.0001,0.01,0.688,0.9093444909344491,4332,4272
2,8704,10,100,0.0001,0.01,0.694,0.9140625,4382,4322
2,8804,10,100,0.0001,0.01,0.71,0.896637891867333,4433,4371
2,8904,10,100,0.0001,0.01,0.682,0.8820754716981132,4480,4424
2,9004,10,100,0.0001,0.01,0.696,0.8963793869391382,4533,4471
2,9104,10,100,0.0001,0.01,0.702,0.9002636203866432,4584,4520
2,9204,10,100,0.0001,0.01,0.704,0.8975445458496306,4634,4570
2,9304,10,100,0.0001,0.01,0.7,0.9103611349957008,4690,4614
2,9404,10,100,0.0001,0.01,0.724,0.9153551680136113,4742,4662
2,9504,10,100,0.0001,0.01,0.72,0.9134048821548821,4786,4718
2,9604,10,100,0.0001,0.01,0.716,0.9209704289879217,4832,4772
2,9704,10,100,0.0001,0.01,0.736,0.9191055234954658,4878,4826
2,9804,10,100,0.0001,0.01,0.724,0.9120767033863729,4936,4868
2,9904,10,100,0.0001,0.01,0.716,0.8936793214862682,4987,4917
2,10004,10,100,0.0001,0.01,0.72,0.9017393042782886,5036,4968
2,10104,10,100,0.0001,0.01,0.722,0.8787608867775138,5087,5017
2,10204,10,100,0.0001,0.01,0.694,0.8905331242649941,5133,5071
2,10304,10,100,0.0001,0.01,0.73,0.9088703416149069,5185,5119
2,10404,10,100,0.0001,0.01,0.716,0.9033064206074587,5237,5167
2,10504,10,100,0.0001,0.01,0.734,0.9084158415841584,5279,5225
2,10604,10,100,0.0001,0.01,0.72,0.9179554884949076,5328,5276
2,10704,10,100,0.0001,0.01,0.74,0.9183482810164425,5377,5327
2,10804,10,100,0.0001,0.01,0.734,0.9197519437245465,5423,5381
2,10904,10,100,0.0001,0.01,0.704,0.9111335289801907,5470,5434
2,11004,10,100,0.0001,0.01,0.694,0.9096692111959288,5518,5486
2,11104,10,100,0.0001,0.01,0.716,0.9156159942363112,5561,5543
2,11204,10,100,0.0001,0.01,0.744,0.9169939307390218,5619,5585
2,11304,10,100,0.0001,0.01,0.738,0.9188782731776363,5661,5643
2,11404,10,100,0.0001,0.01,0.752,0.9249386180287619,5704,5700
2,11504,10,100,0.0001,0.01,0.742,0.9190716272600834,5753,5751
2,11604,10,100,0.0001,0.01,0.752,0.9192519820751465,5816,5788
2,11704,10,100,0.0001,0.01,0.746,0.9142173615857826,5857,5847
2,11804,10,100,0.0001,0.01,0.756,0.9264656048797018,5912,5892
2,11904,10,100,0.0001,0.01,0.724,0.910198252688172,5963,5941
2,12004,10,100,0.0001,0.01,0.756,0.9314395201599467,6013,5991
2,12104,10,100,0.0001,0.01,0.738,0.9250660938532717,6053,6051
2,12204,10,100,0.0001,0.01,0.77,0.9276466732218944,6108,6096
2,12304,10,100,0.0001,0.01,0.738,0.9171001300390117,6159,6145
2,12404,10,100,0.0001,0.01,0.75,0.9376813930990003,6213,6191
2,12504,10,100,0.0001,0.01,0.754,0.9189059500959693,6267,6237
2,12604,10,100,0.0001,0.01,0.758,0.9204220882259601,6324,6280
2,12704,10,100,0.0001,0.01,0.778,0.9296284634760705,6372,6332
2,12804,10,100,0.0001,0.01,0.782,0.9202592939706342,6425,6379
2,12904,10,100,0.0001,0.01,0.756,0.9281618102913826,6479,6425
2,13004,10,100,0.0001,0.01,0.762,0.9265610581359581,6527,6477
2,13104,10,100,0.0001,0.01,0.774,0.9336843711843712,6578,6526
2,13204,10,100,0.0001,0.01,0.75,0.9288851863071796,6626,6578
2,13304,10,100,0.0001,0.01,0.778,0.9436259771497294,6675,6629
2,13404,10,100,0.0001,0.01,0.792,0.9410623694419576,6724,6680
2,13504,10,100,0.0001,0.01,0.764,0.9334271327014217,6775,6729
2,13604,10,100,0.0001,0.01,0.794,0.9349456042340488,6821,6783
2,13704,10,100,0.0001,0.01,0.804,0.9357851722124927,6866,6838
2,13804,10,100,0.0001,0.01,0.788,0.9289336424224862,6918,6886
2,13904,10,100,0.0001,0.01,0.788,0.9204545454545454,6972,6932
2,14004,10,100,0.0001,0.01,0.778,0.922093687517852,7021,6983
2,14104,10,100,0.0001,0.01,0.806,0.9299489506522972,7072,7032
2,14204,10,100,0.0001,0.01,0.79,0.9377640101379893,7114,7090
2,14304,10,100,0.0001,0.01,0.814,0.930089485458613,7169,7135
2,14404,10,100,0.0001,0.01,0.784,0.9316856428769786,7209,7195
2,14504,10,100,0.0001,0.01,0.804,0.9287782680639823,7261,7243
2,14604,10,100,0.0001,0.01,0.8,0.9298137496576281,7307,7297
2,14704,10,100,0.0001,0.01,0.782,0.9219260065288357,7349,7355
2,14804,10,100,0.0001,0.01,0.802,0.9336665766009187,7393,7411
2,14904,10,100,0.0001,0.01,0.818,0.9361916264090178,7441,7463
2,15004,10,100,0.0001,0.01,0.81,0.9324846707544655,7495,7509
3,104,10,100,0.0001,0.01,0.544,0.5192307692307693,54,50
3,204,10,100,0.0001,0.01,0.52,0.6176470588235294,100,104
3,304,10,100,0.0001,0.01,0.492,0.5723684210526315,160,144
3,404,10,100,0.0001,0.01,0.534,0.6361386138613861,214,190
3,504,10,100,0.0001,0.01,0.538,0.625,268,236
3,604,10,100,0.0001,0.01,0.538,0.6539735099337748,320,284
3,704,10,100,0.0001,0.01,0.556,0.6477272727272727,373,331
3,804,10,100,0.0001,0.01,0.536,0.6616915422885572,418,386
3,904,10,100,0.0001,0.01,0.506,0.6438053097345132,459,445
3,1004,10,100,0.0001,0.01,0.5,0.6882470119521913,510,494
3,1104,10,100,0.0001,0.01,0.51,0.6847826086956522,564,540
3,1204,10,100,0.0001,0.01,0.498,0.7009966777408638,607,597
3,1304,10,100,0.0001,0.01,0.48,0.7024539877300614,655,649
3,1404,10,100,0.0001,0.01,0.518,0.6638176638176638,703,701
3,1504,10,100,0.0001,0.01,0.476,0.6861702127659575,762,742
3,1604,10,100,0.0001,0.01,0.5,0.699501246882793,821,783
3,1704,10,100,0.0001,0.01,0.516,0.6672535211267606,873,831
3,1804,10,100,0.0001,0.01,0.498,0.7128603104212861,925,879
3,1904,10,100,0.0001,0.01,0.53,0.6769957983193278,968,936
3,2004,10,100,0.0001,0.01,0.484,0.6911177644710579,1023,981
3,2104,10,100,0.0001,0.01,0.542,0.6696768060836502,1069,1035
3,2204,10,100,0.0001,0.01,0.49,0.7082577132486388,1114,1090
3,2304,10,100,0.0001,0.01,0.54,0.6909722222222222,1160,1144
3,2404,10,100,0.0001,0.01,0.516,0.6980033277870217,1212,1192
3,2504,10,100,0.0001,0.01,0.498,0.7056709265175719,1259,1245
3,2604,10,100,0.0001,0.01,0.488,0.7258064516129032,1299,1305
3,2704,10,100,0.0001,0.01,0.51,0.7230029585798816,1341,1363
3,2804,10,100,0.0001,0.01,0.522,0.7457203994293866,1396,1408
3,2904,10,100,0.0001,0.01,0.532,0.740358126721763,1445,1459
3,3004,10,100,0.0001,0.01,0.542,0.7453395472703063,1486,1518
3,3104,10,100,0.0001,0.01,0.524,0.7364690721649485,1541,1563
3,3204,10,100,0.0001,0.01,0.53,0.7599875156054932,1585,1619
3,3304,10,100,0.0001,0.01,0.518,0.7621065375302664,1634,1670
3,3404,10,100,0.0001,0.01,0.516,0.7541128084606346,1675,1729
3,3504,10,100,0.0001,0.01,0.516,0.7756849315068494,1728,1776
3,3604,10,100,0.0001,0.01,0.524,0.7627635960044395,1782,1822
3,3704,10,100,0.0001,0.01,0.546,0.765658747300216,1831,1873
3,3804,10,100,0.0001,0.01,0.522,0.7812828601472135,1878,1926
3,3904,10,100,0.0001,0.01,0.536,0.7666495901639344,1933,1971
3,4004,10,100,0.0001,0.01,0.528,0.7822177822177823,1986,2018
3,4104,10,100,0.0001,0.01,0.5,0.8009259259259259,2036,2068
3,4204,10,100,0.0001,0.01,0.51,0.801617507136061,2086,2118
3,4304,10,100,0.0001,0.01,0.514,0.8134293680297398,2129,2175
3,4404,10,100,0.0001,0.01,0.506,0.7951861943687557,2190,2214
3,4504,10,100,0.0001,0.01,0.504,0.7533303730017762,2245,2259
3,4604,10,100,0.0001,0.01,0.528,0.7823631624674197,2304,2300
3,4704,10,100,0.0001,0.01,0.522,0.7933673469387755,2348,2356
3,4804,10,100,0.0001,0.01,0.518,0.8136969192339717,2398,2406
3,4904,10,100,0.0001,0.01,0.534,0.8056688417618271,2449,2455
3,5004,10,100,0.0001,0.01,0.532,0.8103517186250999,2492,2512
3,5104,10,100,0.0001,0.01,0.55,0.8105407523510971,2547,2557
3,5204,10,100,0.0001,0.01,0.562,0.8297463489623367,2596,2608
3,5304,10,100,0.0001,0.01,0.568,0.8171191553544495,2650,2654
3,5404,10,100,0.0001,0.01,0.548,0.8371576609918578,2698,2706
3,5504,10,100,0.0001,0.01,0.544,0.8246729651162791,2751,2753
3,5604,10,100,0.0001,0.01,0.586,0.8369022127052106,2795,2809
3,5704,10,100,0.0001,0.01,0.56,0.8425666199158486,2849,2855
3,5804,10,100,0.0001,0.01,0.566,0.8287388008270159,2902,2902
3,5904,10,100,0.0001,0.01,0.56,0.8040311653116531,2954,2950
3,6004,10,100,0.0001,0.01,0.576,0.8192871419053964,3001,3003
3,6104,10,100,0.0001,0.01,0.558,0.8104521625163827,3048,3056
3,6204,10,100,0.0001,0.01,0.588,0.8305931656995487,3098,3106
3,6304,10,100,0.0001,0.01,0.558,0.8220177664974619,3151,3153
3,6404,10,100,0.0001,0.01,0.566,0.834634603372892,3208,3196
3,6504,10,100,0.0001,0.01,0.572,0.818880688806888,3260,3244
3,6604,10,100,0.0001,0.01,0.54,0.8217746820109025,3308,3296
3,6704,10,100,0.0001,0.01,0.532,0.8421837708830548,3353,3351
3,6804,10,100,0.0001,0.01,0.544,0.8405349794238683,3406,3398
3,6904,10,100,0.0001,0.01,0.554,0.8574739281575898,3456,3448
3,7004,10,100,0.0001,0.01,0.562,0.8617932609937179,3508,3496
3,7104,10,100,0.0001,0.01,0.572,0.8236204954954955,3557,3547
3,7204,10,100,0.0001,0.01,0.61,0.8416157690172127,3608,3596
3,7304,10,100,0.0001,0.01,0.59,0.8640470974808324,3658,3646
3,7404,10,100,0.0001,0.01,0.574,0.864397622906537,3713,3691
3,7504,10,100,0.0001,0.01,0.576,0.8482142857142857,3755,3749
3,7604,10,100,0.0001,0.01,0.598,0.8673066806943713,3809,3795
3,7704,10,100,0.0001,0.01,0.608,0.8690290758047767,3866,3838
3,7804,10,100,0.0001,0.01,0.598,0.8798052280881599,3909,3895
3,7904,10,100,0.0001,0.01,0.58,0.874746963562753,3962,3942
3,8004,10,100,0.0001,0.01,0.6,0.8785607196401799,4014,3990
3,8104,10,100,0.0001,0.01,0.624,0.8874629812438302,4060,4044
3,8204,10,100,0.0001,0.01,0.602,0.879205265724037,4119,4085
3,8304,10,100,0.0001,0.01,0.584,0.8389932562620424,4165,4139
3,8404,10,100,0.0001,0.01,0.614,0.8607805806758686,4212,4192
3,8504,10,100,0.0001,0.01,0.6,0.867826904985889,4251,4253
3,8604,10,100,0.0001,0.01,0.638,0.8799395629939563,4308,4296
3,8704,10,100,0.0001,0.01,0.614,0.8400735294117647,4367,4337
3,8804,10,100,0.0001,0.01,0.628,0.8726715129486597,4418,4386
3,8904,10,100,0.0001,0.01,0.674,0.8802785265049416,4474,4430
3,9004,10,100,0.0001,0.01,0.63,0.8745002221235006,4521,4483
3,9104,10,100,0.0001,0.01,0.626,0.8777460456942003,4581,4523
3,9204,10,100,0.0001,0.01,0.638,0.8857018687527162,4627,4577
3,9304,10,100,0.0001,0.01,0.64,0.8779019776440241,4684,4620
3,9404,10,100,0.0001,0.01,0.638,0.8782433007230965,4737,4667
3,9504,10,100,0.0001,0.01,0.632,0.8755260942760943,4782,4722
3,9604,10,100,0.0001,0.01,0.63,0.8826530612244898,4834,4770
3,9704,10,100,0.0001,0.01,0.622,0.8789159109645507,4883,4821
3,9804,10,100,0.0001,0.01,0.624,0.8825989392084863,4935,4869
3,9904,10,100,0.0001,0.01,0.674,0.8607633279483037,4986,4918
3,10004,10,100,0.0001,0.01,0.628,0.8824470211915234,5033,4971
3,10104,10,100,0.0001,0.01,0.67,0.8931116389548693,5084,5020
3,10204,10,100,0.0001,0.01,0.666,0.904155233241866,5134,5070
3,10304,10,100,0.0001,0.01,0.642,0.8816964285714286,5188,5116
3,10404,10,100,0.0001,0.01,0.656,0.8928296808919647,5234,5170
3,10504,10,100,0.0001,0.01,0.672,0.898990860624524,5278,5226
3,10604,10,100,0.0001,0.01,0.642,0.8878725009430404,5328,5276
3,10704,10,100,0.0001,0.01,0.616,0.8739723467862481,5392,5312
3,10804,10,100,0.0001,0.01,0.66,0.8929100333209923,5438,5366
3,10904,10,100,0.0001,0.01,0.688,0.8801357300073368,5489,5415
3,11004,10,100,0.0001,0.01,0.68,0.9011268629589241,5537,5467
3,11104,10,100,0.0001,0.01,0.67,0.9061599423631124,5596,5508
3,11204,10,100,0.0001,0.01,0.684,0.9027133166726169,5644,5560
3,11304,10,100,0.0001,0.01,0.654,0.8942852087756546,5695,5609
3,11404,10,100,0.0001,0.01,0.678,0.8956506488951245,5740,5664
3,11504,10,100,0.0001,0.01,0.674,0.9043810848400556,5786,5718
3,11604,10,100,0.0001,0.01,0.66,0.8971044467425026,5834,5770
3,11704,10,100,0.0001,0.01,0.672,0.8917464114832536,5891,5813
3,11804,10,100,0.0001,0.01,0.67,0.8953744493392071,5931,5873
3,11904,10,100,0.0001,0.01,0.69,0.896505376344086,5978,5926
3,12004,10,100,0.0001,0.01,0.686,0.9020326557814062,6020,5984
3,12104,10,100,0.0001,0.01,0.694,0.906146728354263,6068,6036
3,12204,10,100,0.0001,0.01,0.698,0.912569649295313,6115,6089
3,12304,10,100,0.0001,0.01,0.678,0.9088101430429129,6169,6135
3,12404,10,100,0.0001,0.01,0.668,0.9092228313447275,6212,6192
3,12504,10,100,0.0001,0.01,0.71,0.8948336532309661,6256,6248
3,12604,10,100,0.0001,0.01,0.716,0.9043160901301174,6307,6297
3,12704,10,100,0.0001,0.01,0.71,0.8967254408060453,6353,6351
3,12804,10,100,0.0001,0.01,0.678,0.8860512339893784,6397,6407
3,12904,10,100,0.0001,0.01,0.72,0.8730626162430254,6446,6458
3,13004,10,100,0.0001,0.01,0.732,0.8915718240541372,6489,6515
3,13104,10,100,0.0001,0.01,0.686,0.8962148962148963,6540,6564
3,13204,10,100,0.0001,0.01,0.716,0.8995758860951227,6594,6610
3,13304,10,100,0.0001,0.01,0.728,0.8970986169573061,6645,6659
3,13404,10,100,0.0001,0.01,0.73,0.912861832288869,6687,6717
3,13504,10,100,0.0001,0.01,0.74,0.9215787914691943,6735,6769
3,13604,10,100,0.0001,0.01,0.738,0.9168626874448692,6787,6817
3,13704,10,100,0.0001,0.01,0.756,0.9314068884997081,6834,6870
3,13804,10,100,0.0001,0.01,0.72,0.9215444798609099,6875,6929
3,13904,10,100,0.0001,0.01,0.752,0.9072209436133487,6933,6971
3,14004,10,100,0.0001,0.01,0.756,0.9119537275064268,6983,7021
3,14104,10,100,0.0001,0.01,0.77,0.9249149177538287,7031,7073
3,14204,10,100,0.0001,0.01,0.76,0.928822866798085,7083,7121
3,14304,10,100,0.0001,0.01,0.762,0.926663870246085,7131,7173
3,14404,10,100,0.0001,0.01,0.75,0.9172452096639823,7176,7228
3,14504,10,100,0.0001,0.01,0.76,0.9257446221731936,7227,7277
3,14604,10,100,0.0001,0.01,0.806,0.9263900301287319,7277,7327
3,14704,10,100,0.0001,0.01,0.786,0.9271626768226333,7332,7372
3,14804,10,100,0.0001,0.01,0.784,0.931977843825993,7382,7422
3,14904,10,100,0.0001,0.01,0.772,0.9170692431561996,7430,7474
3,15004,10,100,0.0001,0.01,0.788,0.9360837110103972,7480,7524
4,104,10,100,0.0001,0.01,0.488,0.5480769230769231,48,56
4,204,10,100,0.0001,0.01,0.512,0.6323529411764706,96,108
4,304,10,100,0.0001,0.01,0.504,0.5953947368421053,147,157
4,404,10,100,0.0001,0.01,0.534,0.6089108910891089,194,210
4,504,10,100,0.0001,0.01,0.554,0.623015873015873,245,259
4,604,10,100,0.0001,0.01,0.476,0.6225165562913907,287,317
4,704,10,100,0.0001,0.01,0.518,0.6548295454545454,338,366
4,804,10,100,0.0001,0.01,0.504,0.667910447761194,402,402
4,904,10,100,0.0001,0.01,0.512,0.6537610619469026,459,445
4,1004,10,100,0.0001,0.01,0.53,0.6733067729083665,502,502
4,1104,10,100,0.0001,0.01,0.542,0.6811594202898551,547,557
4,1204,10,100,0.0001,0.01,0.566,0.6835548172757475,590,614
4,1304,10,100,0.0001,0.01,0.544,0.696319018404908,652,652
4,1404,10,100,0.0001,0.01,0.532,0.707977207977208,699,705
4,1504,10,100,0.0001,0.01,0.558,0.7081117021276596,761,743
4,1604,10,100,0.0001,0.01,0.516,0.7182044887780549,807,797
4,1704,10,100,0.0001,0.01,0.504,0.6965962441314554,858,846
4,1804,10,100,0.0001,0.01,0.514,0.7344789356984479,910,894
4,1904,10,100,0.0001,0.01,0.482,0.7410714285714286,962,942
4,2004,10,100,0.0001,0.01,0.49,0.7539920159680639,1015,989
4,2104,10,100,0.0001,0.01,0.518,0.7666349809885932,1065,1039
4,2204,10,100,0.0001,0.01,0.538,0.764519056261343,1117,1087
4,2304,10,100,0.0001,0.01,0.536,0.7565104166666666,1166,1138
4,2404,10,100,0.0001,0.01,0.526,0.7420965058236273,1215,1189
4,2504,10,100,0.0001,0.01,0.528,0.7172523961661342,1278,1226
4,2604,10,100,0.0001,0.01,0.514,0.7484639016897081,1324,1280
4,2704,10,100,0.0001,0.01,0.542,0.7592455621301775,1378,1326
4,2804,10,100,0.0001,0.01,0.524,0.7671184022824536,1437,1367
4,2904,10,100,0.0001,0.01,0.526,0.7565426997245179,1485,1419
4,3004,10,100,0.0001,0.01,0.516,0.7716378162450066,1536,1468
4,3104,10,100,0.0001,0.01,0.542,0.7802835051546392,1591,1513
4,3204,10,100,0.0001,0.01,0.534,0.7893258426966292,1637,1567
4,3304,10,100,0.0001,0.01,0.544,0.7814769975786925,1689,1615
4,3404,10,100,0.0001,0.01,0.51,0.7843713278495887,1741,1663
4,3504,10,100,0.0001,0.01,0.538,0.7734018264840182,1789,1715
4,3604,10,100,0.0001,0.01,0.536,0.7985571587125416,1840,1764
4,3704,10,100,0.0001,0.01,0.544,0.7672786177105831,1892,1812
4,3804,10,100,0.0001,0.01,0.55,0.785751840168244,1939,1865
4,3904,10,100,0.0001,0.01,0.554,0.7730532786885246,1987,1917
4,4004,10,100,0.0001,0.01,0.552,0.7874625374625375,2029,1975
4,4104,10,100,0.0001,0.01,0.526,0.7714424951267057,2088,2016
4,4204,10,100,0.0001,0.01,0.53,0.7909134157944815,2142,2062
4,4304,10,100,0.0001,0.01,0.522,0.8106412639405205,2186,2118
4,4404,10,100,0.0001,0.01,0.548,0.8115349682107176,2242,2162
4,4504,10,100,0.0001,0.01,0.542,0.808392539964476,2296,2208
4,4604,10,100,0.0001,0.01,0.572,0.8116854908774979,2329,2275
4,4704,10,100,0.0001,0.01,0.54,0.8137755102040817,2383,2321
4,4804,10,100,0.0001,0.01,0.544,0.8268109908409659,2440,2364
4,4904,10,100,0.0001,0.01,0.562,0.8299347471451876,2488,2416
4,5004,10,100,0.0001,0.01,0.55,0.836730615507594,2527,2477
4,5104,10,100,0.0001,0.01,0.56,0.8128918495297806,2579,2525
4,5204,10,100,0.0001,0.01,0.558,0.8345503458877787,2623,2581
4,5304,10,100,0.0001,0.01,0.572,0.8403092006033183,2670,2634
4,5404,10,100,0.0001,0.01,0.548,0.8488156920799408,2712,2692
4,5504,10,100,0.0001,0.01,0.598,0.8364825581395349,2758,2746
4,5604,10,100,0.0001,0.01,0.578,0.862062812276945,2800,2804
4,5704,10,100,0.0001,0.01,0.57,0.8380084151472651,2841,2863
4,5804,10,100,0.0001,0.01,0.542,0.8425223983459683,2889,2915
4,5904,10,100,0.0001,0.01,0.536,0.8499322493224932,2941,2963
4,6004,10,100,0.0001,0.01,0.596,0.8382744836775483,2990,3014
4,6104,10,100,0.0001,0.01,0.58,0.8171690694626474,3049,3055
4,6204,10,100,0.0001,0.01,0.566,0.8467117988394585,3104,3100
4,6304,10,100,0.0001,0.01,0.59,0.8664340101522843,3158,3146
4,6404,10,100,0.0001,0.01,0.59,0.8711742660836976,3210,3194
4,6504,10,100,0.0001,0.01,0.59,0.8305658056580566,3265,3239
4,6604,10,100,0.0001,0.01,0.602,0.8562992125984252,3316,3288
4,6704,10,100,0.0001,0.01,0.62,0.8651551312649165,3360,3344
4,6804,10,100,0.0001,0.01,0.608,0.8672839506172839,3409,3395
4,6904,10,100,0.0001,0.01,0.598,0.8809385863267671,3461,3443
4,7004,10,100,0.0001,0.01,0.59,0.8566533409480297,3512,3492
4,7104,10,100,0.0001,0.01,0.604,0.809543918918919,3560,3544
4,7204,10,100,0.0001,0.01,0.614,0.8552193225985564,3612,3592
4,7304,10,100,0.0001,0.01,0.622,0.8618565169769989,3661,3643
4,7404,10,100,0.0001,0.01,0.612,0.8814154511075094,3704,3700
4,7504,10,100,0.0001,0.01,0.63,0.8864605543710021,3757,3747
4,7604,10,100,0.0001,0.01,0.646,0.8824302998421883,3804,3800
4,7704,10,100,0.0001,0.01,0.63,0.8921339563862928,3859,3845
4,7804,10,100,0.0001,0.01,0.618,0.8954382368016401,3911,3893
4,7904,10,100,0.0001,0.01,0.644,0.9016953441295547,3960,3944
4,8004,10,100,0.0001,0.01,0.626,0.9054222888555722,4020,3984
4,8104,10,100,0.0001,0.01,0.636,0.8677196446199408,4077,4027
4,8204,10,100,0.0001,0.01,0.654,0.8871282301316431,4126,4078
4,8304,10,100,0.0001,0.01,0.618,0.8801782273603083,4170,4134
4,8404,10,100,0.0001,0.01,0.646,0.8875535459305093,4213,4191
4,8504,10,100,0.0001,0.01,0.648,0.8812323612417686,4259,4245
4,8604,10,100,0.0001,0.01,0.658,0.8867968386796838,4304,4300
4,8704,10,100,0.0001,0.01,0.634,0.9040670955882353,4358,4346
4,8804,10,100,0.0001,0.01,0.624,0.8759654702407996,4405,4399
4,8904,10,100,0.0001,0.01,0.622,0.8971248876909255,4448,4456
4,9004,10,100,0.0001,0.01,0.622,0.9032652154597957,4508,4496
4,9104,10,100,0.0001,0.01,0.642,0.906085237258348,4548,4556
4,9204,10,100,0.0001,0.01,0.648,0.9128639721860061,4609,4595
4,9304,10,100,0.0001,0.01,0.662,0.913585554600172,4663,4641
4,9404,10,100,0.0001,0.01,0.61,0.9088685665674181,4702,4702
4,9504,10,100,0.0001,0.01,0.638,0.9171927609427609,4756,4748
4,9604,10,100,0.0001,0.01,0.64,0.9101416076634735,4812,4792
4,9704,10,100,0.0001,0.01,0.646,0.8866446826051113,4855,4849
4,9804,10,100,0.0001,0.01,0.65,0.8984088127294981,4899,4905
4,9904,10,100,0.0001,0.01,0.64,0.906502423263328,4952,4952
4,10004,10,100,0.0001,0.01,0.666,0.9120351859256297,5001,5003
4,10104,10,100,0.0001,0.01,0.63,0.8960807600950119,5051,5053
4,10204,10,100,0.0001,0.01,0.652,0.8956291650333202,5099,5105
4,10304,10,100,0.0001,0.01,0.656,0.9045031055900621,5148,5156
4,10404,10,100,0.0001,0.01,0.624,0.905517108804306,5203,5201
4,10504,10,100,0.0001,0.01,0.626,0.9128903274942879,5249,5255
4,10604,10,100,0.0001,0.01,0.59,0.8909845341380611,5300,5304
4,10704,10,100,0.0001,0.01,0.642,0.8988228699551569,5351,5353
4,10804,10,100,0.0001,0.01,0.616,0.8937430581266198,5403,5401
4,10904,10,100,0.0001,0.01,0.616,0.8849046221570066,5451,5453
4,11004,10,100,0.0001,0.01,0.646,0.8991275899672846,5512,5492
4,11104,10,100,0.0001,0.01,0.634,0.9012067723342939,5559,5545
4,11204,10,100,0.0001,0.01,0.656,0.9054801856479828,5603,5601
4,11304,10,100,0.0001,0.01,0.644,0.9084394904458599,5652,5652
4,11404,10,100,0.0001,0.01,0.654,0.9107330761136443,5707,5697
4,11504,10,100,0.0001,0.01,0.638,0.9162899860917941,5763,5741
4,11604,10,100,0.0001,0.01,0.664,0.921664943123061,5811,5793
4,11704,10,100,0.0001,0.01,0.63,0.9183185235816814,5860,5844
4,11804,10,100,0.0001,0.01,0.642,0.9166384276516435,5921,5883
4,11904,10,100,0.0001,0.01,0.672,0.920866935483871,5966,5938
4,12004,10,100,0.0001,0.01,0.69,0.907947350883039,6010,5994
4,12104,10,100,0.0001,0.01,0.648,0.9082947785855915,6058,6046
4,12204,10,100,0.0001,0.01,0.654,0.9167486070140938,6106,6098
4,12304,10,100,0.0001,0.01,0.674,0.9132802340702211,6152,6152
4,12404,10,100,0.0001,0.01,0.67,0.8885037084811351,6208,6196
4,12504,10,100,0.0001,0.01,0.628,0.8203774792066538,6253,6251
4,12604,10,100,0.0001,0.01,0.652,0.8588543319581086,6299,6305
4,12704,10,100,0.0001,0.01,0.644,0.8815333753148614,6348,6356
4,12804,10,100,0.0001,0.01,0.668,0.8922211808809747,6397,6407
4,12904,10,100,0.0001,0.01,0.668,0.8857718536887786,6454,6450
4,13004,10,100,0.0001,0.01,0.652,0.8933405106121194,6500,6504
4,13104,10,100,0.0001,0.01,0.674,0.8948412698412699,6551,6553
4,13204,10,100,0.0001,0.01,0.684,0.8832929415328689,6600,6604
4,13304,10,100,0.0001,0.01,0.722,0.8985267588695129,6655,6649
4,13404,10,100,0.0001,0.01,0.694,0.9048791405550581,6710,6694
4,13504,10,100,0.0001,0.01,0.702,0.9014366113744076,6761,6743
4,13604,10,100,0.0001,0.01,0.712,0.910467509556013,6813,6791
4,13704,10,100,0.0001,0.01,0.664,0.8945563339171045,6865,6839
4,13804,10,100,0.0001,0.01,0.708,0.9025644740654882,6915,6889
4,13904,10,100,0.0001,0.01,0.72,0.917361910241657,6961,6943
4,14004,10,100,0.0001,0.01,0.71,0.9001713796058269,7016,6988
4,14104,10,100,0.0001,0.01,0.714,0.9158394781622234,7068,7036
4,14204,10,100,0.0001,0.01,0.728,0.9111517882286679,7118,7086
4,14304,10,100,0.0001,0.01,0.736,0.9202321029082774,7171,7133
4,14404,10,100,0.0001,0.01,0.748,0.9250208275479034,7217,7187
4,14504,10,100,0.0001,0.01,0.716,0.9269167126309984,7266,7238
4,14604,10,100,0.0001,0.01,0.756,0.9222130923034785,7317,7287
4,14704,10,100,0.0001,0.01,0.702,0.9207018498367792,7357,7347
4,14804,10,100,0.0001,0.01,0.746,0.9144825722777628,7413,7391
4,14904,10,100,0.0001,0.01,0.732,0.9308910359634998,7462,7442
4,15004,10,100,0.0001,0.01,0.728,0.9173553719008265,7513,7491
5,104,10,100,0.0001,0.01,0.514,0.5865384615384616,61,43
5,204,10,100,0.0001,0.01,0.514,0.5490196078431373,112,92
5,304,10,100,0.0001,0.01,0.488,0.5756578947368421,167,137
5,404,10,100,0.0001,0.01,0.492,0.5668316831683168,221,183
5,504,10,100,0.0001,0.01,0.476,0.6468253968253969,274,230
5,604,10,100,0.0001,0.01,0.516,0.6076158940397351,319,285
5,704,10,100,0.0001,0.01,0.47,0.6420454545454546,368,336
5,804,10,100,0.0001,0.01,0.466,0.677860696517413,413,391
5,904,10,100,0.0001,0.01,0.48,0.6603982300884956,464,440
5,1004,10,100,0.0001,0.01,0.462,0.6653386454183267,508,496
5,1104,10,100,0.0001,0.01,0.486,0.6757246376811594,565,539
5,1204,10,100,0.0001,0.01,0.5,0.6893687707641196,618,586
5,1304,10,100,0.0001,0.01,0.478,0.6694785276073619,669,635
5,1404,10,100,0.0001,0.01,0.482,0.6794871794871795,724,680
5,1504,10,100,0.0001,0.01,0.49,0.6848404255319149,778,726
5,1604,10,100,0.0001,0.01,0.48,0.7082294264339152,824,780
5,1704,10,100,0.0001,0.01,0.498,0.6960093896713615,879,825
5,1804,10,100,0.0001,0.01,0.512,0.7028824833702882,941,863
5,1904,10,100,0.0001,0.01,0.488,0.664390756302521,988,916
5,2004,10,100,0.0001,0.01,0.484,0.7215568862275449,1032,972
5,2104,10,100,0.0001,0.01,0.496,0.7309885931558935,1083,1021
5,2204,10,100,0.0001,0.01,0.49,0.75,1126,1078
5,2304,10,100,0.0001,0.01,0.522,0.7252604166666666,1187,1117
5,2404,10,100,0.0001,0.01,0.514,0.7462562396006656,1230,1174
5,2504,10,100,0.0001,0.01,0.49,0.7631789137380192,1282,1222
5,2604,10,100,0.0001,0.01,0.486,0.7457757296466974,1334,1270
5,2704,10,100,0.0001,0.01,0.478,0.7340976331360947,1385,1319
5,2804,10,100,0.0001,0.01,0.49,0.7328815977175464,1437,1367
5,2904,10,100,0.0001,0.01,0.51,0.7706611570247934,1499,1405
5,3004,10,100,0.0001,0.01,0.524,0.7816245006657789,1550,1454
5,3104,10,100,0.0001,0.01,0.504,0.7193943298969072,1601,1503
5,3204,10,100,0.0001,0.01,0.552,0.7540574282147315,1647,1557
5,3304,10,100,0.0001,0.01,0.53,0.7733050847457628,1694,1610
5,3404,10,100,0.0001,0.01,0.512,0.7717391304347826,1736,1668
5,3504,10,100,0.0001,0.01,0.534,0.7674086757990868,1782,1722
5,3604,10,100,0.0001,0.01,0.512,0.7977247502774695,1835,1769
5,3704,10,100,0.0001,0.01,0.52,0.7818574514038877,1892,1812
5,3804,10,100,0.0001,0.01,0.548,0.796267087276551,1944,1860
5,3904,10,100,0.0001,0.01,0.522,0.7566598360655737,1990,1914
5,4004,10,100,0.0001,0.01,0.542,0.7702297702297702,2043,1961
5,4104,10,100,0.0001,0.01,0.494,0.7609649122807017,2094,2010
5,4204,10,100,0.0001,0.01,0.518,0.771883920076118,2138,2066
5,4304,10,100,0.0001,0.01,0.506,0.7804368029739777,2185,2119
5,4404,10,100,0.0001,0.01,0.494,0.78905540417802,2234,2170
5,4504,10,100,0.0001,0.01,0.52,0.7839698046181173,2280,2224
5,4604,10,100,0.0001,0.01,0.516,0.7912684622067767,2337,2267
5,4704,10,100,0.0001,0.01,0.492,0.7810374149659864,2383,2321
5,4804,10,100,0.0001,0.01,0.496,0.7937135720233139,2435,2369
5,4904,10,100,0.0001,0.01,0.512,0.8064845024469821,2483,2421
5,5004,10,100,0.0001,0.01,0.528,0.8057553956834532,2539,2465
5,5104,10,100,0.0001,0.01,0.518,0.7827194357366771,2599,2505
5,5204,10,100,0.0001,0.01,0.554,0.8136049192928516,2652,2552
5,5304,10,100,0.0001,0.01,0.534,0.8225867269984917,2700,2604
5,5404,10,100,0.0001,0.01,0.536,0.8310510732790526,2749,2655
5,5504,10,100,0.0001,0.01,0.52,0.8461119186046512,2789,2715
5,5604,10,100,0.0001,0.01,0.528,0.8411848679514632,2843,2761
5,5704,10,100,0.0001,0.01,0.526,0.8327489481065918,2885,2819
5,5804,10,100,0.0001,0.01,0.548,0.8287388008270159,2931,2873
5,5904,10,100,0.0001,0.01,0.534,0.7975948509485095,2985,2919
5,6004,10,100,0.0001,0.01,0.57,0.8302798134576949,3031,2973
5,6104,10,100,0.0001,0.01,0.56,0.8129095674967235,3085,3019
5,6204,10,100,0.0001,0.01,0.55,0.8405867182462927,3134,3070
5,6304,10,100,0.0001,0.01,0.558,0.8447017766497462,3188,3116
5,6404,10,100,0.0001,0.01,0.562,0.8580574640849469,3240,3164
5,6504,10,100,0.0001,0.01,0.558,0.8459409594095941,3284,3220
5,6604,10,100,0.0001,0.01,0.552,0.8399454875832829,3333,3271
5,6704,10,100,0.0001,0.01,0.594,0.836664677804296,3373,3331
5,6804,10,100,0.0001,0.01,0.562,0.852145796590241,3419,3385
5,6904,10,100,0.0001,0.01,0.546,0.831981460023175,3467,3437
5,7004,10,100,0.0001,0.01,0.59,0.8600799543118218,3510,3494
5,7104,10,100,0.0001,0.01,0.58,0.8695101351351351,3561,3543
5,7204,10,100,0.0001,0.01,0.608,0.8593836757357024,3608,3596
5,7304,10,100,0.0001,0.01,0.55,0.8436473165388828,3657,3647
5,7404,10,100,0.0001,0.01,0.578,0.8626418152350082,3706,3698
5,7504,10,100,0.0001,0.01,0.554,0.8703358208955224,3762,3742
5,7604,10,100,0.0001,0.01,0.584,0.8762493424513415,3806,3798
5,7704,10,100,0.0001,0.01,0.582,0.8766874350986501,3859,3845
5,7804,10,100,0.0001,0.01,0.584,0.8831368528959508,3917,3887
5,7904,10,100,0.0001,0.01,0.592,0.8911943319838057,3972,3932
5,8004,10,100,0.0001,0.01,0.584,0.8831834082958521,4022,3982
5,8104,10,100,0.0001,0.01,0.626,0.8712981243830207,4073,4031
5,8204,10,100,0.0001,0.01,0.57,0.8735982447586543,4120,4084
5,8304,10,100,0.0001,0.01,0.594,0.8701830443159922,4164,4140
5,8404,10,100,0.0001,0.01,0.592,0.8737505949547835,4216,4188
5,8504,10,100,0.0001,0.01,0.6,0.8795860771401693,4269,4235
5,8604,10,100,0.0001,0.01,0.59,0.8923756392375639,4319,4285
5,8704,10,100,0.0001,0.01,0.608,0.8916590073529411,4376,4328
5,8804,10,100,0.0001,0.01,0.624,0.8873239436619719,4423,4381
5,8904,10,100,0.0001,0.01,0.64,0.8755615453728661,4475,4429
5,9004,10,100,0.0001,0.01,0.636,0.8944913371834741,4521,4483
5,9104,10,100,0.0001,0.01,0.644,0.8822495606326889,4573,4531
5,9204,10,100,0.0001,0.01,0.636,0.8896132116471099,4619,4585
5,9304,10,100,0.0001,0.01,0.61,0.8930567497850387,4667,4637
5,9404,10,100,0.0001,0.01,0.642,0.8952573373032752,4712,4692
5,9504,10,100,0.0001,0.01,0.638,0.9051978114478114,4758,4746
5,9604,10,100,0.0001,0.01,0.656,0.9069137859225322,4807,4797
5,9704,10,100,0.0001,0.01,0.66,0.9127164056059357,4854,4850
5,9804,10,100,0.0001,0.01,0.67,0.9112607099143207,4905,4899
5,9904,10,100,0.0001,0.01,0.694,0.8872172859450727,4948,4956
5,10004,10,100,0.0001,0.01,0.668,0.9116353458616553,4999,5005
5,10104,10,100,0.0001,0.01,0.65,0.9160728424386382,5044,5060
5,10204,10,100,0.0001,0.01,0.67,0.9030772246177969,5099,5105
5,10304,10,100,0.0001,0.01,0.676,0.8833462732919255,5151,5153
5,10404,10,100,0.0001,0.01,0.652,0.9071510957324106,5199,5205
5,10504,10,100,0.0001,0.01,0.666,0.9160319878141661,5255,5249
5,10604,10,100,0.0001,0.01,0.684,0.9095624292719728,5306,5298
5,10704,10,100,0.0001,0.01,0.702,0.9138639760837071,5355,5349
5,10804,10,100,0.0001,0.01,0.688,0.9188263606071825,5406,5398
5,10904,10,100,0.0001,0.01,0.704,0.9217718268525312,5454,5450
5,11004,10,100,0.0001,0.01,0.694,0.9179389312977099,5502,5502
5,11104,10,100,0.0001,0.01,0.71,0.9140850144092219,5557,5547
5,11204,10,100,0.0001,0.01,0.704,0.9201178150660478,5603,5601
5,11304,10,100,0.0001,0.01,0.694,0.9048124557678697,5644,5660
5,11404,10,100,0.0001,0.01,0.698,0.9042441248684672,5693,5711
5,11504,10,100,0.0001,0.01,0.69,0.907336578581363,5741,5763
5,11604,10,100,0.0001,0.01,0.696,0.9263185108583247,5797,5807
5,11704,10,100,0.0001,0.01,0.732,0.9247265892002734,5848,5856
5,11804,10,100,0.0001,0.01,0.708,0.9228227719417147,5896,5908
5,11904,10,100,0.0001,0.01,0.674,0.9041498655913979,5942,5962
5,12004,10,100,0.0001,0.01,0.69,0.9231089636787737,5994,6010
5,12104,10,100,0.0001,0.01,0.734,0.9342366159947125,6048,6056
5,12204,10,100,0.0001,0.01,0.73,0.9232218944608325,6110,6094
5,12304,10,100,0.0001,0.01,0.724,0.9249837451235371,6154,6150
5,12404,10,100,0.0001,0.01,0.724,0.9269590454692035,6201,6203
5,12504,10,100,0.0001,0.01,0.656,0.8398912348048625,6252,6252
5,12604,10,100,0.0001,0.01,0.678,0.8891621707394478,6305,6299
5,12704,10,100,0.0001,0.01,0.69,0.8868860201511335,6361,6343
5,12804,10,100,0.0001,0.01,0.72,0.9128397375820057,6414,6390
5,12904,10,100,0.0001,0.01,0.696,0.9128177309361438,6465,6439
5,13004,10,100,0.0001,0.01,0.698,0.9184866195016917,6517,6487
5,13104,10,100,0.0001,0.01,0.734,0.9172771672771672,6562,6542
5,13204,10,100,0.0001,0.01,0.758,0.9328233868524689,6608,6596
5,13304,10,100,0.0001,0.01,0.744,0.923331328923632,6656,6648
5,13404,10,100,0.0001,0.01,0.724,0.9289018203521336,6704,6700
5,13504,10,100,0.0001,0.01,0.738,0.9293542654028436,6750,6754
5,13604,10,100,0.0001,0.01,0.758,0.9394295795354307,6802,6802
5,13704,10,100,0.0001,0.01,0.754,0.9403093987157034,6852,6852
5,13804,10,100,0.0001,0.01,0.762,0.9312518110692553,6898,6906
5,13904,10,100,0.0001,0.01,0.746,0.9461306098964327,6946,6958
5,14004,10,100,0.0001,0.01,0.762,0.9403741788060554,6997,7007
5,14104,10,100,0.0001,0.01,0.786,0.9477453204764605,7041,7063
5,14204,10,100,0.0001,0.01,0.778,0.9485356237679526,7088,7116
5,14304,10,100,0.0001,0.01,0.79,0.9386185682326622,7142,7162
5,14404,10,100,0.0001,0.01,0.766,0.9402943626770341,7194,7210
5,14504,10,100,0.0001,0.01,0.782,0.9358797573083287,7242,7262
5,14604,10,100,0.0001,0.01,0.792,0.9422760887428102,7296,7308
5,14704,10,100,0.0001,0.01,0.792,0.933759521218716,7349,7355
5,14804,10,100,0.0001,0.01,0.77,0.9456903539583896,7400,7404
5,14904,10,100,0.0001,0.01,0.788,0.9543075684380032,7450,7454
5,15004,10,100,0.0001,0.01,0.788,0.9346840842442016,7495,7509
6,104,10,100,0.0001,0.01,0.526,0.625,44,60
6,204,10,100,0.0001,0.01,0.484,0.47549019607843135,96,108
6,304,10,100,0.0001,0.01,0.506,0.6019736842105263,158,146
6,404,10,100,0.0001,0.01,0.53,0.6039603960396039,223,181
6,504,10,100,0.0001,0.01,0.518,0.5892857142857143,268,236
6,604,10,100,0.0001,0.01,0.494,0.5960264900662252,319,285
6,704,10,100,0.0001,0.01,0.48,0.6136363636363636,366,338
6,804,10,100,0.0001,0.01,0.498,0.6355721393034826,417,387
6,904,10,100,0.0001,0.01,0.484,0.6183628318584071,468,436
6,1004,10,100,0.0001,0.01,0.486,0.6264940239043825,517,487
6,1104,10,100,0.0001,0.01,0.506,0.6385869565217391,567,537
6,1204,10,100,0.0001,0.01,0.516,0.6420265780730897,626,578
6,1304,10,100,0.0001,0.01,0.47,0.625,675,629
6,1404,10,100,0.0001,0.01,0.484,0.6381766381766382,728,676
6,1504,10,100,0.0001,0.01,0.482,0.6416223404255319,778,726
6,1604,10,100,0.0001,0.01,0.51,0.6614713216957606,828,776
6,1704,10,100,0.0001,0.01,0.476,0.6737089201877934,885,819
6,1804,10,100,0.0001,0.01,0.488,0.7078713968957872,931,873
6,1904,10,100,0.0001,0.01,0.532,0.710609243697479,977,927
6,2004,10,100,0.0001,0.01,0.526,0.7235528942115769,1022,982
6,2104,10,100,0.0001,0.01,0.484,0.7271863117870723,1067,1037
6,2204,10,100,0.0001,0.01,0.524,0.7445553539019963,1111,1093
6,2304,10,100,0.0001,0.01,0.52,0.7269965277777778,1167,1137
6,2404,10,100,0.0001,0.01,0.542,0.7200499168053245,1220,1184
6,2504,10,100,0.0001,0.01,0.542,0.7304313099041534,1268,1236
6,2604,10,100,0.0001,0.01,0.556,0.7311827956989247,1316,1288
6,2704,10,100,0.0001,0.01,0.532,0.7599852071005917,1367,1337
6,2804,10,100,0.0001,0.01,0.512,0.7656918687589158,1429,1375
6,2904,10,100,0.0001,0.01,0.554,0.7351928374655647,1472,1432
6,3004,10,100,0.0001,0.01,0.512,0.7400133155792277,1519,1485
6,3104,10,100,0.0001,0.01,0.556,0.7719072164948454,1569,1535
6,3204,10,100,0.0001,0.01,0.564,0.7531210986267166,1623,1581
6,3304,10,100,0.0001,0.01,0.504,0.7524213075060533,1678,1626
6,3404,10,100,0.0001,0.01,0.54,0.7987661574618097,1727,1677
6,3504,10,100,0.0001,0.01,0.544,0.8110730593607306,1766,1738
6,3604,10,100,0.0001,0.01,0.562,0.8160377358490566,1820,1784
6,3704,10,100,0.0001,0.01,0.556,0.8174946004319654,1868,1836
6,3804,10,100,0.0001,0.01,0.562,0.8170347003154574,1916,1888
6,3904,10,100,0.0001,0.01,0.576,0.8291495901639344,1964,1940
6,4004,10,100,0.0001,0.01,0.562,0.8086913086913087,2004,2000
6,4104,10,100,0.0001,0.01,0.594,0.8092105263157895,2055,2049
6,4204,10,100,0.0001,0.01,0.598,0.8311132254995243,2097,2107
6,4304,10,100,0.0001,0.01,0.584,0.8273698884758365,2151,2153
6,4404,10,100,0.0001,0.01,0.608,0.8505903723887375,2193,2211
6,4504,10,100,0.0001,0.01,0.636,0.8043960923623446,2237,2267
6,4604,10,100,0.0001,0.01,0.644,0.817984361424848,2291,2313
6,4704,10,100,0.0001,0.01,0.62,0.841624149659864,2344,2360
6,4804,10,100,0.0001,0.01,0.644,0.8278517901748543,2390,2414
6,4904,10,100,0.0001,0.01,0.616,0.8099510603588908,2439,2465
6,5004,10,100,0.0001,0.01,0.648,0.8309352517985612,2485,2519
6,5104,10,100,0.0001,0.01,0.636,0.8317006269592476,2532,2572
6,5204,10,100,0.0001,0.01,0.636,0.8303228285933897,2581,2623
6,5304,10,100,0.0001,0.01,0.63,0.826734539969834,2633,2671
6,5404,10,100,0.0001,0.01,0.622,0.8393782383419689,2680,2724
6,5504,10,100,0.0001,0.01,0.652,0.8522892441860465,2728,2776
6,5604,10,100,0.0001,0.01,0.626,0.8761598857958601,2783,2821
6,5704,10,100,0.0001,0.01,0.656,0.8590462833099579,2836,2868
6,5804,10,100,0.0001,0.01,0.65,0.8694004135079255,2884,2920
6,5904,10,100,0.0001,0.01,0.642,0.850609756097561,2939,2965
6,6004,10,100,0.0001,0.01,0.648,0.8607594936708861,2988,3016
6,6104,10,100,0.0001,0.01,0.676,0.8541939711664482,3035,3069
6,6204,10,100,0.0001,0.01,0.644,0.8812056737588653,3084,3120
6,6304,10,100,0.0001,0.01,0.668,0.8789657360406091,3135,3169
6,6404,10,100,0.0001,0.01,0.69,0.8902248594628357,3193,3211
6,6504,10,100,0.0001,0.01,0.68,0.8986777367773677,3246,3258
6,6604,10,100,0.0001,0.01,0.67,0.8817383403997577,3294,3310
6,6704,10,100,0.0001,0.01,0.692,0.8872315035799523,3346,3358
6,6804,10,100,0.0001,0.01,0.682,0.8871252204585538,3389,3415
6,6904,10,100,0.0001,0.01,0.684,0.8896292004634995,3436,3468
6,7004,10,100,0.0001,0.01,0.694,0.905625356938892,3484,3520
6,7104,10,100,0.0001,0.01,0.698,0.9141328828828829,3529,3575
6,7204,10,100,0.0001,0.01,0.672,0.9035258189894503,3580,3624
6,7304,10,100,0.0001,0.01,0.71,0.8990963855421686,3630,3674
6,7404,10,100,0.0001,0.01,0.696,0.8931658562938952,3674,3730
6,7504,10,100,0.0001,0.01,0.712,0.9011194029850746,3726,3778
6,7604,10,100,0.0001,0.01,0.688,0.9018937401367702,3790,3814
6,7704,10,100,0.0001,0.01,0.714,0.9083592938733126,3845,3859
6,7804,10,100,0.0001,0.01,0.678,0.9255509994874423,3894,3910
6,7904,10,100,0.0001,0.01,0.694,0.9266194331983806,3953,3951
6,8004,10,100,0.0001,0.01,0.702,0.9061719140429785,3994,4010
6,8104,10,100,0.0001,0.01,0.71,0.9115251727541954,4041,4063
6,8204,10,100,0.0001,0.01,0.698,0.9117503656752803,4092,4112
6,8304,10,100,0.0001,0.01,0.706,0.9214836223506744,4146,4158
6,8404,10,100,0.0001,0.01,0.682,0.9249167063303189,4203,4201
6,8504,10,100,0.0001,0.01,0.696,0.8647695202257761,4248,4256
6,8604,10,100,0.0001,0.01,0.702,0.8837749883774988,4294,4310
6,8704,10,100,0.0001,0.01,0.702,0.9044117647058824,4350,4354
6,8804,10,100,0.0001,0.01,0.696,0.9045888232621536,4402,4402
6,8904,10,100,0.0001,0.01,0.71,0.9177897574123989,4449,4455
6,9004,10,100,0.0001,0.01,0.736,0.9278098622834295,4493,4511
6,9104,10,100,0.0001,0.01,0.712,0.9211335676625659,4549,4555
6,9204,10,100,0.0001,0.01,0.738,0.9193828770099957,4601,4603
6,9304,10,100,0.0001,0.01,0.738,0.9133705932932072,4658,4646
6,9404,10,100,0.0001,0.01,0.744,0.9279030199914929,4705,4699
6,9504,10,100,0.0001,0.01,0.72,0.9086700336700336,4754,4750
6,9604,10,100,0.0001,0.01,0.722,0.9211786755518534,4807,4797
6,9704,10,100,0.0001,0.01,0.684,0.8611912613355317,4861,4843
6,9804,10,100,0.0001,0.01,0.706,0.9062627498980008,4910,4894
6,9904,10,100,0.0001,0.01,0.738,0.9225565428109854,4952,4952
6,10004,10,100,0.0001,0.01,0.746,0.9326269492203119,4997,5007
6,10104,10,100,0.0001,0.01,0.764,0.9375494853523357,5044,5060
6,10204,10,100,0.0001,0.01,0.744,0.9331634653077224,5099,5105
6,10304,10,100,0.0001,0.01,0.73,0.921777950310559,5155,5149
6,10404,10,100,0.0001,0.01,0.762,0.9318531334102268,5200,5204
6,10504,10,100,0.0001,0.01,0.768,0.9361195734958111,5252,5252
6,10604,10,100,0.0001,0.01,0.766,0.9315352697095436,5301,5303
6,10704,10,100,0.0001,0.01,0.776,0.9413303437967115,5354,5350
6,10804,10,100,0.0001,0.01,0.756,0.9413180303591262,5402,5402
6,10904,10,100,0.0001,0.01,0.764,0.9333272193690388,5462,5442
6,11004,10,100,0.0001,0.01,0.766,0.937749909123955,5516,5488
6,11104,10,100,0.0001,0.01,0.742,0.9339877521613833,5568,5536
6,11204,10,100,0.0001,0.01,0.738,0.8920921099607283,5622,5582
6,11304,10,100,0.0001,0.01,0.772,0.866065109695683,5671,5633
6,11404,10,100,0.0001,0.01,0.748,0.8970536653805682,5722,5682
6,11504,10,100,0.0001,0.01,0.784,0.9164638386648123,5772,5732
6,11604,10,100,0.0001,0.01,0.782,0.9111513271285764,5812,5792
6,11704,10,100,0.0001,0.01,0.788,0.9177204374572796,5863,5841
6,11804,10,100,0.0001,0.01,0.79,0.9297695696374111,5906,5898
6,11904,10,100,0.0001,0.01,0.784,0.9361559139784946,5948,5956
6,12004,10,100,0.0001,0.01,0.804,0.9368543818727091,6003,6001
6,12104,10,100,0.0001,0.01,0.792,0.9488598810310641,6059,6045
6,12204,10,100,0.0001,0.01,0.816,0.950589970501475,6111,6093
6,12304,10,100,0.0001,0.01,0.806,0.9491222366710013,6155,6149
6,12404,10,100,0.0001,0.01,0.794,0.9452595936794582,6207,6197
6,12504,10,100,0.0001,0.01,0.806,0.9341810620601407,6265,6239
6,12604,10,100,0.0001,0.01,0.82,0.9439860361789908,6310,6294
6,12704,10,100,0.0001,0.01,0.818,0.9378148614609572,6348,6356
6,12804,10,100,0.0001,0.01,0.816,0.9438456732271165,6398,6406
6,12904,10,100,0.0001,0.01,0.84,0.9519528828270304,6447,6457
6,13004,10,100,0.0001,0.01,0.8,0.9352506920947401,6492,6512
6,13104,10,100,0.0001,0.01,0.756,0.8933150183150184,6541,6563
6,13204,10,100,0.0001,0.01,0.78,0.9156316267797637,6593,6611
6,13304,10,100,0.0001,0.01,0.788,0.9267889356584486,6645,6659
6,13404,10,100,0.0001,0.01,0.814,0.94136078782453,6691,6713
6,13504,10,100,0.0001,0.01,0.804,0.9353524881516587,6748,6756
6,13604,10,100,0.0001,0.01,0.8,0.9267127315495443,6790,6814
6,13704,10,100,0.0001,0.01,0.814,0.9403823701109165,6844,6860
6,13804,10,100,0.0001,0.01,0.794,0.9290785279629094,6887,6917
6,13904,10,100,0.0001,0.01,0.82,0.9267117376294591,6939,6965
6,14004,10,100,0.0001,0.01,0.794,0.9184518708940302,6990,7014
6,14104,10,100,0.0001,0.01,0.82,0.9376772546795236,7048,7056
6,14204,10,100,0.0001,0.01,0.814,0.9454379048155449,7103,7101
6,14304,10,100,0.0001,0.01,0.846,0.9407158836689038,7149,7155
6,14404,10,100,0.0001,0.01,0.854,0.9520272146625938,7198,7206
6,14504,10,100,0.0001,0.01,0.848,0.9600799779371207,7242,7262
6,14604,10,100,0.0001,0.01,0.83,0.9428923582580115,7290,7314
6,14704,10,100,0.0001,0.01,0.832,0.9526659412404788,7337,7367
6,14804,10,100,0.0001,0.01,0.814,0.8969873007295326,7396,7408
6,14904,10,100,0.0001,0.01,0.764,0.885601180891036,7445,7459
6,15004,10,100,0.0001,0.01,0.78,0.9106904825379899,7510,7494
7,104,10,100,0.0001,0.01,0.484,0.4807692307692308,58,46
7,204,10,100,0.0001,0.01,0.506,0.5784313725490197,108,96
7,304,10,100,0.0001,0.01,0.514,0.6710526315789473,152,152
7,404,10,100,0.0001,0.01,0.488,0.5594059405940595,201,203
7,504,10,100,0.0001,0.01,0.538,0.5972222222222222,250,254
7,604,10,100,0.0001,0.01,0.512,0.6009933774834437,293,311
7,704,10,100,0.0001,0.01,0.524,0.6136363636363636,344,360
7,804,10,100,0.0001,0.01,0.508,0.6019900497512438,393,411
7,904,10,100,0.0001,0.01,0.51,0.6272123893805309,446,458
7,1004,10,100,0.0001,0.01,0.556,0.6454183266932271,493,511
7,1104,10,100,0.0001,0.01,0.53,0.6458333333333334,540,564
7,1204,10,100,0.0001,0.01,0.56,0.6619601328903655,585,619
7,1304,10,100,0.0001,0.01,0.546,0.6679447852760736,628,676
7,1404,10,100,0.0001,0.01,0.544,0.6481481481481481,690,714
7,1504,10,100,0.0001,0.01,0.5,0.6436170212765957,745,759
7,1604,10,100,0.0001,0.01,0.538,0.6976309226932669,794,810
7,1704,10,100,0.0001,0.01,0.514,0.6754694835680751,835,869
7,1804,10,100,0.0001,0.01,0.51,0.7117516629711752,888,916
7,1904,10,100,0.0001,0.01,0.526,0.7132352941176471,942,962
7,2004,10,100,0.0001,0.01,0.54,0.7230538922155688,992,1012
7,2104,10,100,0.0001,0.01,0.538,0.7024714828897338,1046,1058
7,2204,10,100,0.0001,0.01,0.488,0.7241379310344828,1101,1103
7,2304,10,100,0.0001,0.01,0.514,0.71484375,1147,1157
7,2404,10,100,0.0001,0.01,0.502,0.7262895174708819,1202,1202
7,2504,10,100,0.0001,0.01,0.51,0.7176517571884984,1249,1255
7,2604,10,100,0.0001,0.01,0.494,0.7269585253456221,1293,1311
7,2704,10,100,0.0001,0.01,0.494,0.7433431952662722,1344,1360
7,2804,10,100,0.0001,0.01,0.514,0.7631954350927247,1395,1409
7,2904,10,100,0.0001,0.01,0.506,0.772038567493113,1440,1464
7,3004,10,100,0.0001,0.01,0.514,0.7789613848202397,1490,1514
7,3104,10,100,0.0001,0.01,0.504,0.7503221649484536,1535,1569
7,3204,10,100,0.0001,0.01,0.53,0.7649812734082397,1583,1621
7,3304,10,100,0.0001,0.01,0.494,0.75,1629,1675
7,3404,10,100,0.0001,0.01,0.49,0.7817273795534665,1673,1731
7,3504,10,100,0.0001,0.01,0.534,0.7890981735159818,1724,1780
7,3604,10,100,0.0001,0.01,0.518,0.7966148723640399,1777,1827
7,3704,10,100,0.0001,0.01,0.508,0.7999460043196545,1834,1870
7,3804,10,100,0.0001,0.01,0.532,0.812565720294427,1878,1926
7,3904,10,100,0.0001,0.01,0.502,0.7891905737704918,1924,1980
7,4004,10,100,0.0001,0.01,0.518,0.8056943056943057,1965,2039
7,4104,10,100,0.0001,0.01,0.536,0.8172514619883041,2019,2085
7,4204,10,100,0.0001,0.01,0.548,0.826593720266413,2064,2140
7,4304,10,100,0.0001,0.01,0.518,0.7962360594795539,2114,2190
7,4404,10,100,0.0001,0.01,0.552,0.8142597638510445,2163,2241
7,4504,10,100,0.0001,0.01,0.544,0.8383658969804618,2216,2288
7,4604,10,100,0.0001,0.01,0.552,0.8184187662901824,2267,2337
7,4704,10,100,0.0001,0.01,0.56,0.7982568027210885,2316,2388
7,4804,10,100,0.0001,0.01,0.554,0.8139050791007494,2371,2433
7,4904,10,100,0.0001,0.01,0.536,0.8250407830342578,2416,2488
7,5004,10,100,0.0001,0.01,0.58,0.8413269384492406,2460,2544
7,5104,10,100,0.0001,0.01,0.576,0.8040752351097179,2515,2589
7,5204,10,100,0.0001,0.01,0.608,0.8418524212144505,2566,2638
7,5304,10,100,0.0001,0.01,0.624,0.8482277526395173,2613,2691
7,5404,10,100,0.0001,0.01,0.616,0.8362324204293117,2666,2738
7,5504,10,100,0.0001,0.01,0.644,0.8571947674418605,2724,2780
7,5604,10,100,0.0001,0.01,0.62,0.8577801570306923,2775,2829
7,5704,10,100,0.0001,0.01,0.64,0.798562412342216,2836,2868
7,5804,10,100,0.0001,0.01,0.638,0.8263266712611992,2884,2920
7,5904,10,100,0.0001,0.01,0.626,0.8345189701897019,2937,2967
7,6004,10,100,0.0001,0.01,0.652,0.8584277148567622,2997,3007
7,6104,10,100,0.0001,0.01,0.648,0.8278178243774574,3048,3056
7,6204,10,100,0.0001,0.01,0.644,0.8330109606705351,3096,3108
7,6304,10,100,0.0001,0.01,0.634,0.8401015228426396,3149,3155
7,6404,10,100,0.0001,0.01,0.65,0.8608682073703935,3196,3208
7,6504,10,100,0.0001,0.01,0.618,0.8534747847478474,3241,3263
7,6604,10,100,0.0001,0.01,0.656,0.8622047244094488,3294,3310
7,6704,10,100,0.0001,0.01,0.68,0.8535202863961814,3336,3368
7,6804,10,100,0.0001,0.01,0.684,0.8671369782480893,3391,3413
7,6904,10,100,0.0001,0.01,0.68,0.8739860950173812,3451,3453
7,7004,10,100,0.0001,0.01,0.716,0.8797829811536265,3504,3500
7,7104,10,100,0.0001,0.01,0.686,0.884009009009009,3557,3547
7,7204,10,100,0.0001,0.01,0.674,0.8727096057745697,3608,3596
7,7304,10,100,0.0001,0.01,0.696,0.8719879518072289,3656,3648
7,7404,10,100,0.0001,0.01,0.682,0.8908698001080497,3709,3695
7,7504,10,100,0.0001,0.01,0.658,0.8891257995735607,3759,3745
7,7604,10,100,0.0001,0.01,0.674,0.8855865334034718,3805,3799
7,7704,10,100,0.0001,0.01,0.63,0.8840861889927311,3856,3848
7,7804,10,100,0.0001,0.01,0.668,0.8894156842644797,3910,3894
7,7904,10,100,0.0001,0.01,0.662,0.9008097165991903,3968,3936
7,8004,10,100,0.0001,0.01,0.68,0.8974262868565717,4013,3991
7,8104,10,100,0.0001,0.01,0.69,0.894990128331688,4063,4041
7,8204,10,100,0.0001,0.01,0.718,0.8951730862993662,4109,4095
7,8304,10,100,0.0001,0.01,0.68,0.9057080924855492,4149,4155
7,8404,10,100,0.0001,0.01,0.668,0.8886244645406949,4205,4199
7,8504,10,100,0.0001,0.01,0.704,0.8844073377234243,4246,4258
7,8604,10,100,0.0001,0.01,0.71,0.8970246397024639,4292,4312
7,8704,10,100,0.0001,0.01,0.736,0.9028033088235294,4345,4359
7,8804,10,100,0.0001,0.01,0.686,0.8908450704225352,4402,4402
7,8904,10,100,0.0001,0.01,0.682,0.8803908355795148,4446,4458
7,9004,10,100,0.0001,0.01,0.7,0.8710573078631719,4509,4495
7,9104,10,100,0.0001,0.01,0.692,0.8614894551845342,4559,4545
7,9204,10,100,0.0001,0.01,0.71,0.8939591481964363,4605,4599
7,9304,10,100,0.0001,0.01,0.712,0.9090713671539123,4655,4649
7,9404,10,100,0.0001,0.01,0.716,0.9064227988090174,4705,4699
7,9504,10,100,0.0001,0.01,0.724,0.9059343434343434,4754,4750
7,9604,10,100,0.0001,0.01,0.75,0.898896293211162,4800,4804
7,9704,10,100,0.0001,0.01,0.732,0.874484748557296,4840,4864
7,9804,10,100,0.0001,0.01,0.74,0.9016727866177071,4896,4908
7,9904,10,100,0.0001,0.01,0.73,0.904886914378029,4947,4957
7,10004,10,100,0.0001,0.01,0.736,0.9062375049980008,4993,5011
7,10104,10,100,0.0001,0.01,0.75,0.9130047505938242,5045,5059
7,10204,10,100,0.0001,0.01,0.732,0.9159153273226186,5089,5115
7,10304,10,100,0.0001,0.01,0.734,0.9150815217391305,5139,5165
7,10404,10,100,0.0001,0.01,0.726,0.8913879277201077,5196,5208
7,10504,10,100,0.0001,0.01,0.728,0.9142231530845393,5250,5254
7,10604,10,100,0.0001,0.01,0.726,0.9139947189739721,5301,5303
7,10704,10,100,0.0001,0.01,0.738,0.921618086696562,5343,5361
7,10804,10,100,0.0001,0.01,0.714,0.9100333209922251,5397,5407
7,10904,10,100,0.0001,0.01,0.73,0.9186537050623624,5446,5458
7,11004,10,100,0.0001,0.01,0.74,0.9208469647400945,5495,5509
7,11104,10,100,0.0001,0.01,0.766,0.9323667146974063,5547,5557
7,11204,10,100,0.0001,0.01,0.732,0.9014637629418065,5588,5616
7,11304,10,100,0.0001,0.01,0.744,0.8924274593064402,5634,5670
7,11404,10,100,0.0001,0.01,0.732,0.9188004209049456,5688,5716
7,11504,10,100,0.0001,0.01,0.754,0.9079450625869263,5733,5771
7,11604,10,100,0.0001,0.01,0.75,0.9291623578076526,5779,5825
7,11704,10,100,0.0001,0.01,0.742,0.925580997949419,5826,5878
7,11804,10,100,0.0001,0.01,0.746,0.9122331413080311,5876,5928
7,11904,10,100,0.0001,0.01,0.756,0.9274193548387096,5914,5990
7,12004,10,100,0.0001,0.01,0.762,0.9234421859380206,5962,6042
7,12104,10,100,0.0001,0.01,0.72,0.898876404494382,6010,6094
7,12204,10,100,0.0001,0.01,0.752,0.9175680104883644,6062,6142
7,12304,10,100,0.0001,0.01,0.736,0.9258777633289987,6119,6185
7,12404,10,100,0.0001,0.01,0.75,0.9233311834891971,6163,6241
7,12504,10,100,0.0001,0.01,0.742,0.9116282789507357,6221,6283
7,12604,10,100,0.0001,0.01,0.744,0.9115360203110123,6272,6332
7,12704,10,100,0.0001,0.01,0.766,0.9329345088161209,6331,6373
7,12804,10,100,0.0001,0.01,0.732,0.8975320212433614,6388,6416
7,12904,10,100,0.0001,0.01,0.736,0.8713577185368878,6435,6469
7,13004,10,100,0.0001,0.01,0.724,0.8922639187942172,6484,6520
7,13104,10,100,0.0001,0.01,0.752,0.9052960927960928,6533,6571
7,13204,10,100,0.0001,0.01,0.758,0.9009391093607998,6588,6616
7,13304,10,100,0.0001,0.01,0.76,0.9027360192423332,6639,6665
7,13404,10,100,0.0001,0.01,0.732,0.904729931363772,6684,6720
7,13504,10,100,0.0001,0.01,0.764,0.8923281990521327,6733,6771
7,13604,10,100,0.0001,0.01,0.762,0.9054689797118495,6780,6824
7,13704,10,100,0.0001,0.01,0.778,0.9168126094570929,6830,6874
7,13804,10,100,0.0001,0.01,0.76,0.9187192118226601,6876,6928
7,13904,10,100,0.0001,0.01,0.766,0.9296605293440736,6928,6976
7,14004,10,100,0.0001,0.01,0.742,0.8870322764924308,6976,7028
7,14104,10,100,0.0001,0.01,0.796,0.9267583664208735,7018,7086
7,14204,10,100,0.0001,0.01,0.8,0.9260771613629963,7073,7131
7,14304,10,100,0.0001,0.01,0.802,0.9263143176733781,7132,7172
7,14404,10,100,0.0001,0.01,0.786,0.9311996667592335,7180,7224
7,14504,10,100,0.0001,0.01,0.808,0.9322255929398786,7228,7276
7,14604,10,100,0.0001,0.01,0.794,0.9363872911531087,7283,7321
7,14704,10,100,0.0001,0.01,0.808,0.9328754080522307,7340,7364
7,14804,10,100,0.0001,0.01,0.776,0.91272629019184,7392,7412
7,14904,10,100,0.0001,0.01,0.716,0.825751476113795,7444,7460
7,15004,10,100,0.0001,0.01,0.73,0.872100773127166,7496,7508
8,104,10,100,0.0001,0.01,0.508,0.5096153846153846,51,53
8,204,10,100,0.0001,0.01,0.478,0.6813725490196079,106,98
8,304,10,100,0.0001,0.01,0.488,0.5361842105263158,159,145
8,404,10,100,0.0001,0.01,0.488,0.5693069306930693,204,200
8,504,10,100,0.0001,0.01,0.528,0.6468253968253969,251,253
8,604,10,100,0.0001,0.01,0.494,0.6490066225165563,302,302
8,704,10,100,0.0001,0.01,0.502,0.640625,351,353
8,804,10,100,0.0001,0.01,0.522,0.6567164179104478,402,402
8,904,10,100,0.0001,0.01,0.522,0.6404867256637168,449,455
8,1004,10,100,0.0001,0.01,0.526,0.6762948207171314,493,511
8,1104,10,100,0.0001,0.01,0.498,0.6603260869565217,543,561
8,1204,10,100,0.0001,0.01,0.504,0.686046511627907,588,616
8,1304,10,100,0.0001,0.01,0.516,0.6802147239263804,635,669
8,1404,10,100,0.0001,0.01,0.498,0.7058404558404558,681,723
8,1504,10,100,0.0001,0.01,0.522,0.6968085106382979,725,779
8,1604,10,100,0.0001,0.01,0.524,0.7331670822942643,788,816
8,1704,10,100,0.0001,0.01,0.53,0.7376760563380281,836,868
8,1804,10,100,0.0001,0.01,0.516,0.7305986696230599,886,918
8,1904,10,100,0.0001,0.01,0.526,0.7253151260504201,931,973
8,2004,10,100,0.0001,0.01,0.55,0.7894211576846307,978,1026
8,2104,10,100,0.0001,0.01,0.55,0.7946768060836502,1022,1082
8,2204,10,100,0.0001,0.01,0.548,0.8049001814882033,1073,1131
8,2304,10,100,0.0001,0.01,0.54,0.8355034722222222,1130,1174
8,2404,10,100,0.0001,0.01,0.582,0.8406821963394343,1187,1217
8,2504,10,100,0.0001,0.01,0.542,0.8190894568690096,1233,1271
8,2604,10,100,0.0001,0.01,0.53,0.8356374807987711,1275,1329
8,2704,10,100,0.0001,0.01,0.562,0.8221153846153846,1323,1381
8,2804,10,100,0.0001,0.01,0.582,0.822753209700428,1369,1435
8,2904,10,100,0.0001,0.01,0.616,0.8398760330578512,1420,1484
8,3004,10,100,0.0001,0.01,0.598,0.861185086551265,1471,1533
8,3104,10,100,0.0001,0.01,0.604,0.8521262886597938,1521,1583
8,3204,10,100,0.0001,0.01,0.608,0.8817103620474407,1563,1641
8,3304,10,100,0.0001,0.01,0.632,0.8816585956416465,1615,1689
8,3404,10,100,0.0001,0.01,0.63,0.8895417156286721,1670,1734
8,3504,10,100,0.0001,0.01,0.628,0.8538812785388128,1716,1788
8,3604,10,100,0.0001,0.01,0.668,0.8809655937846836,1775,1829
8,3704,10,100,0.0001,0.01,0.672,0.8968682505399568,1825,1879
8,3804,10,100,0.0001,0.01,0.69,0.9166666666666666,1873,1931
8,3904,10,100,0.0001,0.01,0.676,0.9121413934426229,1923,1981
8,4004,10,100,0.0001,0.01,0.7,0.9235764235764236,1971,2033
8,4104,10,100,0.0001,0.01,0.702,0.9368908382066277,2039,2065
8,4204,10,100,0.0001,0.01,0.7,0.9155566127497621,2092,2112
8,4304,10,100,0.0001,0.01,0.704,0.904275092936803,2137,2167
8,4404,10,100,0.0001,0.01,0.708,0.9148501362397821,2194,2210
8,4504,10,100,0.0001,0.01,0.71,0.8896536412078153,2249,2255
8,4604,10,100,0.0001,0.01,0.738,0.9096437880104257,2297,2307
8,4704,10,100,0.0001,0.01,0.72,0.9045493197278912,2348,2356
8,4804,10,100,0.0001,0.01,0.736,0.9250624479600333,2392,2412
8,4904,10,100,0.0001,0.01,0.726,0.9341353996737357,2435,2469
8,5004,10,100,0.0001,0.01,0.748,0.9424460431654677,2492,2512
8,5104,10,100,0.0001,0.01,0.766,0.9459247648902821,2547,2557
8,5204,10,100,0.0001,0.01,0.764,0.9463873943120676,2594,2610
8,5304,10,100,0.0001,0.01,0.742,0.9458898944193062,2641,2663
8,5404,10,100,0.0001,0.01,0.738,0.9480014803849001,2689,2715
8,5504,10,100,0.0001,0.01,0.762,0.9462209302325582,2735,2769
8,5604,10,100,0.0001,0.01,0.762,0.9387937187723054,2779,2825
8,5704,10,100,0.0001,0.01,0.756,0.947054698457223,2827,2877
8,5804,10,100,0.0001,0.01,0.738,0.9352170916609235,2872,2932
8,5904,10,100,0.0001,0.01,0.76,0.9180216802168022,2921,2983
8,6004,10,100,0.0001,0.01,0.752,0.9238840772818121,2979,3025
8,6104,10,100,0.0001,0.01,0.752,0.9295543905635649,3034,3070
8,6204,10,100,0.0001,0.01,0.76,0.9487427466150871,3085,3119
8,6304,10,100,0.0001,0.01,0.766,0.9524111675126904,3140,3164
8,6404,10,100,0.0001,0.01,0.766,0.9412866958151156,3195,3209
8,6504,10,100,0.0001,0.01,0.786,0.9486469864698647,3240,3264
8,6604,10,100,0.0001,0.01,0.788,0.951847365233192,3297,3307
8,6704,10,100,0.0001,0.01,0.768,0.9537589498806682,3344,3360
8,6804,10,100,0.0001,0.01,0.806,0.9397413286302175,3404,3400
8,6904,10,100,0.0001,0.01,0.786,0.9420625724217845,3457,3447
8,7004,10,100,0.0001,0.01,0.756,0.9507424328954883,3506,3498
8,7104,10,100,0.0001,0.01,0.816,0.9594594594594594,3551,3553
8,7204,10,100,0.0001,0.01,0.782,0.9514158800666297,3598,3606
8,7304,10,100,0.0001,0.01,0.808,0.9607064622124863,3644,3660
8,7404,10,100,0.0001,0.01,0.816,0.9577255537547271,3695,3709
8,7504,10,100,0.0001,0.01,0.808,0.956956289978678,3750,3754
8,7604,10,100,0.0001,0.01,0.788,0.9572593371909521,3801,3803
8,7704,10,100,0.0001,0.01,0.804,0.9430166147455867,3854,3850
8,7804,10,100,0.0001,0.01,0.786,0.9486160943106099,3905,3899
8,7904,10,100,0.0001,0.01,0.788,0.9509109311740891,3964,3940
8,8004,10,100,0.0001,0.01,0.794,0.9571464267866067,4006,3998
8,8104,10,100,0.0001,0.01,0.784,0.9596495557749259,4061,4043
8,8204,10,100,0.0001,0.01,0.806,0.9675767918088737,4116,4088
8,8304,10,100,0.0001,0.01,0.812,0.9644749518304432,4158,4146
8,8404,10,100,0.0001,0.01,0.826,0.9715611613517373,4201,4203
8,8504,10,100,0.0001,0.01,0.804,0.9623706491063029,4249,4255
8,8604,10,100,0.0001,0.01,0.814,0.9680381218038122,4287,4317
8,8704,10,100,0.0001,0.01,0.82,0.9684053308823529,4340,4364
8,8804,10,100,0.0001,0.01,0.804,0.9633121308496138,4387,4417
8,8904,10,100,0.0001,0.01,0.832,0.9645103324348607,4432,4472
8,9004,10,100,0.0001,0.01,0.808,0.9616836961350511,4486,4518
8,9104,10,100,0.0001,0.01,0.836,0.9714411247803163,4549,4555
8,9204,10,100,0.0001,0.01,0.818,0.9777270751847023,4593,4611
8,9304,10,100,0.0001,0.01,0.814,0.959372312983663,4639,4665
8,9404,10,100,0.0001,0.01,0.798,0.9441726924712888,4686,4718
8,9504,10,100,0.0001,0.01,0.816,0.9347643097643098,4733,4771
8,9604,10,100,0.0001,0.01,0.84,0.9559558517284464,4785,4819
8,9704,10,100,0.0001,0.01,0.836,0.968363561417972,4841,4863
8,9804,10,100,0.0001,0.01,0.824,0.9536923704610363,4890,4914
8,9904,10,100,0.0001,0.01,0.826,0.9268982229402262,4934,4970
8,10004,10,100,0.0001,0.01,0.836,0.9429228308676529,4984,5020
8,10104,10,100,0.0001,0.01,0.808,0.9387371338083927,5033,5071
8,10204,10,100,0.0001,0.01,0.844,0.9554096432771462,5084,5120
8,10304,10,100,0.0001,0.01,0.844,0.9589479813664596,5134,5170
8,10404,10,100,0.0001,0.01,0.84,0.9472318339100346,5186,5218
8,10504,10,100,0.0001,0.01,0.82,0.9116527037319117,5237,5267
8,10604,10,100,0.0001,0.01,0.832,0.9470954356846473,5278,5326
8,10704,10,100,0.0001,0.01,0.83,0.9599215246636771,5334,5370
8,10804,10,100,0.0001,0.01,0.836,0.9548315438726398,5387,5417
8,10904,10,100,0.0001,0.01,0.846,0.9415810711665444,5441,5463
8,11004,10,100,0.0001,0.01,0.846,0.9548346055979644,5496,5508
8,11104,10,100,0.0001,0.01,0.838,0.9710014409221902,5540,5564
8,11204,10,100,0.0001,0.01,0.834,0.9675116029989289,5590,5614
8,11304,10,100,0.0001,0.01,0.84,0.9681528662420382,5646,5658
8,11404,10,100,0.0001,0.01,0.838,0.9695720799719396,5703,5701
8,11504,10,100,0.0001,0.01,0.848,0.9678372739916551,5753,5751
8,11604,10,100,0.0001,0.01,0.848,0.963891761461565,5802,5802
8,11704,10,100,0.0001,0.01,0.84,0.9618933697881066,5858,5846
8,11804,10,100,0.0001,0.01,0.836,0.9675533717383937,5907,5897
8,11904,10,100,0.0001,0.01,0.842,0.9663978494623656,5959,5945
8,12004,10,100,0.0001,0.01,0.848,0.9675108297234255,6013,5991
8,12104,10,100,0.0001,0.01,0.852,0.9723231989424983,6062,6042
8,12204,10,100,0.0001,0.01,0.846,0.9721402818747952,6105,6099
8,12304,10,100,0.0001,0.01,0.854,0.9724479843953185,6149,6155
8,12404,10,100,0.0001,0.01,0.864,0.9729925830377297,6195,6209
8,12504,10,100,0.0001,0.01,0.866,0.9769673704414588,6245,6259
8,12604,10,100,0.0001,0.01,0.86,0.9666772453189464,6290,6314
8,12704,10,100,0.0001,0.01,0.854,0.9654439546599496,6330,6374
8,12804,10,100,0.0001,0.01,0.864,0.9720399875039051,6383,6421
8,12904,10,100,0.0001,0.01,0.862,0.9652045877247365,6435,6469
8,13004,10,100,0.0001,0.01,0.858,0.9727776068901877,6485,6519
8,13104,10,100,0.0001,0.01,0.856,0.9744352869352869,6536,6568
8,13204,10,100,0.0001,0.01,0.866,0.9719024538018782,6587,6617
8,13304,10,100,0.0001,0.01,0.864,0.9720384846662657,6646,6658
8,13404,10,100,0.0001,0.01,0.866,0.9730677409728439,6696,6708
8,13504,10,100,0.0001,0.01,0.876,0.9628258293838863,6750,6754
8,13604,10,100,0.0001,0.01,0.856,0.963466627462511,6799,6805
8,13704,10,100,0.0001,0.01,0.866,0.9703736135434909,6855,6849
8,13804,10,100,0.0001,0.01,0.868,0.9689944943494639,6907,6897
8,13904,10,100,0.0001,0.01,0.864,0.95864499424626,6957,6947
8,14004,10,100,0.0001,0.01,0.868,0.9757926306769494,7005,6999
8,14104,10,100,0.0001,0.01,0.864,0.9718519568916619,7057,7047
8,14204,10,100,0.0001,0.01,0.878,0.973246972683751,7108,7096
8,14304,10,100,0.0001,0.01,0.87,0.9702181208053692,7154,7150
8,14404,10,100,0.0001,0.01,0.87,0.9710497084143294,7199,7205
8,14504,10,100,0.0001,0.01,0.87,0.9637341423055709,7253,7251
8,14604,10,100,0.0001,0.01,0.868,0.974869898657902,7299,7305
8,14704,10,100,0.0001,0.01,0.856,0.9733405875952121,7357,7347
8,14804,10,100,0.0001,0.01,0.852,0.9696028100513375,7413,7391
8,14904,10,100,0.0001,0.01,0.852,0.9530327428878154,7461,7443
8,15004,10,100,0.0001,0.01,0.846,0.9639429485470541,7506,7498
9,104,10,100,0.0001,0.01,0.532,0.46153846153846156,56,48
9,204,10,100,0.0001,0.01,0.49,0.6764705882352942,98,106
9,304,10,100,0.0001,0.01,0.468,0.6118421052631579,154,150
9,404,10,100,0.0001,0.01,0.478,0.6608910891089109,204,200
9,504,10,100,0.0001,0.01,0.458,0.628968253968254,252,252
9,604,10,100,0.0001,0.01,0.514,0.6490066225165563,299,305
9,704,10,100,0.0001,0.01,0.514,0.6505681818181818,349,355
9,804,10,100,0.0001,0.01,0.526,0.6915422885572139,392,412
9,904,10,100,0.0001,0.01,0.528,0.6913716814159292,442,462
9,1004,10,100,0.0001,0.01,0.53,0.6842629482071713,491,513
9,1104,10,100,0.0001,0.01,0.57,0.6648550724637681,539,565
9,1204,10,100,0.0001,0.01,0.528,0.7126245847176079,587,617
9,1304,10,100,0.0001,0.01,0.554,0.7515337423312883,636,668
9,1404,10,100,0.0001,0.01,0.518,0.7393162393162394,681,723
9,1504,10,100,0.0001,0.01,0.55,0.7460106382978723,729,775
9,1604,10,100,0.0001,0.01,0.532,0.7350374064837906,775,829
9,1704,10,100,0.0001,0.01,0.546,0.7282863849765259,829,875
9,1804,10,100,0.0001,0.01,0.534,0.7488913525498891,874,930
9,1904,10,100,0.0001,0.01,0.552,0.7400210084033614,924,980
9,2004,10,100,0.0001,0.01,0.552,0.7310379241516967,975,1029
9,2104,10,100,0.0001,0.01,0.536,0.7452471482889734,1016,1088
9,2204,10,100,0.0001,0.01,0.546,0.7708711433756806,1059,1145
9,2304,10,100,0.0001,0.01,0.548,0.7434895833333334,1110,1194
9,2404,10,100,0.0001,0.01,0.526,0.7799500831946755,1165,1239
9,2504,10,100,0.0001,0.01,0.558,0.7891373801916933,1221,1283
9,2604,10,100,0.0001,0.01,0.524,0.7684331797235023,1265,1339
9,2704,10,100,0.0001,0.01,0.538,0.7625739644970414,1306,1398
9,2804,10,100,0.0001,0.01,0.554,0.776034236804565,1354,1450
9,2904,10,100,0.0001,0.01,0.568,0.7827134986225895,1404,1500
9,3004,10,100,0.0001,0.01,0.55,0.7952729693741678,1447,1557
9,3104,10,100,0.0001,0.01,0.576,0.7857603092783505,1504,1600
9,3204,10,100,0.0001,0.01,0.568,0.7843320848938826,1549,1655
9,3304,10,100,0.0001,0.01,0.574,0.7808716707021792,1596,1708
9,3404,10,100,0.0001,0.01,0.56,0.7737955346650999,1646,1758
9,3504,10,100,0.0001,0.01,0.584,0.776255707762557,1697,1807
9,3604,10,100,0.0001,0.01,0.556,0.7752497225305216,1740,1864
9,3704,10,100,0.0001,0.01,0.546,0.7680885529157667,1786,1918
9,3804,10,100,0.0001,0.01,0.584,0.7981072555205048,1832,1972
9,3904,10,100,0.0001,0.01,0.554,0.8130122950819673,1883,2021
9,4004,10,100,0.0001,0.01,0.568,0.8194305694305695,1929,2075
9,4104,10,100,0.0001,0.01,0.556,0.8189571150097466,1983,2121
9,4204,10,100,0.0001,0.01,0.57,0.8311132254995243,2033,2171
9,4304,10,100,0.0001,0.01,0.598,0.8071561338289963,2087,2217
9,4404,10,100,0.0001,0.01,0.606,0.8242506811989101,2135,2269
9,4504,10,100,0.0001,0.01,0.594,0.8210479573712256,2191,2313
9,4604,10,100,0.0001,0.01,0.582,0.828627280625543,2248,2356
9,4704,10,100,0.0001,0.01,0.604,0.8235544217687075,2288,2416
9,4804,10,100,0.0001,0.01,0.622,0.8399250624479601,2336,2468
9,4904,10,100,0.0001,0.01,0.602,0.8413539967373572,2379,2525
9,5004,10,100,0.0001,0.01,0.608,0.851119104716227,2428,2576
9,5104,10,100,0.0001,0.01,0.6,0.86108934169279,2480,2624
9,5204,10,100,0.0001,0.01,0.592,0.8503074558032283,2529,2675
9,5304,10,100,0.0001,0.01,0.594,0.8389894419306184,2579,2725
9,5404,10,100,0.0001,0.01,0.6,0.8454848260547743,2630,2774
9,5504,10,100,0.0001,0.01,0.606,0.854469476744186,2683,2821
9,5604,10,100,0.0001,0.01,0.622,0.8536759457530335,2729,2875
9,5704,10,100,0.0001,0.01,0.618,0.8350280504908836,2786,2918
9,5804,10,100,0.0001,0.01,0.628,0.8606133700895934,2841,2963
9,5904,10,100,0.0001,0.01,0.638,0.8655149051490515,2901,3003
9,6004,10,100,0.0001,0.01,0.644,0.8757495003331113,2948,3056
9,6104,10,100,0.0001,0.01,0.632,0.8666448230668414,3001,3103
9,6204,10,100,0.0001,0.01,0.628,0.8462282398452611,3055,3149
9,6304,10,100,0.0001,0.01,0.642,0.8781725888324873,3097,3207
9,6404,10,100,0.0001,0.01,0.644,0.8777326670830731,3146,3258
9,6504,10,100,0.0001,0.01,0.64,0.892220172201722,3199,3305
9,6604,10,100,0.0001,0.01,0.652,0.8914294367050273,3250,3354
9,6704,10,100,0.0001,0.01,0.624,0.8990155131264916,3295,3409
9,6804,10,100,0.0001,0.01,0.652,0.8816872427983539,3351,3453
9,6904,10,100,0.0001,0.01,0.662,0.886297798377752,3400,3504
9,7004,10,100,0.0001,0.01,0.638,0.8913478012564249,3454,3550
9,7104,10,100,0.0001,0.01,0.648,0.8643018018018018,3504,3600
9,7204,10,100,0.0001,0.01,0.658,0.882565241532482,3554,3650
9,7304,10,100,0.0001,0.01,0.676,0.8877327491785323,3600,3704
9,7404,10,100,0.0001,0.01,0.682,0.88290113452188,3649,3755
9,7504,10,100,0.0001,0.01,0.634,0.8626066098081023,3698,3806
9,7604,10,100,0.0001,0.01,0.666,0.8874276696475539,3750,3854
9,7704,10,100,0.0001,0.01,0.676,0.9066718587746625,3803,3901
9,7804,10,100,0.0001,0.01,0.684,0.9047924141465915,3851,3953
9,7904,10,100,0.0001,0.01,0.652,0.9161184210526315,3905,3999
9,8004,10,100,0.0001,0.01,0.7,0.9186656671664168,3953,4051
9,8104,10,100,0.0001,0.01,0.67,0.9209032576505429,4009,4095
9,8204,10,100,0.0001,0.01,0.678,0.9133349585568016,4071,4133
9,8304,10,100,0.0001,0.01,0.668,0.9129335260115607,4128,4176
9,8404,10,100,0.0001,0.01,0.686,0.9083769633507853,4178,4226
9,8504,10,100,0.0001,0.01,0.678,0.9027516462841016,4228,4276
9,8604,10,100,0.0001,0.01,0.694,0.9207345420734542,4277,4327
9,8704,10,100,0.0001,0.01,0.724,0.9047564338235294,4325,4379
9,8804,10,100,0.0001,0.01,0.702,0.9218537028623353,4374,4430
9,8904,10,100,0.0001,0.01,0.71,0.9098158131176999,4420,4484
9,9004,10,100,0.0001,0.01,0.702,0.9185917370057752,4471,4533
9,9104,10,100,0.0001,0.01,0.68,0.906085237258348,4517,4587
9,9204,10,100,0.0001,0.01,0.722,0.9146023468057366,4574,4630
9,9304,10,100,0.0001,0.01,0.708,0.9098237317282889,4629,4675
9,9404,10,100,0.0001,0.01,0.694,0.9193960017014037,4690,4714
9,9504,10,100,0.0001,0.01,0.712,0.9087752525252525,4745,4759
9,9604,10,100,0.0001,0.01,0.718,0.923469387755102,4799,4805
9,9704,10,100,0.0001,0.01,0.702,0.8837592745259687,4839,4865
9,9804,10,100,0.0001,0.01,0.744,0.8959608323133414,4890,4914
9,9904,10,100,0.0001,0.01,0.74,0.904281098546042,4949,4955
9,10004,10,100,0.0001,0.01,0.73,0.9038384646141543,5000,5004
9,10104,10,100,0.0001,0.01,0.716,0.9145882818685669,5049,5055
9,10204,10,100,0.0001,0.01,0.716,0.92218737749902,5095,5109
9,10304,10,100,0.0001,0.01,0.726,0.9319681677018633,5146,5158
9,10404,10,100,0.0001,0.01,0.752,0.9338715878508266,5193,5211
9,10504,10,100,0.0001,0.01,0.756,0.925932977913176,5240,5264
9,10604,10,100,0.0001,0.01,0.748,0.9355903432666918,5294,5310
9,10704,10,100,0.0001,0.01,0.764,0.9388079222720478,5346,5358
9,10804,10,100,0.0001,0.01,0.742,0.9409477971121807,5398,5406
9,10904,10,100,0.0001,0.01,0.732,0.9182868672046955,5443,5461
9,11004,10,100,0.0001,0.01,0.74,0.9278444202108325,5490,5514
9,11104,10,100,0.0001,0.01,0.748,0.9246217579250721,5539,5565
9,11204,10,100,0.0001,0.01,0.758,0.9424312745448055,5589,5615
9,11304,10,100,0.0001,0.01,0.73,0.9229476291578202,5645,5659
9,11404,10,100,0.0001,0.01,0.734,0.9400210452472817,5693,5711
9,11504,10,100,0.0001,0.01,0.774,0.9515820584144645,5746,5758
9,11604,10,100,0.0001,0.01,0.764,0.9472595656670114,5795,5809
9,11704,10,100,0.0001,0.01,0.796,0.931390977443609,5845,5859
9,11804,10,100,0.0001,0.01,0.754,0.943154862758387,5894,5910
9,11904,10,100,0.0001,0.01,0.77,0.9424563172043011,5944,5960
9,12004,10,100,0.0001,0.01,0.754,0.9231089636787737,5998,6006
9,12104,10,100,0.0001,0.01,0.762,0.9444811632518176,6049,6055
9,12204,10,100,0.0001,0.01,0.76,0.9294493608652901,6097,6107
9,12304,10,100,0.0001,0.01,0.772,0.9477405721716515,6147,6157
9,12404,10,100,0.0001,0.01,0.77,0.9426797807158981,6199,6205
9,12504,10,100,0.0001,0.01,0.772,0.940978886756238,6252,6252
9,12604,10,100,0.0001,0.01,0.798,0.9437480165026976,6308,6296
9,12704,10,100,0.0001,0.01,0.77,0.9389168765743073,6359,6345
9,12804,10,100,0.0001,0.01,0.792,0.9479850046860356,6405,6399
9,12904,10,100,0.0001,0.01,0.804,0.9382362058276503,6455,6449
9,13004,10,100,0.0001,0.01,0.8,0.9339434020301446,6504,6500
9,13104,10,100,0.0001,0.01,0.786,0.9571123321123322,6558,6546
9,13204,10,100,0.0001,0.01,0.816,0.9347924871251136,6605,6599
9,13304,10,100,0.0001,0.01,0.78,0.9011575466025256,6660,6644
9,13404,10,100,0.0001,0.01,0.81,0.9400925096985975,6709,6695
9,13504,10,100,0.0001,0.01,0.812,0.9460900473933649,6756,6748
9,13604,10,100,0.0001,0.01,0.834,0.9564833872390474,6800,6804
9,13704,10,100,0.0001,0.01,0.81,0.9491389375364857,6852,6852
9,13804,10,100,0.0001,0.01,0.826,0.9507389162561576,6898,6906
9,13904,10,100,0.0001,0.01,0.808,0.9524597238204833,6947,6957
9,14004,10,100,0.0001,0.01,0.82,0.9557269351613824,7001,7003
9,14104,10,100,0.0001,0.01,0.814,0.9601531480431084,7056,7048
9,14204,10,100,0.0001,0.01,0.828,0.9603632779498733,7104,7100
9,14304,10,100,0.0001,0.01,0.812,0.9556068232662193,7155,7149
9,14404,10,100,0.0001,0.01,0.816,0.9466814773673979,7211,7193
9,14504,10,100,0.0001,0.01,0.808,0.9446359624931053,7263,7241
9,14604,10,100,0.0001,0.01,0.824,0.9548753766091482,7314,7290
9,14704,10,100,0.0001,0.01,0.802,0.955930359085963,7367,7337
9,14804,10,100,0.0001,0.01,0.824,0.958930018913807,7419,7385
9,14904,10,100,0.0001,0.01,0.834,0.961352657004831,7465,7439
9,15004,10,100,0.0001,0.01,0.83,0.9594108237803253,7517,7487
10,104,10,100,0.0001,0.01,0.5,0.5865384615384616,61,43
10,204,10,100,0.0001,0.01,0.512,0.5833333333333334,108,96
10,304,10,100,0.0001,0.01,0.488,0.5296052631578947,156,148
10,404,10,100,0.0001,0.01,0.492,0.5767326732673267,209,195
10,504,10,100,0.0001,0.01,0.526,0.6170634920634921,251,253
10,604,10,100,0.0001,0.01,0.534,0.5894039735099338,304,300
10,704,10,100,0.0001,0.01,0.52,0.6022727272727273,355,349
10,804,10,100,0.0001,0.01,0.522,0.6243781094527363,404,400
10,904,10,100,0.0001,0.01,0.506,0.6393805309734514,450,454
10,1004,10,100,0.0001,0.01,0.52,0.650398406374502,498,506
10,1104,10,100,0.0001,0.01,0.528,0.654891304347826,549,555
10,1204,10,100,0.0001,0.01,0.544,0.6827242524916943,595,609
10,1304,10,100,0.0001,0.01,0.512,0.6809815950920245,643,661
10,1404,10,100,0.0001,0.01,0.548,0.7193732193732194,693,711
10,1504,10,100,0.0001,0.01,0.532,0.7054521276595744,740,764
10,1604,10,100,0.0001,0.01,0.558,0.7325436408977556,798,806
10,1704,10,100,0.0001,0.01,0.516,0.7124413145539906,850,854
10,1804,10,100,0.0001,0.01,0.558,0.7660753880266076,900,904
10,1904,10,100,0.0001,0.01,0.536,0.7531512605042017,950,954
10,2004,10,100,0.0001,0.01,0.538,0.7714570858283433,1001,1003
10,2104,10,100,0.0001,0.01,0.578,0.8084600760456274,1051,1053
10,2204,10,100,0.0001,0.01,0.57,0.7835753176043557,1102,1102
10,2304,10,100,0.0001,0.01,0.584,0.7886284722222222,1150,1154
10,2404,10,100,0.0001,0.01,0.588,0.8348585690515807,1202,1202
10,2504,10,100,0.0001,0.01,0.612,0.8334664536741214,1257,1247
10,2604,10,100,0.0001,0.01,0.634,0.8671274961597543,1314,1290
10,2704,10,100,0.0001,0.01,0.632,0.8609467455621301,1367,1337
10,2804,10,100,0.0001,0.01,0.652,0.87660485021398,1415,1389
10,2904,10,100,0.0001,0.01,0.634,0.8984159779614325,1469,1435
10,3004,10,100,0.0001,0.01,0.666,0.8931424766977364,1522,1482
10,3104,10,100,0.0001,0.01,0.652,0.8350515463917526,1567,1537
10,3204,10,100,0.0001,0.01,0.662,0.8636079900124844,1612,1592
10,3304,10,100,0.0001,0.01,0.69,0.8771186440677966,1656,1648
10,3404,10,100,0.0001,0.01,0.708,0.9112808460634547,1709,1695
10,3504,10,100,0.0001,0.01,0.766,0.9426369863013698,1749,1755
10,3604,10,100,0.0001,0.01,0.766,0.9642064372918979,1793,1811
10,3704,10,100,0.0001,0.01,0.814,0.9703023758099352,1846,1858
10,3804,10,100,0.0001,0.01,0.822,0.9729232386961093,1896,1908
10,3904,10,100,0.0001,0.01,0.82,0.9784836065573771,1948,1956
10,4004,10,100,0.0001,0.01,0.832,0.9692807192807192,1992,2012
10,4104,10,100,0.0001,0.01,0.85,0.979775828460039,2034,2070
10,4204,10,100,0.0001,0.01,0.836,0.9731208372978116,2085,2119
10,4304,10,100,0.0001,0.01,0.848,0.9767657992565055,2128,2176
10,4404,10,100,0.0001,0.01,0.866,0.9727520435967303,2180,2224
10,4504,10,100,0.0001,0.01,0.884,0.9842362344582594,2226,2278
10,4604,10,100,0.0001,0.01,0.902,0.9856646394439618,2270,2334
10,4704,10,100,0.0001,0.01,0.9,0.9887329931972789,2317,2387
10,4804,10,100,0.0001,0.01,0.902,0.9906328059950041,2372,2432
10,4904,10,100,0.0001,0.01,0.89,0.9879690048939641,2410,2494
10,5004,10,100,0.0001,0.01,0.872,0.9840127897681854,2456,2548
10,5104,10,100,0.0001,0.01,0.908,0.9925548589341693,2509,2595
10,5204,10,100,0.0001,0.01,0.92,0.9905841660261338,2561,2643
10,5304,10,100,0.0001,0.01,0.91,0.9849170437405732,2617,2687
10,5404,10,100,0.0001,0.01,0.92,0.9888971132494448,2664,2740
10,5504,10,100,0.0001,0.01,0.914,0.9796511627906976,2705,2799
10,5604,10,100,0.0001,0.01,0.918,0.9825124910778016,2755,2849
10,5704,10,100,0.0001,0.01,0.94,0.9873772791023843,2800,2904
10,5804,10,100,0.0001,0.01,0.93,0.9877670572019297,2853,2951
10,5904,10,100,0.0001,0.01,0.924,0.9884823848238482,2900,3004
10,6004,10,100,0.0001,0.01,0.936,0.9860093271152565,2951,3053
10,6104,10,100,0.0001,0.01,0.936,0.9842726081258192,2995,3109
10,6204,10,100,0.0001,0.01,0.952,0.9896840747904577,3038,3166
10,6304,10,100,0.0001,0.01,0.952,0.9906408629441624,3097,3207
10,6404,10,100,0.0001,0.01,0.94,0.995159275452842,3147,3257
10,6504,10,100,0.0001,0.01,0.962,0.9953874538745388,3187,3317
10,6604,10,100,0.0001,0.01,0.944,0.9947001817080557,3240,3364
10,6704,10,100,0.0001,0.01,0.956,0.9938842482100239,3292,3412
10,6804,10,100,0.0001,0.01,0.952,0.9913286302175192,3342,3462
10,6904,10,100,0.0001,0.01,0.944,0.9688586326767091,3402,3502
10,7004,10,100,0.0001,0.01,0.962,0.990434037692747,3447,3557
10,7104,10,100,0.0001,0.01,0.968,0.9916948198198198,3495,3609
10,7204,10,100,0.0001,0.01,0.958,0.9913936701832315,3544,3660
10,7304,10,100,0.0001,0.01,0.966,0.9927437020810514,3597,3707
10,7404,10,100,0.0001,0.01,0.966,0.9958130740140465,3640,3764
10,7504,10,100,0.0001,0.01,0.962,0.9912046908315565,3690,3814
10,7604,10,100,0.0001,0.01,0.904,0.9679116254602841,3743,3861
10,7704,10,100,0.0001,0.01,0.948,0.9691069574247144,3795,3909
10,7804,10,100,0.0001,0.01,0.942,0.9751409533572527,3847,3957
10,7904,10,100,0.0001,0.01,0.936,0.9671052631578947,3895,4009
10,8004,10,100,0.0001,0.01,0.956,0.9863818090954523,3940,4064
10,8104,10,100,0.0001,0.01,0.972,0.9921026653504442,3990,4114
10,8204,10,100,0.0001,0.01,0.966,0.9928083861530961,4037,4167
10,8304,10,100,0.0001,0.01,0.966,0.9948217726396917,4090,4214
10,8404,10,100,0.0001,0.01,0.958,0.993455497382199,4146,4258
10,8504,10,100,0.0001,0.01,0.966,0.9962370649106302,4197,4307
10,8604,10,100,0.0001,0.01,0.952,0.9891910739191074,4241,4363
10,8704,10,100,0.0001,0.01,0.964,0.9928768382352942,4294,4410
10,8804,10,100,0.0001,0.01,0.946,0.9920490686051795,4339,4465
10,8904,10,100,0.0001,0.01,0.966,0.9961814914645103,4387,4517
10,9004,10,100,0.0001,0.01,0.972,0.9983340737450023,4436,4568
10,9104,10,100,0.0001,0.01,0.968,0.9953866432337434,4479,4625
10,9204,10,100,0.0001,0.01,0.97,0.9940243372446762,4528,4676
10,9304,10,100,0.0001,0.01,0.952,0.9920464316423044,4578,4726
10,9404,10,100,0.0001,0.01,0.952,0.9730965546575925,4627,4777
10,9504,10,100,0.0001,0.01,0.966,0.9869528619528619,4667,4837
10,9604,10,100,0.0001,0.01,0.966,0.9895876718034152,4717,4887
10,9704,10,100,0.0001,0.01,0.97,0.9958779884583677,4776,4928
10,9804,10,100,0.0001,0.01,0.97,0.9978580171358629,4821,4983
10,9904,10,100,0.0001,0.01,0.962,0.9980815831987075,4878,5026
10,10004,10,100,0.0001,0.01,0.954,0.9953018792483007,4926,5078
10,10104,10,100,0.0001,0.01,0.954,0.9942596991290578,4978,5126
10,10204,10,100,0.0001,0.01,0.972,0.994609956879655,5022,5182
10,10304,10,100,0.0001,0.01,0.968,0.9944681677018633,5083,5221
10,10404,10,100,0.0001,0.01,0.968,0.9905805459438678,5140,5264
10,10504,10,100,0.0001,0.01,0.966,0.9886709824828637,5192,5312
10,10604,10,100,0.0001,0.01,0.972,0.9906639004149378,5244,5360
10,10704,10,100,0.0001,0.01,0.974,0.9954222720478326,5300,5404
10,10804,10,100,0.0001,0.01,0.966,0.9966679007774898,5358,5446
10,10904,10,100,0.0001,0.01,0.972,0.9978906823184153,5409,5495
10,11004,10,100,0.0001,0.01,0.972,0.9950018175209014,5455,5549
10,11104,10,100,0.0001,0.01,0.974,0.9961275216138329,5508,5596
10,11204,10,100,0.0001,0.01,0.974,0.9954480542663334,5562,5642
10,11304,10,100,0.0001,0.01,0.972,0.9974345364472753,5616,5688
10,11404,10,100,0.0001,0.01,0.968,0.9943879340582252,5662,5742
10,11504,10,100,0.0001,0.01,0.962,0.991394297635605,5709,5795
10,11604,10,100,0.0001,0.01,0.968,0.9838848672871424,5754,5850
10,11704,10,100,0.0001,0.01,0.972,0.9942754613807245,5804,5900
10,11804,10,100,0.0001,0.01,0.966,0.9910199932226363,5861,5943
10,11904,10,100,0.0001,0.01,0.968,0.9952116935483871,5905,5999
10,12004,10,100,0.0001,0.01,0.97,0.9931689436854382,5963,6041
10,12104,10,100,0.0001,0.01,0.968,0.9938037012557832,6016,6088
10,12204,10,100,0.0001,0.01,0.976,0.9962307440183547,6074,6130
10,12304,10,100,0.0001,0.01,0.966,0.9937418725617685,6129,6175
10,12404,10,100,0.0001,0.01,0.966,0.9925024185746534,6180,6224
10,12504,10,100,0.0001,0.01,0.958,0.9823256557901472,6233,6271
10,12604,10,100,0.0001,0.01,0.976,0.995001586797842,6280,6324
10,12704,10,100,0.0001,0.01,0.97,0.9961429471032746,6340,6364
10,12804,10,100,0.0001,0.01,0.974,0.996797875663855,6389,6415
10,12904,10,100,0.0001,0.01,0.982,0.9979851208927464,6440,6464
10,13004,10,100,0.0001,0.01,0.966,0.9926945555213781,6485,6519
10,13104,10,100,0.0001,0.01,0.966,0.9927503052503053,6543,6561
10,13204,10,100,0.0001,0.01,0.976,0.9920478642835504,6593,6611
10,13304,10,100,0.0001,0.01,0.976,0.9933854479855683,6649,6655
10,13404,10,100,0.0001,0.01,0.98,0.9939570277529096,6702,6702
10,13504,10,100,0.0001,0.01,0.974,0.9934834123222749,6749,6755
10,13604,10,100,0.0001,0.01,0.976,0.9947809467803587,6800,6804
10,13704,10,100,0.0001,0.01,0.968,0.9967892586106246,6848,6856
10,13804,10,100,0.0001,0.01,0.986,0.9969574036511156,6901,6903
10,13904,10,100,0.0001,0.01,0.962,0.994102416570771,6948,6956
10,14004,10,100,0.0001,0.01,0.976,0.9940017137960583,7007,6997
10,14104,10,100,0.0001,0.01,0.972,0.9924134997163925,7060,7044
10,14204,10,100,0.0001,0.01,0.968,0.992466910729372,7109,7095
10,14304,10,100,0.0001,0.01,0.97,0.9952460850111857,7162,7142
10,14404,10,100,0.0001,0.01,0.976,0.9972229936128854,7206,7198
10,14504,10,100,0.0001,0.01,0.976,0.9957253171538886,7254,7250
10,14604,10,100,0.0001,0.01,0.972,0.9878115584771295,7306,7298
10,14704,10,100,0.0001,0.01,0.982,0.9956474428726877,7356,7348
10,14804,10,100,0.0001,0.01,0.976,0.9925695757903269,7407,7397
10,14904,10,100,0.0001,0.01,0.98,0.995907139023081,7449,7455
10,15004,10,100,0.0001,0.01,0.974,0.99673420421221,7502,7502
11,104,10,100,0.0001,0.01,0.508,0.5384615384615384,48,56
11,204,10,100,0.0001,0.01,0.5,0.5735294117647058,103,101
11,304,10,100,0.0001,0.01,0.53,0.6019736842105263,153,151
11,404,10,100,0.0001,0.01,0.502,0.6089108910891089,203,201
11,504,10,100,0.0001,0.01,0.48,0.6190476190476191,254,250
11,604,10,100,0.0001,0.01,0.488,0.6374172185430463,306,298
11,704,10,100,0.0001,0.01,0.466,0.6321022727272727,356,348
11,804,10,100,0.0001,0.01,0.476,0.6579601990049752,409,395
11,904,10,100,0.0001,0.01,0.474,0.6238938053097345,460,444
11,1004,10,100,0.0001,0.01,0.51,0.6723107569721115,511,493
11,1104,10,100,0.0001,0.01,0.512,0.6503623188405797,563,541
11,1204,10,100,0.0001,0.01,0.53,0.6769102990033222,598,606
11,1304,10,100,0.0001,0.01,0.492,0.6510736196319018,646,658
11,1404,10,100,0.0001,0.01,0.516,0.7008547008547008,692,712
11,1504,10,100,0.0001,0.01,0.512,0.7007978723404256,744,760
11,1604,10,100,0.0001,0.01,0.51,0.7369077306733167,796,808
11,1704,10,100,0.0001,0.01,0.536,0.7411971830985915,857,847
11,1804,10,100,0.0001,0.01,0.512,0.7416851441241685,906,898
11,1904,10,100,0.0001,0.01,0.5,0.7515756302521008,959,945
11,2004,10,100,0.0001,0.01,0.496,0.7370259481037924,1003,1001
11,2104,10,100,0.0001,0.01,0.532,0.7100760456273765,1055,1049
11,2204,10,100,0.0001,0.01,0.51,0.7363883847549909,1098,1106
11,2304,10,100,0.0001,0.01,0.506,0.7508680555555556,1152,1152
11,2404,10,100,0.0001,0.01,0.488,0.7487520798668885,1196,1208
11,2504,10,100,0.0001,0.01,0.488,0.7787539936102237,1247,1257
11,2604,10,100,0.0001,0.01,0.496,0.7899385560675883,1305,1299
11,2704,10,100,0.0001,0.01,0.5,0.7629437869822485,1354,1350
11,2804,10,100,0.0001,0.01,0.502,0.7917261055634808,1401,1403
11,2904,10,100,0.0001,0.01,0.524,0.7947658402203857,1452,1452
11,3004,10,100,0.0001,0.01,0.522,0.7879494007989347,1501,1503
11,3104,10,100,0.0001,0.01,0.512,0.8044458762886598,1552,1552
11,3204,10,100,0.0001,0.01,0.518,0.8289637952559301,1605,1599
11,3304,10,100,0.0001,0.01,0.492,0.8108353510895884,1653,1651
11,3404,10,100,0.0001,0.01,0.516,0.8169800235017627,1705,1699
11,3504,10,100,0.0001,0.01,0.506,0.803082191780822,1760,1744
11,3604,10,100,0.0001,0.01,0.546,0.8174250832408435,1815,1789
11,3704,10,100,0.0001,0.01,0.506,0.8382829373650108,1872,1832
11,3804,10,100,0.0001,0.01,0.524,0.8088853838065194,1927,1877
11,3904,10,100,0.0001,0.01,0.538,0.8445184426229508,1981,1923
11,4004,10,100,0.0001,0.01,0.536,0.8459040959040959,2034,1970
11,4104,10,100,0.0001,0.01,0.522,0.844541910331384,2089,2015
11,4204,10,100,0.0001,0.01,0.516,0.8399143672692674,2141,2063
11,4304,10,100,0.0001,0.01,0.51,0.8336431226765799,2187,2117
11,4404,10,100,0.0001,0.01,0.504,0.8460490463215259,2233,2171
11,4504,10,100,0.0001,0.01,0.562,0.8257104795737122,2283,2221
11,4604,10,100,0.0001,0.01,0.518,0.828627280625543,2334,2270
11,4704,10,100,0.0001,0.01,0.516,0.8244047619047619,2382,2322
11,4804,10,100,0.0001,0.01,0.496,0.8365945045795171,2435,2369
11,4904,10,100,0.0001,0.01,0.508,0.8032218597063622,2479,2425
11,5004,10,100,0.0001,0.01,0.502,0.8321342925659473,2531,2473
11,5104,10,100,0.0001,0.01,0.532,0.8038793103448276,2583,2521
11,5204,10,100,0.0001,0.01,0.51,0.8324365872405841,2630,2574
11,5304,10,100,0.0001,0.01,0.518,0.8225867269984917,2675,2629
11,5404,10,100,0.0001,0.01,0.506,0.8397483345669874,2721,2683
11,5504,10,100,0.0001,0.01,0.516,0.7896075581395349,2768,2736
11,5604,10,100,0.0001,0.01,0.514,0.806745182012848,2820,2784
11,5704,10,100,0.0001,0.01,0.526,0.8145161290322581,2880,2824
11,5804,10,100,0.0001,0.01,0.528,0.8263266712611992,2926,2878
11,5904,10,100,0.0001,0.01,0.506,0.8204607046070461,2975,2929
11,6004,10,100,0.0001,0.01,0.544,0.8481012658227848,3026,2978
11,6104,10,100,0.0001,0.01,0.534,0.8620576671035387,3074,3030
11,6204,10,100,0.0001,0.01,0.542,0.8652482269503546,3125,3079
11,6304,10,100,0.0001,0.01,0.562,0.8775380710659898,3174,3130
11,6404,10,100,0.0001,0.01,0.552,0.8513429106808245,3237,3167
11,6504,10,100,0.0001,0.01,0.536,0.8631611316113161,3279,3225
11,6604,10,100,0.0001,0.01,0.57,0.8584191399152029,3327,3277
11,6704,10,100,0.0001,0.01,0.564,0.8527744630071599,3379,3325
11,6804,10,100,0.0001,0.01,0.568,0.8600823045267489,3431,3373
11,6904,10,100,0.0001,0.01,0.526,0.8270567786790266,3485,3419
11,7004,10,100,0.0001,0.01,0.522,0.8516561964591662,3535,3469
11,7104,10,100,0.0001,0.01,0.562,0.8139076576576577,3568,3536
11,7204,10,100,0.0001,0.01,0.582,0.8402276513048307,3619,3585
11,7304,10,100,0.0001,0.01,0.534,0.8481653888280394,3664,3640
11,7404,10,100,0.0001,0.01,0.59,0.8522420313344138,3716,3688
11,7504,10,100,0.0001,0.01,0.56,0.8714019189765458,3767,3737
11,7604,10,100,0.0001,0.01,0.59,0.8680957390846923,3811,3793
11,7704,10,100,0.0001,0.01,0.576,0.8762980269989615,3862,3842
11,7804,10,100,0.0001,0.01,0.59,0.8822398769861609,3917,3887
11,7904,10,100,0.0001,0.01,0.604,0.8937246963562753,3973,3931
11,8004,10,100,0.0001,0.01,0.58,0.8871814092953523,4024,3980
11,8104,10,100,0.0001,0.01,0.58,0.8968410661401777,4082,4022
11,8204,10,100,0.0001,0.01,0.592,0.8881033642125792,4129,4075
11,8304,10,100,0.0001,0.01,0.596,0.8942678227360308,4178,4126
11,8404,10,100,0.0001,0.01,0.608,0.9004045692527368,4222,4182
11,8504,10,100,0.0001,0.01,0.618,0.8954609595484478,4280,4224
11,8604,10,100,0.0001,0.01,0.61,0.898884239888424,4334,4270
11,8704,10,100,0.0001,0.01,0.602,0.9057904411764706,4381,4323
11,8804,10,100,0.0001,0.01,0.636,0.8949341208541572,4433,4371
11,8904,10,100,0.0001,0.01,0.628,0.8766846361185984,4482,4422
11,9004,10,100,0.0001,0.01,0.638,0.9005997334517992,4539,4465
11,9104,10,100,0.0001,0.01,0.632,0.9074033391915641,4596,4508
11,9204,10,100,0.0001,0.01,0.62,0.904606692742286,4638,4566
11,9304,10,100,0.0001,0.01,0.624,0.8963886500429923,4690,4614
11,9404,10,100,0.0001,0.01,0.638,0.9035516801361123,4739,4665
11,9504,10,100,0.0001,0.01,0.646,0.89614898989899,4782,4722
11,9604,10,100,0.0001,0.01,0.664,0.9073302790503956,4833,4771
11,9704,10,100,0.0001,0.01,0.666,0.9117889530090684,4874,4830
11,9804,10,100,0.0001,0.01,0.658,0.9042227662178702,4922,4882
11,9904,10,100,0.0001,0.01,0.688,0.9010500807754442,4971,4933
11,10004,10,100,0.0001,0.01,0.62,0.9025389844062375,5025,4979
11,10104,10,100,0.0001,0.01,0.656,0.9158749010292954,5085,5019
11,10204,10,100,0.0001,0.01,0.67,0.9098392787142298,5126,5078
11,10304,10,100,0.0001,0.01,0.664,0.9271156832298136,5182,5122
11,10404,10,100,0.0001,0.01,0.628,0.9163783160322952,5230,5174
11,10504,10,100,0.0001,0.01,0.68,0.9162223914699162,5282,5222
11,10604,10,100,0.0001,0.01,0.694,0.9160694077706526,5330,5274
11,10704,10,100,0.0001,0.01,0.67,0.9250747384155455,5374,5330
11,10804,10,100,0.0001,0.01,0.704,0.9255831173639393,5430,5374
11,10904,10,100,0.0001,0.01,0.69,0.9312179016874541,5482,5422
11,11004,10,100,0.0001,0.01,0.682,0.9402944383860414,5538,5466
11,11104,10,100,0.0001,0.01,0.716,0.9294848703170029,5589,5515
11,11204,10,100,0.0001,0.01,0.668,0.920474830417708,5637,5567
11,11304,10,100,0.0001,0.01,0.66,0.9061394196744516,5692,5612
11,11404,10,100,0.0001,0.01,0.698,0.9184496667835848,5743,5661
11,11504,10,100,0.0001,0.01,0.69,0.9156815020862309,5795,5709
11,11604,10,100,0.0001,0.01,0.71,0.9360565322302654,5841,5763
11,11704,10,100,0.0001,0.01,0.73,0.9354066985645934,5889,5815
11,11804,10,100,0.0001,0.01,0.708,0.9275669264656049,5942,5862
11,11904,10,100,0.0001,0.01,0.734,0.9431283602150538,6002,5902
11,12004,10,100,0.0001,0.01,0.714,0.9369376874375208,6048,5956
11,12104,10,100,0.0001,0.01,0.714,0.9402676801057501,6098,6006
11,12204,10,100,0.0001,0.01,0.714,0.9336283185840708,6148,6056
11,12304,10,100,0.0001,0.01,0.712,0.9340052015604682,6204,6100
11,12404,10,100,0.0001,0.01,0.708,0.9381651080296678,6248,6156
11,12504,10,100,0.0001,0.01,0.726,0.9468170185540628,6304,6200
11,12604,10,100,0.0001,0.01,0.734,0.9519993652808633,6353,6251
11,12704,10,100,0.0001,0.01,0.742,0.9366341309823678,6406,6298
11,12804,10,100,0.0001,0.01,0.742,0.9468915963761324,6453,6351
11,12904,10,100,0.0001,0.01,0.724,0.9273093614383137,6500,6404
11,13004,10,100,0.0001,0.01,0.708,0.9322516148877269,6543,6461
11,13104,10,100,0.0001,0.01,0.718,0.9101037851037851,6595,6509
11,13204,10,100,0.0001,0.01,0.766,0.9289609209330506,6643,6561
11,13304,10,100,0.0001,0.01,0.758,0.944152134696332,6687,6617
11,13404,10,100,0.0001,0.01,0.758,0.9428528797373918,6746,6658
11,13504,10,100,0.0001,0.01,0.752,0.9370556872037915,6794,6710
11,13604,10,100,0.0001,0.01,0.75,0.9428844457512496,6845,6759
11,13704,10,100,0.0001,0.01,0.772,0.9502335084646818,6890,6814
11,13804,10,100,0.0001,0.01,0.774,0.9535641842944074,6943,6861
11,13904,10,100,0.0001,0.01,0.716,0.9297324510932106,6995,6909
11,14004,10,100,0.0001,0.01,0.736,0.93416166809483,7042,6962
11,14104,10,100,0.0001,0.01,0.774,0.9602240499149177,7088,7016
11,14204,10,100,0.0001,0.01,0.786,0.9479019994367783,7127,7077
11,14304,10,100,0.0001,0.01,0.764,0.9440715883668904,7172,7132
11,14404,10,100,0.0001,0.01,0.774,0.9485559566787004,7219,7185
11,14504,10,100,0.0001,0.01,0.756,0.9542195256480971,7270,7234
11,14604,10,100,0.0001,0.01,0.75,0.9314571350314982,7315,7289
11,14704,10,100,0.0001,0.01,0.794,0.9494695321001088,7358,7346
11,14804,10,100,0.0001,0.01,0.788,0.9583896244258309,7411,7393
11,14904,10,100,0.0001,0.01,0.806,0.9592726784755771,7465,7439
11,15004,10,100,0.0001,0.01,0.788,0.9494134897360704,7506,7498
12,104,10,100,0.0001,0.01,0.51,0.5961538461538461,42,62
12,204,10,100,0.0001,0.01,0.518,0.5637254901960784,89,115
12,304,10,100,0.0001,0.01,0.508,0.5394736842105263,140,164
12,404,10,100,0.0001,0.01,0.52,0.5767326732673267,192,212
12,504,10,100,0.0001,0.01,0.51,0.5515873015873016,242,262
12,604,10,100,0.0001,0.01,0.492,0.6026490066225165,291,313
12,704,10,100,0.0001,0.01,0.488,0.59375,333,371
12,804,10,100,0.0001,0.01,0.492,0.6206467661691543,379,425
12,904,10,100,0.0001,0.01,0.51,0.6084070796460177,422,482
12,1004,10,100,0.0001,0.01,0.5,0.6444223107569721,478,526
12,1104,10,100,0.0001,0.01,0.512,0.6340579710144928,522,582
12,1204,10,100,0.0001,0.01,0.526,0.6478405315614618,570,634
12,1304,10,100,0.0001,0.01,0.506,0.6687116564417178,617,687
12,1404,10,100,0.0001,0.01,0.508,0.7072649572649573,659,745
12,1504,10,100,0.0001,0.01,0.5,0.6728723404255319,713,791
12,1604,10,100,0.0001,0.01,0.49,0.7038653366583542,758,846
12,1704,10,100,0.0001,0.01,0.512,0.7200704225352113,813,891
12,1804,10,100,0.0001,0.01,0.52,0.7427937915742794,859,945
12,1904,10,100,0.0001,0.01,0.512,0.7526260504201681,906,998
12,2004,10,100,0.0001,0.01,0.516,0.7764471057884231,950,1054
12,2104,10,100,0.0001,0.01,0.558,0.7903992395437263,997,1107
12,2204,10,100,0.0001,0.01,0.556,0.808076225045372,1045,1159
12,2304,10,100,0.0001,0.01,0.584,0.8541666666666666,1083,1221
12,2404,10,100,0.0001,0.01,0.588,0.8643926788685524,1141,1263
12,2504,10,100,0.0001,0.01,0.594,0.8514376996805112,1186,1318
12,2604,10,100,0.0001,0.01,0.612,0.8183563748079877,1234,1370
12,2704,10,100,0.0001,0.01,0.614,0.8391272189349113,1279,1425
12,2804,10,100,0.0001,0.01,0.652,0.8758915834522111,1332,1472
12,2904,10,100,0.0001,0.01,0.674,0.90633608815427,1389,1515
12,3004,10,100,0.0001,0.01,0.666,0.9107856191744341,1437,1567
12,3104,10,100,0.0001,0.01,0.694,0.8521262886597938,1491,1613
12,3204,10,100,0.0001,0.01,0.7,0.9147940074906367,1547,1657
12,3304,10,100,0.0001,0.01,0.754,0.9337167070217918,1590,1714
12,3404,10,100,0.0001,0.01,0.75,0.949177438307873,1628,1776
12,3504,10,100,0.0001,0.01,0.75,0.9432077625570776,1678,1826
12,3604,10,100,0.0001,0.01,0.728,0.9253607103218646,1723,1881
12,3704,10,100,0.0001,0.01,0.738,0.9187365010799136,1777,1927
12,3804,10,100,0.0001,0.01,0.766,0.9271819137749737,1824,1980
12,3904,10,100,0.0001,0.01,0.796,0.9467213114754098,1875,2029
12,4004,10,100,0.0001,0.01,0.812,0.957042957042957,1931,2073
12,4104,10,100,0.0001,0.01,0.822,0.9615009746588694,1975,2129
12,4204,10,100,0.0001,0.01,0.83,0.9650333016175071,2035,2169
12,4304,10,100,0.0001,0.01,0.838,0.9686338289962825,2087,2217
12,4404,10,100,0.0001,0.01,0.86,0.9727520435967303,2138,2266
12,4504,10,100,0.0001,0.01,0.882,0.9875666074600356,2192,2312
12,4604,10,100,0.0001,0.01,0.894,0.9821894005212859,2240,2364
12,4704,10,100,0.0001,0.01,0.89,0.9846938775510204,2280,2424
12,4804,10,100,0.0001,0.01,0.908,0.973563696919234,2325,2479
12,4904,10,100,0.0001,0.01,0.902,0.9714518760195758,2381,2523
12,5004,10,100,0.0001,0.01,0.93,0.9848121502797762,2429,2575
12,5104,10,100,0.0001,0.01,0.934,0.9894200626959248,2478,2626
12,5204,10,100,0.0001,0.01,0.922,0.990392006149116,2533,2671
12,5304,10,100,0.0001,0.01,0.942,0.9947209653092006,2581,2723
12,5404,10,100,0.0001,0.01,0.928,0.9920429311621022,2635,2769
12,5504,10,100,0.0001,0.01,0.944,0.9952761627906976,2686,2818
12,5604,10,100,0.0001,0.01,0.942,0.9966095645967167,2731,2873
12,5704,10,100,0.0001,0.01,0.946,0.9947405329593267,2784,2920
12,5804,10,100,0.0001,0.01,0.954,0.9932804962095106,2831,2973
12,5904,10,100,0.0001,0.01,0.912,0.9706978319783198,2869,3035
12,6004,10,100,0.0001,0.01,0.938,0.9866755496335776,2922,3082
12,6104,10,100,0.0001,0.01,0.946,0.9859108781127129,2970,3134
12,6204,10,100,0.0001,0.01,0.944,0.9859767891682786,3013,3191
12,6304,10,100,0.0001,0.01,0.958,0.9946065989847716,3071,3233
12,6404,10,100,0.0001,0.01,0.942,0.995159275452842,3117,3287
12,6504,10,100,0.0001,0.01,0.94,0.9969249692496925,3167,3337
12,6604,10,100,0.0001,0.01,0.952,0.9980314960629921,3214,3390
12,6704,10,100,0.0001,0.01,0.954,0.9964200477326969,3263,3441
12,6804,10,100,0.0001,0.01,0.96,0.9964726631393298,3313,3491
12,6904,10,100,0.0001,0.01,0.96,0.9953650057937428,3370,3534
12,7004,10,100,0.0001,0.01,0.954,0.9910051399200457,3419,3585
12,7104,10,100,0.0001,0.01,0.95,0.9894425675675675,3472,3632
12,7204,10,100,0.0001,0.01,0.952,0.9870905052748473,3531,3673
12,7304,10,100,0.0001,0.01,0.962,0.9917853231106243,3587,3717
12,7404,10,100,0.0001,0.01,0.952,0.9808211777417613,3639,3765
12,7504,10,100,0.0001,0.01,0.956,0.9918710021321961,3696,3808
12,7604,10,100,0.0001,0.01,0.966,0.9903997895844292,3746,3858
12,7704,10,100,0.0001,0.01,0.966,0.9945482866043613,3790,3914
12,7804,10,100,0.0001,0.01,0.964,0.9947462839569452,3838,3966
12,7904,10,100,0.0001,0.01,0.966,0.9955718623481782,3888,4016
12,8004,10,100,0.0001,0.01,0.956,0.995752123938031,3933,4071
12,8104,10,100,0.0001,0.01,0.966,0.9934600197433366,3977,4127
12,8204,10,100,0.0001,0.01,0.958,0.9921989273525109,4033,4171
12,8304,10,100,0.0001,0.01,0.974,0.9942196531791907,4093,4211
12,8404,10,100,0.0001,0.01,0.962,0.992265587815326,4141,4263
12,8504,10,100,0.0001,0.01,0.978,0.9974129821260583,4192,4312
12,8604,10,100,0.0001,0.01,0.974,0.9961645746164575,4251,4353
12,8704,10,100,0.0001,0.01,0.976,0.9982766544117647,4300,4404
12,8804,10,100,0.0001,0.01,0.968,0.9964788732394366,4348,4456
12,8904,10,100,0.0001,0.01,0.974,0.9966307277628033,4394,4510
12,9004,10,100,0.0001,0.01,0.966,0.9896712572190137,4444,4560
12,9104,10,100,0.0001,0.01,0.97,0.9946177504393673,4497,4607
12,9204,10,100,0.0001,0.01,0.976,0.9927205562798783,4539,4665
12,9304,10,100,0.0001,0.01,0.98,0.992798796216681,4599,4705
12,9404,10,100,0.0001,0.01,0.966,0.9939387494683114,4648,4756
12,9504,10,100,0.0001,0.01,0.97,0.9962121212121212,4701,4803
12,9604,10,100,0.0001,0.01,0.976,0.9930237401082882,4753,4851
12,9704,10,100,0.0001,0.01,0.982,0.9965993404781534,4808,4896
12,9804,10,100,0.0001,0.01,0.982,0.9951040391676866,4863,4941
12,9904,10,100,0.0001,0.01,0.978,0.9962641357027464,4911,4993
12,10004,10,100,0.0001,0.01,0.978,0.9948020791683326,4958,5046
12,10104,10,100,0.0001,0.01,0.98,0.9942596991290578,5010,5094
12,10204,10,100,0.0001,0.01,0.98,0.9929439435515484,5068,5136
12,10304,10,100,0.0001,0.01,0.978,0.9940799689440993,5115,5189
12,10404,10,100,0.0001,0.01,0.98,0.9916378316032295,5163,5241
12,10504,10,100,0.0001,0.01,0.984,0.9952399086062452,5212,5292
12,10604,10,100,0.0001,0.01,0.984,0.9963221425877028,5261,5343
12,10704,10,100,0.0001,0.01,0.982,0.9972907324364724,5307,5397
12,10804,10,100,0.0001,0.01,0.974,0.9966679007774898,5356,5448
12,10904,10,100,0.0001,0.01,0.982,0.9948642699926632,5414,5490
12,11004,10,100,0.0001,0.01,0.976,0.9934569247546347,5474,5530
12,11104,10,100,0.0001,0.01,0.982,0.9951368876080692,5520,5584
12,11204,10,100,0.0001,0.01,0.984,0.9945555158871832,5559,5645
12,11304,10,100,0.0001,0.01,0.988,0.9949575371549894,5615,5689
12,11404,10,100,0.0001,0.01,0.98,0.9921957207997194,5673,5731
12,11504,10,100,0.0001,0.01,0.984,0.9964360222531293,5725,5779
12,11604,10,100,0.0001,0.01,0.984,0.9975008617718029,5773,5831
12,11704,10,100,0.0001,0.01,0.984,0.9948735475051265,5822,5882
12,11804,10,100,0.0001,0.01,0.982,0.9969501863774991,5873,5931
12,11904,10,100,0.0001,0.01,0.984,0.998067876344086,5917,5987
12,12004,10,100,0.0001,0.01,0.976,0.9900033322225925,5974,6030
12,12104,10,100,0.0001,0.01,0.966,0.9765366820885658,6022,6082
12,12204,10,100,0.0001,0.01,0.988,0.992133726647001,6070,6134
12,12304,10,100,0.0001,0.01,0.988,0.9935793237971391,6121,6183
12,12404,10,100,0.0001,0.01,0.986,0.9951628506933248,6169,6235
12,12504,10,100,0.0001,0.01,0.988,0.9974408189379399,6221,6283
12,12604,10,100,0.0001,0.01,0.99,0.9969057442081879,6270,6334
12,12704,10,100,0.0001,0.01,0.988,0.9964578085642317,6320,6384
12,12804,10,100,0.0001,0.01,0.982,0.9946891596376133,6377,6427
12,12904,10,100,0.0001,0.01,0.988,0.995737755734656,6428,6476
12,13004,10,100,0.0001,0.01,0.99,0.9949246385727468,6482,6522
12,13104,10,100,0.0001,0.01,0.986,0.994429181929182,6537,6567
12,13204,10,100,0.0001,0.01,0.98,0.9946228415631627,6590,6614
12,13304,10,100,0.0001,0.01,0.984,0.992708959711365,6644,6660
12,13404,10,100,0.0001,0.01,0.98,0.9933601909877648,6693,6711
12,13504,10,100,0.0001,0.01,0.99,0.9964454976303317,6744,6760
12,13604,10,100,0.0001,0.01,0.988,0.997794766245222,6794,6810
12,13704,10,100,0.0001,0.01,0.982,0.9959136018680678,6837,6867
12,13804,10,100,0.0001,0.01,0.984,0.9968849608809041,6887,6917
12,13904,10,100,0.0001,0.01,0.982,0.9964039125431531,6935,6969
12,14004,10,100,0.0001,0.01,0.99,0.9963581833761782,6995,7009
12,14104,10,100,0.0001,0.01,0.978,0.9964549064095292,7047,7057
12,14204,10,100,0.0001,0.01,0.986,0.9956350323852436,7098,7106
12,14304,10,100,0.0001,0.01,0.984,0.9939876957494407,7149,7155
12,14404,10,100,0.0001,0.01,0.988,0.9979866703693419,7206,7198
12,14504,10,100,0.0001,0.01,0.986,0.9983452840595698,7261,7243
12,14604,10,100,0.0001,0.01,0.988,0.9984250890167078,7308,7296
12,14704,10,100,0.0001,0.01,0.988,0.9981637649619152,7356,7348
12,14804,10,100,0.0001,0.01,0.99,0.9981086192920832,7403,7401
12,14904,10,100,0.0001,0.01,0.982,0.9967122920021471,7455,7449
12,15004,10,100,0.0001,0.01,0.98,0.9882031458277792,7507,7497
13,104,10,100,0.0001,0.01,0.482,0.6634615384615384,47,57
13,204,10,100,0.0001,0.01,0.518,0.6225490196078431,103,101
13,304,10,100,0.0001,0.01,0.528,0.6217105263157895,157,147
13,404,10,100,0.0001,0.01,0.526,0.6881188118811881,208,196
13,504,10,100,0.0001,0.01,0.514,0.6765873015873016,260,244
13,604,10,100,0.0001,0.01,0.504,0.6738410596026491,311,293
13,704,10,100,0.0001,0.01,0.484,0.6519886363636364,355,349
13,804,10,100,0.0001,0.01,0.498,0.6703980099502488,408,396
13,904,10,100,0.0001,0.01,0.518,0.6637168141592921,452,452
13,1004,10,100,0.0001,0.01,0.488,0.6454183266932271,510,494
13,1104,10,100,0.0001,0.01,0.498,0.657608695652174,563,541
13,1204,10,100,0.0001,0.01,0.47,0.6893687707641196,615,589
13,1304,10,100,0.0001,0.01,0.51,0.6878834355828221,659,645
13,1404,10,100,0.0001,0.01,0.508,0.7222222222222222,702,702
13,1504,10,100,0.0001,0.01,0.514,0.738031914893617,747,757
13,1604,10,100,0.0001,0.01,0.55,0.7406483790523691,802,802
13,1704,10,100,0.0001,0.01,0.51,0.7470657276995305,850,854
13,1804,10,100,0.0001,0.01,0.53,0.7633037694013304,899,905
13,1904,10,100,0.0001,0.01,0.516,0.7489495798319328,952,952
13,2004,10,100,0.0001,0.01,0.544,0.812874251497006,1016,988
13,2104,10,100,0.0001,0.01,0.564,0.8013307984790875,1068,1036
13,2204,10,100,0.0001,0.01,0.576,0.8371143375680581,1112,1092
13,2304,10,100,0.0001,0.01,0.588,0.8485243055555556,1164,1140
13,2404,10,100,0.0001,0.01,0.642,0.8548252911813644,1219,1185
13,2504,10,100,0.0001,0.01,0.624,0.8115015974440895,1266,1238
13,2604,10,100,0.0001,0.01,0.64,0.8221966205837173,1313,1291
13,2704,10,100,0.0001,0.01,0.652,0.8332100591715976,1365,1339
13,2804,10,100,0.0001,0.01,0.678,0.8573466476462197,1417,1387
13,2904,10,100,0.0001,0.01,0.66,0.8526170798898072,1473,1431
13,3004,10,100,0.0001,0.01,0.688,0.8778295605858855,1529,1475
13,3104,10,100,0.0001,0.01,0.656,0.845360824742268,1584,1520
13,3204,10,100,0.0001,0.01,0.724,0.8748439450686641,1641,1563
13,3304,10,100,0.0001,0.01,0.738,0.8825665859564165,1695,1609
13,3404,10,100,0.0001,0.01,0.732,0.9056991774383079,1751,1653
13,3504,10,100,0.0001,0.01,0.756,0.9178082191780822,1805,1699
13,3604,10,100,0.0001,0.01,0.762,0.939511653718091,1856,1748
13,3704,10,100,0.0001,0.01,0.786,0.9392548596112311,1912,1792
13,3804,10,100,0.0001,0.01,0.774,0.935856992639327,1967,1837
13,3904,10,100,0.0001,0.01,0.814,0.9326331967213115,2014,1890
13,4004,10,100,0.0001,0.01,0.794,0.9468031968031968,2068,1936
13,4104,10,100,0.0001,0.01,0.802,0.9381091617933723,2111,1993
13,4204,10,100,0.0001,0.01,0.798,0.9400570884871551,2150,2054
13,4304,10,100,0.0001,0.01,0.79,0.908224907063197,2205,2099
13,4404,10,100,0.0001,0.01,0.842,0.9361943687556766,2256,2148
13,4504,10,100,0.0001,0.01,0.85,0.9609236234458259,2298,2206
13,4604,10,100,0.0001,0.01,0.848,0.9496090356211989,2338,2266
13,4704,10,100,0.0001,0.01,0.856,0.966624149659864,2389,2315
13,4804,10,100,0.0001,0.01,0.814,0.9296419650291424,2442,2362
13,4904,10,100,0.0001,0.01,0.866,0.9359706362153344,2489,2415
13,5004,10,100,0.0001,0.01,0.834,0.9222621902478018,2534,2470
13,5104,10,100,0.0001,0.01,0.83,0.905564263322884,2582,2522
13,5204,10,100,0.0001,0.01,0.84,0.9375480399692544,2629,2575
13,5304,10,100,0.0001,0.01,0.888,0.9570135746606335,2679,2625
13,5404,10,100,0.0001,0.01,0.894,0.9726128793486306,2722,2682
13,5504,10,100,0.0001,0.01,0.886,0.9678415697674418,2774,2730
13,5604,10,100,0.0001,0.01,0.88,0.9589578872234118,2827,2777
13,5704,10,100,0.0001,0.01,0.874,0.9500350631136045,2876,2828
13,5804,10,100,0.0001,0.01,0.88,0.9627842866988284,2925,2879
13,5904,10,100,0.0001,0.01,0.89,0.9532520325203252,2976,2928
13,6004,10,100,0.0001,0.01,0.89,0.9613590939373751,3033,2971
13,6104,10,100,0.0001,0.01,0.892,0.9487221494102228,3082,3022
13,6204,10,100,0.0001,0.01,0.906,0.9676015473887815,3133,3071
13,6304,10,100,0.0001,0.01,0.912,0.9814403553299492,3182,3122
13,6404,10,100,0.0001,0.01,0.908,0.980793254216115,3233,3171
13,6504,10,100,0.0001,0.01,0.908,0.9855473554735548,3287,3217
13,6604,10,100,0.0001,0.01,0.918,0.984251968503937,3344,3260
13,6704,10,100,0.0001,0.01,0.92,0.9870226730310262,3402,3302
13,6804,10,100,0.0001,0.01,0.926,0.9875073486184597,3454,3350
13,6904,10,100,0.0001,0.01,0.926,0.9891367323290846,3503,3401
13,7004,10,100,0.0001,0.01,0.914,0.9878640776699029,3555,3449
13,7104,10,100,0.0001,0.01,0.916,0.9855011261261262,3598,3506
13,7204,10,100,0.0001,0.01,0.9,0.9704330927262632,3644,3560
13,7304,10,100,0.0001,0.01,0.902,0.9585158817086528,3691,3613
13,7404,10,100,0.0001,0.01,0.922,0.9669097784981091,3743,3661
13,7504,10,100,0.0001,0.01,0.908,0.9717484008528785,3793,3711
13,7604,10,100,0.0001,0.01,0.91,0.9823776959495003,3840,3764
13,7704,10,100,0.0001,0.01,0.926,0.9910436137071651,3892,3812
13,7804,10,100,0.0001,0.01,0.916,0.9880830343413634,3948,3856
13,7904,10,100,0.0001,0.01,0.922,0.9849443319838057,3994,3910
13,8004,10,100,0.0001,0.01,0.92,0.9818840579710145,4038,3966
13,8104,10,100,0.0001,0.01,0.926,0.9737166831194471,4094,4010
13,8204,10,100,0.0001,0.01,0.926,0.9826913700633837,4138,4066
13,8304,10,100,0.0001,0.01,0.938,0.9902456647398844,4187,4117
13,8404,10,100,0.0001,0.01,0.924,0.9825083293669681,4240,4164
13,8504,10,100,0.0001,0.01,0.904,0.9710724365004704,4291,4213
13,8604,10,100,0.0001,0.01,0.922,0.9723384472338448,4337,4267
13,8704,10,100,0.0001,0.01,0.924,0.9865579044117647,4393,4311
13,8804,10,100,0.0001,0.01,0.882,0.9270786006360745,4447,4357
13,8904,10,100,0.0001,0.01,0.856,0.9040880503144654,4492,4412
13,9004,10,100,0.0001,0.01,0.894,0.9441359395824078,4534,4470
13,9104,10,100,0.0001,0.01,0.904,0.9544156414762741,4585,4519
13,9204,10,100,0.0001,0.01,0.858,0.8890699695784442,4627,4577
13,9304,10,100,0.0001,0.01,0.85,0.9114359415305245,4684,4620
13,9404,10,100,0.0001,0.01,0.922,0.9574649085495534,4726,4678
13,9504,10,100,0.0001,0.01,0.916,0.9710648148148148,4782,4722
13,9604,10,100,0.0001,0.01,0.94,0.9789670970428987,4823,4781
13,9704,10,100,0.0001,0.01,0.936,0.9826875515251443,4873,4831
13,9804,10,100,0.0001,0.01,0.93,0.9793961648306814,4925,4879
13,9904,10,100,0.0001,0.01,0.922,0.9799071082390953,4975,4929
13,10004,10,100,0.0001,0.01,0.94,0.9836065573770492,5031,4973
13,10104,10,100,0.0001,0.01,0.942,0.9857482185273159,5083,5021
13,10204,10,100,0.0001,0.01,0.944,0.9851038808310466,5125,5079
13,10304,10,100,0.0001,0.01,0.944,0.9868982919254659,5186,5118
13,10404,10,100,0.0001,0.01,0.93,0.9773164167627836,5238,5166
13,10504,10,100,0.0001,0.01,0.942,0.9863861386138614,5287,5217
13,10604,10,100,0.0001,0.01,0.946,0.984156921916258,5335,5269
13,10704,10,100,0.0001,0.01,0.944,0.9825298953662183,5384,5320
13,10804,10,100,0.0001,0.01,0.95,0.9862088115512773,5438,5366
13,10904,10,100,0.0001,0.01,0.952,0.9912876008804109,5491,5413
13,11004,10,100,0.0001,0.01,0.958,0.9922755361686659,5533,5471
13,11104,10,100,0.0001,0.01,0.948,0.9907240634005764,5569,5535
13,11204,10,100,0.0001,0.01,0.942,0.9886647625847912,5622,5582
13,11304,10,100,0.0001,0.01,0.942,0.9893842887473461,5676,5628
13,11404,10,100,0.0001,0.01,0.948,0.9935987372851631,5726,5678
13,11504,10,100,0.0001,0.01,0.948,0.9940020862308763,5767,5737
13,11604,10,100,0.0001,0.01,0.946,0.9903481558083419,5818,5786
13,11704,10,100,0.0001,0.01,0.942,0.987012987012987,5864,5840
13,11804,10,100,0.0001,0.01,0.946,0.9878007455099966,5919,5885
13,11904,10,100,0.0001,0.01,0.944,0.9903393817204301,5979,5925
13,12004,10,100,0.0001,0.01,0.948,0.9904198600466512,6029,5975
13,12104,10,100,0.0001,0.01,0.946,0.9918208856576338,6069,6035
13,12204,10,100,0.0001,0.01,0.938,0.9881186496230744,6117,6087
13,12304,10,100,0.0001,0.01,0.942,0.9923602080624188,6170,6134
13,12404,10,100,0.0001,0.01,0.956,0.9916156078684295,6218,6186
13,12504,10,100,0.0001,0.01,0.952,0.9912028150991683,6265,6239
13,12604,10,100,0.0001,0.01,0.95,0.9921453506823231,6313,6291
13,12704,10,100,0.0001,0.01,0.958,0.9900818639798489,6366,6338
13,12804,10,100,0.0001,0.01,0.954,0.9928928459856294,6417,6387
13,12904,10,100,0.0001,0.01,0.958,0.9871357718536887,6472,6432
13,13004,10,100,0.0001,0.01,0.948,0.9816210396800984,6525,6479
13,13104,10,100,0.0001,0.01,0.948,0.9818376068376068,6573,6531
13,13204,10,100,0.0001,0.01,0.956,0.9904574371402606,6623,6581
13,13304,10,100,0.0001,0.01,0.966,0.9939116055321707,6664,6640
13,13404,10,100,0.0001,0.01,0.962,0.9888093106535363,6715,6689
13,13504,10,100,0.0001,0.01,0.958,0.9927428909952607,6755,6749
13,13604,10,100,0.0001,0.01,0.968,0.9958100558659218,6806,6798
13,13704,10,100,0.0001,0.01,0.966,0.9920461179217747,6856,6848
13,13804,10,100,0.0001,0.01,0.966,0.9896406838597508,6903,6901
13,13904,10,100,0.0001,0.01,0.962,0.9901467203682394,6952,6952
13,14004,10,100,0.0001,0.01,0.968,0.9949300199942873,6995,7009
13,14104,10,100,0.0001,0.01,0.962,0.9943278502552467,7038,7066
13,14204,10,100,0.0001,0.01,0.966,0.9828217403548296,7084,7120
13,14304,10,100,0.0001,0.01,0.964,0.9866470917225951,7133,7171
13,14404,10,100,0.0001,0.01,0.972,0.9925020827547903,7192,7212
13,14504,10,100,0.0001,0.01,0.968,0.9967595146166575,7239,7265
13,14604,10,100,0.0001,0.01,0.964,0.9947274719254998,7293,7311
13,14704,10,100,0.0001,0.01,0.936,0.9790533188248096,7341,7363
13,14804,10,100,0.0001,0.01,0.956,0.9937854633882734,7393,7411
13,14904,10,100,0.0001,0.01,0.976,0.9938271604938271,7447,7457
13,15004,10,100,0.0001,0.01,0.958,0.9869368168488403,7492,7512
14,104,10,100,0.0001,0.01,0.508,0.7211538461538461,46,58
14,204,10,100,0.0001,0.01,0.53,0.5833333333333334,98,106
14,304,10,100,0.0001,0.01,0.462,0.6282894736842105,150,154
14,404,10,100,0.0001,0.01,0.498,0.650990099009901,197,207
14,504,10,100,0.0001,0.01,0.528,0.5853174603174603,249,255
14,604,10,100,0.0001,0.01,0.524,0.6059602649006622,301,303
14,704,10,100,0.0001,0.01,0.504,0.6377840909090909,350,354
14,804,10,100,0.0001,0.01,0.516,0.6305970149253731,401,403
14,904,10,100,0.0001,0.01,0.5,0.6559734513274337,443,461
14,1004,10,100,0.0001,0.01,0.496,0.6364541832669323,488,516
14,1104,10,100,0.0001,0.01,0.5,0.6512681159420289,545,559
14,1204,10,100,0.0001,0.01,0.476,0.6802325581395349,600,604
14,1304,10,100,0.0001,0.01,0.486,0.6526073619631901,656,648
14,1404,10,100,0.0001,0.01,0.512,0.688034188034188,704,700
14,1504,10,100,0.0001,0.01,0.484,0.6861702127659575,754,750
14,1604,10,100,0.0001,0.01,0.5,0.6539900249376559,802,802
14,1704,10,100,0.0001,0.01,0.482,0.687206572769953,856,848
14,1804,10,100,0.0001,0.01,0.492,0.6674057649667405,899,905
14,1904,10,100,0.0001,0.01,0.486,0.6607142857142857,952,952
14,2004,10,100,0.0001,0.01,0.512,0.7005988023952096,994,1010
14,2104,10,100,0.0001,0.01,0.49,0.6996197718631179,1041,1063
14,2204,10,100,0.0001,0.01,0.486,0.7159709618874773,1090,1114
14,2304,10,100,0.0001,0.01,0.506,0.7443576388888888,1133,1171
14,2404,10,100,0.0001,0.01,0.504,0.7408485856905158,1188,1216
14,2504,10,100,0.0001,0.01,0.51,0.6861022364217252,1235,1269
14,2604,10,100,0.0001,0.01,0.508,0.7200460829493087,1289,1315
14,2704,10,100,0.0001,0.01,0.5,0.7329881656804734,1333,1371
14,2804,10,100,0.0001,0.01,0.504,0.7582025677603423,1386,1418
14,2904,10,100,0.0001,0.01,0.5,0.7524104683195593,1432,1472
14,3004,10,100,0.0001,0.01,0.532,0.7433422103861518,1484,1520
14,3104,10,100,0.0001,0.01,0.526,0.7319587628865979,1537,1567
14,3204,10,100,0.0001,0.01,0.498,0.7578027465667915,1585,1619
14,3304,10,100,0.0001,0.01,0.5,0.7621065375302664,1635,1669
14,3404,10,100,0.0001,0.01,0.506,0.7831962397179788,1689,1715
14,3504,10,100,0.0001,0.01,0.51,0.781392694063927,1745,1759
14,3604,10,100,0.0001,0.01,0.502,0.7794117647058824,1802,1802
14,3704,10,100,0.0001,0.01,0.526,0.7653887688984882,1854,1850
14,3804,10,100,0.0001,0.01,0.524,0.8023133543638276,1908,1896
14,3904,10,100,0.0001,0.01,0.534,0.7930327868852459,1958,1946
14,4004,10,100,0.0001,0.01,0.552,0.8194305694305695,2002,2002
14,4104,10,100,0.0001,0.01,0.534,0.8126218323586745,2058,2046
14,4204,10,100,0.0001,0.01,0.532,0.7997145575642245,2107,2097
14,4304,10,100,0.0001,0.01,0.51,0.8022769516728625,2150,2154
14,4404,10,100,0.0001,0.01,0.534,0.7949591280653951,2197,2207
14,4504,10,100,0.0001,0.01,0.52,0.8112788632326821,2251,2253
14,4604,10,100,0.0001,0.01,0.544,0.8247176368375326,2295,2309
14,4704,10,100,0.0001,0.01,0.518,0.8069727891156463,2354,2350
14,4804,10,100,0.0001,0.01,0.506,0.8322231473771857,2405,2399
14,4904,10,100,0.0001,0.01,0.524,0.8276916802610114,2453,2451
14,5004,10,100,0.0001,0.01,0.52,0.8127498001598721,2498,2506
14,5104,10,100,0.0001,0.01,0.532,0.8320924764890282,2551,2553
14,5204,10,100,0.0001,0.01,0.546,0.8581860107609531,2607,2597
14,5304,10,100,0.0001,0.01,0.56,0.8580316742081447,2649,2655
14,5404,10,100,0.0001,0.01,0.55,0.8617690599555885,2699,2705
14,5504,10,100,0.0001,0.01,0.542,0.8484738372093024,2756,2748
14,5604,10,100,0.0001,0.01,0.546,0.8490364025695931,2804,2800
14,5704,10,100,0.0001,0.01,0.528,0.8487026647966339,2848,2856
14,5804,10,100,0.0001,0.01,0.536,0.8595796002756719,2897,2907
14,5904,10,100,0.0001,0.01,0.556,0.8733062330623306,2964,2940
14,6004,10,100,0.0001,0.01,0.552,0.8509327115256495,3014,2990
14,6104,10,100,0.0001,0.01,0.566,0.8248689384010485,3067,3037
14,6204,10,100,0.0001,0.01,0.564,0.8468729851708575,3121,3083
14,6304,10,100,0.0001,0.01,0.56,0.8374048223350253,3183,3121
14,6404,10,100,0.0001,0.01,0.572,0.858682073703935,3238,3166
14,6504,10,100,0.0001,0.01,0.556,0.856549815498155,3284,3220
14,6604,10,100,0.0001,0.01,0.56,0.8709872804360993,3328,3276
14,6704,10,100,0.0001,0.01,0.556,0.8730608591885441,3378,3326
14,6804,10,100,0.0001,0.01,0.582,0.8837448559670782,3419,3385
14,6904,10,100,0.0001,0.01,0.58,0.8829663962920047,3470,3434
14,7004,10,100,0.0001,0.01,0.588,0.8772130211307824,3519,3485
14,7104,10,100,0.0001,0.01,0.594,0.8703547297297297,3570,3534
14,7204,10,100,0.0001,0.01,0.572,0.8749305941143809,3615,3589
14,7304,10,100,0.0001,0.01,0.564,0.8781489594742606,3666,3638
14,7404,10,100,0.0001,0.01,0.58,0.8915451107509454,3723,3681
14,7504,10,100,0.0001,0.01,0.598,0.8746002132196162,3770,3734
14,7604,10,100,0.0001,0.01,0.588,0.9105733824302998,3823,3781
14,7704,10,100,0.0001,0.01,0.626,0.9169262720664589,3875,3829
14,7804,10,100,0.0001,0.01,0.608,0.9103024090210149,3925,3879
14,7904,10,100,0.0001,0.01,0.622,0.9109311740890689,3980,3924
14,8004,10,100,0.0001,0.01,0.598,0.9012993503248375,4029,3975
14,8104,10,100,0.0001,0.01,0.6,0.8708045409674235,4075,4029
14,8204,10,100,0.0001,0.01,0.618,0.8993174061433447,4120,4084
14,8304,10,100,0.0001,0.01,0.628,0.903179190751445,4172,4132
14,8404,10,100,0.0001,0.01,0.636,0.9133745835316516,4227,4177
14,8504,10,100,0.0001,0.01,0.648,0.9132173095014111,4267,4237
14,8604,10,100,0.0001,0.01,0.636,0.9127150162715016,4320,4284
14,8704,10,100,0.0001,0.01,0.636,0.9086626838235294,4375,4329
14,8804,10,100,0.0001,0.01,0.646,0.9070876874148115,4430,4374
14,8904,10,100,0.0001,0.01,0.64,0.9044249775381851,4476,4428
14,9004,10,100,0.0001,0.01,0.638,0.905264326965793,4525,4479
14,9104,10,100,0.0001,0.01,0.64,0.9076230228471002,4582,4522
14,9204,10,100,0.0001,0.01,0.644,0.9206866579747935,4626,4578
14,9304,10,100,0.0001,0.01,0.652,0.9218615649183147,4684,4620
14,9404,10,100,0.0001,0.01,0.65,0.9248192258613356,4738,4666
14,9504,10,100,0.0001,0.01,0.638,0.922979797979798,4780,4724
14,9604,10,100,0.0001,0.01,0.638,0.9274260724698042,4828,4776
14,9704,10,100,0.0001,0.01,0.652,0.9218878812860676,4871,4833
14,9804,10,100,0.0001,0.01,0.64,0.9356385148918809,4918,4886
14,9904,10,100,0.0001,0.01,0.656,0.9274030694668821,4958,4946
14,10004,10,100,0.0001,0.01,0.638,0.916233506597361,5015,4989
14,10104,10,100,0.0001,0.01,0.636,0.938341250989707,5066,5038
14,10204,10,100,0.0001,0.01,0.65,0.9413955311642493,5117,5087
14,10304,10,100,0.0001,0.01,0.652,0.9466226708074534,5169,5135
14,10404,10,100,0.0001,0.01,0.682,0.931276432141484,5222,5182
14,10504,10,100,0.0001,0.01,0.66,0.9262185833968012,5276,5228
14,10604,10,100,0.0001,0.01,0.68,0.9318181818181818,5324,5280
14,10704,10,100,0.0001,0.01,0.668,0.9099402092675636,5382,5322
14,10804,10,100,0.0001,0.01,0.666,0.9147537948907812,5422,5382
14,10904,10,100,0.0001,0.01,0.654,0.9290168745414527,5477,5427
14,11004,10,100,0.0001,0.01,0.674,0.9334787350054525,5521,5483
14,11104,10,100,0.0001,0.01,0.692,0.9259726224783862,5569,5535
14,11204,10,100,0.0001,0.01,0.676,0.9332381292395573,5614,5590
14,11304,10,100,0.0001,0.01,0.67,0.9301132342533617,5664,5640
14,11404,10,100,0.0001,0.01,0.67,0.9320413889863206,5708,5696
14,11504,10,100,0.0001,0.01,0.702,0.9401947148817803,5751,5753
14,11604,10,100,0.0001,0.01,0.708,0.9445018958979662,5804,5800
14,11704,10,100,0.0001,0.01,0.696,0.9493335611756665,5851,5853
14,11804,10,100,0.0001,0.01,0.698,0.931040325313453,5909,5895
14,11904,10,100,0.0001,0.01,0.704,0.9297715053763441,5953,5951
14,12004,10,100,0.0001,0.01,0.714,0.9295234921692769,6012,5992
14,12104,10,100,0.0001,0.01,0.7,0.9377891606080635,6068,6036
14,12204,10,100,0.0001,0.01,0.736,0.9501802687643396,6123,6081
14,12304,10,100,0.0001,0.01,0.732,0.9309980494148244,6172,6132
14,12404,10,100,0.0001,0.01,0.724,0.9393743953563367,6217,6187
14,12504,10,100,0.0001,0.01,0.724,0.9500159948816379,6263,6241
14,12604,10,100,0.0001,0.01,0.736,0.9458108536972389,6317,6287
14,12704,10,100,0.0001,0.01,0.712,0.9391530226700252,6374,6330
14,12804,10,100,0.0001,0.01,0.716,0.9353327085285849,6422,6382
14,12904,10,100,0.0001,0.01,0.734,0.9294017358958463,6468,6436
14,13004,10,100,0.0001,0.01,0.732,0.9367886804060289,6511,6493
14,13104,10,100,0.0001,0.01,0.724,0.9468101343101343,6561,6543
14,13204,10,100,0.0001,0.01,0.76,0.9534232050893668,6607,6597
14,13304,10,100,0.0001,0.01,0.75,0.95625375826819,6652,6652
14,13404,10,100,0.0001,0.01,0.76,0.9360638615338704,6704,6700
14,13504,10,100,0.0001,0.01,0.75,0.9379443127962085,6750,6754
14,13604,10,100,0.0001,0.01,0.758,0.955748309320788,6803,6801
14,13704,10,100,0.0001,0.01,0.76,0.950452422650321,6858,6846
14,13804,10,100,0.0001,0.01,0.73,0.9462474645030426,6908,6896
14,13904,10,100,0.0001,0.01,0.76,0.9505897583429229,6962,6942
14,14004,10,100,0.0001,0.01,0.75,0.9553698943159097,7010,6994
14,14104,10,100,0.0001,0.01,0.782,0.9549064095292116,7061,7043
14,14204,10,100,0.0001,0.01,0.792,0.9588144184736694,7110,7094
14,14304,10,100,0.0001,0.01,0.772,0.9307885906040269,7159,7145
14,14404,10,100,0.0001,0.01,0.824,0.9516106637045265,7213,7191
14,14504,10,100,0.0001,0.01,0.764,0.9471180364037507,7265,7239
14,14604,10,100,0.0001,0.01,0.754,0.9411120241029854,7308,7296
14,14704,10,100,0.0001,0.01,0.784,0.9637513601741022,7367,7337
14,14804,10,100,0.0001,0.01,0.802,0.9534585247230478,7420,7384
14,14904,10,100,0.0001,0.01,0.788,0.9616881374127751,7466,7438
14,15004,10,100,0.0001,0.01,0.8,0.9614769394828045,7516,7488
15,104,10,100,0.0001,0.01,0.508,0.5961538461538461,49,55
15,204,10,100,0.0001,0.01,0.498,0.5588235294117647,99,105
15,304,10,100,0.0001,0.01,0.464,0.5921052631578947,151,153
15,404,10,100,0.0001,0.01,0.506,0.5321782178217822,205,199
15,504,10,100,0.0001,0.01,0.51,0.5476190476190477,253,251
15,604,10,100,0.0001,0.01,0.472,0.5860927152317881,308,296
15,704,10,100,0.0001,0.01,0.496,0.5894886363636364,362,342
15,804,10,100,0.0001,0.01,0.5,0.6243781094527363,413,391
15,904,10,100,0.0001,0.01,0.494,0.6139380530973452,463,441
15,1004,10,100,0.0001,0.01,0.486,0.6065737051792829,509,495
15,1104,10,100,0.0001,0.01,0.508,0.6213768115942029,558,546
15,1204,10,100,0.0001,0.01,0.492,0.6387043189368771,607,597
15,1304,10,100,0.0001,0.01,0.498,0.6418711656441718,654,650
15,1404,10,100,0.0001,0.01,0.51,0.6566951566951567,710,694
15,1504,10,100,0.0001,0.01,0.49,0.6582446808510638,756,748
15,1604,10,100,0.0001,0.01,0.512,0.6795511221945137,809,795
15,1704,10,100,0.0001,0.01,0.5,0.6748826291079812,875,829
15,1804,10,100,0.0001,0.01,0.512,0.6607538802660754,926,878
15,1904,10,100,0.0001,0.01,0.482,0.6612394957983193,977,927
15,2004,10,100,0.0001,0.01,0.508,0.689620758483034,1017,987
15,2104,10,100,0.0001,0.01,0.484,0.6734790874524715,1063,1041
15,2204,10,100,0.0001,0.01,0.484,0.6987295825771325,1109,1095
15,2304,10,100,0.0001,0.01,0.484,0.6879340277777778,1158,1146
15,2404,10,100,0.0001,0.01,0.508,0.7050748752079867,1210,1194
15,2504,10,100,0.0001,0.01,0.502,0.6717252396166135,1264,1240
15,2604,10,100,0.0001,0.01,0.48,0.7019969278033794,1319,1285
15,2704,10,100,0.0001,0.01,0.512,0.6945266272189349,1375,1329
15,2804,10,100,0.0001,0.01,0.504,0.7139800285306704,1429,1375
15,2904,10,100,0.0001,0.01,0.478,0.6759641873278237,1468,1436
15,3004,10,100,0.0001,0.01,0.514,0.7093874833555259,1524,1480
15,3104,10,100,0.0001,0.01,0.52,0.7174613402061856,1578,1526
15,3204,10,100,0.0001,0.01,0.51,0.7290886392009988,1630,1574
15,3304,10,100,0.0001,0.01,0.502,0.7294188861985472,1680,1624
15,3404,10,100,0.0001,0.01,0.536,0.7482373678025852,1729,1675
15,3504,10,100,0.0001,0.01,0.508,0.7294520547945206,1784,1720
15,3604,10,100,0.0001,0.01,0.528,0.7333518312985572,1829,1775
15,3704,10,100,0.0001,0.01,0.512,0.7424406047516199,1885,1819
15,3804,10,100,0.0001,0.01,0.516,0.7310725552050473,1938,1866
15,3904,10,100,0.0001,0.01,0.494,0.7456454918032787,1984,1920
15,4004,10,100,0.0001,0.01,0.518,0.7714785214785215,2036,1968
15,4104,10,100,0.0001,0.01,0.53,0.7897173489278753,2088,2016
15,4204,10,100,0.0001,0.01,0.52,0.7959086584205518,2144,2060
15,4304,10,100,0.0001,0.01,0.498,0.7795074349442379,2198,2106
15,4404,10,100,0.0001,0.01,0.526,0.7879200726612171,2254,2150
15,4504,10,100,0.0001,0.01,0.524,0.8012877442273535,2296,2208
15,4604,10,100,0.0001,0.01,0.524,0.7934404865334492,2338,2266
15,4704,10,100,0.0001,0.01,0.528,0.7846513605442177,2388,2316
15,4804,10,100,0.0001,0.01,0.526,0.8082847626977518,2441,2363
15,4904,10,100,0.0001,0.01,0.524,0.8099510603588908,2493,2411
15,5004,10,100,0.0001,0.01,0.508,0.8261390887290168,2537,2467
15,5104,10,100,0.0001,0.01,0.508,0.8360109717868338,2589,2515
15,5204,10,100,0.0001,0.01,0.53,0.8418524212144505,2636,2568
15,5304,10,100,0.0001,0.01,0.532,0.8092006033182504,2696,2608
15,5404,10,100,0.0001,0.01,0.522,0.8297557364914878,2742,2662
15,5504,10,100,0.0001,0.01,0.522,0.8212209302325582,2785,2719
15,5604,10,100,0.0001,0.01,0.528,0.8420770877944326,2823,2781
15,5704,10,100,0.0001,0.01,0.52,0.8460729312762973,2867,2837
15,5804,10,100,0.0001,0.01,0.518,0.853893866299104,2919,2885
15,5904,10,100,0.0001,0.01,0.484,0.8313008130081301,2970,2934
15,6004,10,100,0.0001,0.01,0.522,0.850599600266489,3022,2982
15,6104,10,100,0.0001,0.01,0.488,0.815694626474443,3067,3037
15,6204,10,100,0.0001,0.01,0.508,0.8384912959381045,3124,3080
15,6304,10,100,0.0001,0.01,0.496,0.8202728426395939,3181,3123
15,6404,10,100,0.0001,0.01,0.498,0.8371330418488445,3236,3168
15,6504,10,100,0.0001,0.01,0.5,0.8497847478474785,3290,3214
15,6604,10,100,0.0001,0.01,0.518,0.854633555420957,3333,3271
15,6704,10,100,0.0001,0.01,0.528,0.8535202863961814,3380,3324
15,6804,10,100,0.0001,0.01,0.534,0.8606701940035273,3435,3369
15,6904,10,100,0.0001,0.01,0.534,0.8406720741599073,3492,3412
15,7004,10,100,0.0001,0.01,0.544,0.8659337521416334,3543,3461
15,7104,10,100,0.0001,0.01,0.548,0.879786036036036,3592,3512
15,7204,10,100,0.0001,0.01,0.556,0.8808995002776235,3647,3557
15,7304,10,100,0.0001,0.01,0.54,0.882803943044907,3696,3608
15,7404,10,100,0.0001,0.01,0.562,0.8881685575364667,3747,3657
15,7504,10,100,0.0001,0.01,0.56,0.8746002132196162,3792,3712
15,7604,10,100,0.0001,0.01,0.576,0.8653340347185692,3841,3763
15,7704,10,100,0.0001,0.01,0.582,0.8646157840083074,3891,3813
15,7804,10,100,0.0001,0.01,0.598,0.8732701178882625,3938,3866
15,7904,10,100,0.0001,0.01,0.576,0.8170546558704453,3993,3911
15,8004,10,100,0.0001,0.01,0.598,0.842703648175912,4049,3955
15,8104,10,100,0.0001,0.01,0.592,0.8489634748272458,4095,4009
15,8204,10,100,0.0001,0.01,0.602,0.856167723061921,4143,4061
15,8304,10,100,0.0001,0.01,0.622,0.8640414258188824,4195,4109
15,8404,10,100,0.0001,0.01,0.604,0.8639933365064255,4246,4158
15,8504,10,100,0.0001,0.01,0.638,0.856420507996237,4293,4211
15,8604,10,100,0.0001,0.01,0.634,0.8640167364016736,4340,4264
15,8704,10,100,0.0001,0.01,0.63,0.8629365808823529,4387,4317
15,8804,10,100,0.0001,0.01,0.644,0.8688096319854611,4434,4370
15,8904,10,100,0.0001,0.01,0.652,0.8807277628032345,4480,4424
15,9004,10,100,0.0001,0.01,0.662,0.8833851621501555,4527,4477
15,9104,10,100,0.0001,0.01,0.656,0.8863137082601055,4577,4527
15,9204,10,100,0.0001,0.01,0.644,0.8770099956540635,4626,4578
15,9304,10,100,0.0001,0.01,0.65,0.8861779879621668,4678,4626
15,9404,10,100,0.0001,0.01,0.668,0.8782433007230965,4727,4677
15,9504,10,100,0.0001,0.01,0.658,0.8811026936026936,4769,4735
15,9604,10,100,0.0001,0.01,0.66,0.8806747188671387,4826,4778
15,9704,10,100,0.0001,0.01,0.66,0.8819043693322342,4875,4829
15,9804,10,100,0.0001,0.01,0.708,0.8800489596083231,4922,4882
15,9904,10,100,0.0001,0.01,0.658,0.8556138933764136,4970,4934
15,10004,10,100,0.0001,0.01,0.658,0.8722510995601759,5020,4984
15,10104,10,100,0.0001,0.01,0.662,0.8728226444972288,5068,5036
15,10204,10,100,0.0001,0.01,0.67,0.8831830654645237,5121,5083
15,10304,10,100,0.0001,0.01,0.672,0.8873253105590062,5171,5133
15,10404,10,100,0.0001,0.01,0.686,0.8851403306420608,5225,5179
15,10504,10,100,0.0001,0.01,0.676,0.8765232292460016,5268,5236
15,10604,10,100,0.0001,0.01,0.676,0.8748585439456809,5318,5286
15,10704,10,100,0.0001,0.01,0.668,0.8821001494768311,5364,5340
15,10804,10,100,0.0001,0.01,0.68,0.8814328026656794,5415,5389
15,10904,10,100,0.0001,0.01,0.682,0.8897652237710931,5462,5442
15,11004,10,100,0.0001,0.01,0.692,0.8936750272628136,5521,5483
15,11104,10,100,0.0001,0.01,0.69,0.891750720461095,5569,5535
15,11204,10,100,0.0001,0.01,0.682,0.8929846483398786,5622,5582
15,11304,10,100,0.0001,0.01,0.7,0.8928697806086341,5671,5633
15,11404,10,100,0.0001,0.01,0.674,0.8796036478428622,5720,5684
15,11504,10,100,0.0001,0.01,0.652,0.8680458970792768,5767,5737
15,11604,10,100,0.0001,0.01,0.686,0.8826266804550155,5813,5791
15,11704,10,100,0.0001,0.01,0.672,0.8874743677375256,5864,5840
15,11804,10,100,0.0001,0.01,0.686,0.8908844459505253,5920,5884
15,11904,10,100,0.0001,0.01,0.684,0.8865087365591398,5973,5931
15,12004,10,100,0.0001,0.01,0.694,0.8887037654115295,6031,5973
15,12104,10,100,0.0001,0.01,0.702,0.8866490416391276,6078,6026
15,12204,10,100,0.0001,0.01,0.69,0.8951982956407735,6122,6082
15,12304,10,100,0.0001,0.01,0.702,0.8907672301690507,6169,6135
15,12404,10,100,0.0001,0.01,0.672,0.8791518864882296,6212,6192
15,12504,10,100,0.0001,0.01,0.722,0.8837172104926424,6259,6245
15,12604,10,100,0.0001,0.01,0.704,0.891621707394478,6314,6290
15,12704,10,100,0.0001,0.01,0.714,0.8943639798488665,6362,6342
15,12804,10,100,0.0001,0.01,0.708,0.8843330209309591,6412,6392
15,12904,10,100,0.0001,0.01,0.72,0.8586484810911346,6462,6442
15,13004,10,100,0.0001,0.01,0.736,0.8544294063365119,6512,6492
15,13104,10,100,0.0001,0.01,0.738,0.8634004884004884,6567,6537
15,13204,10,100,0.0001,0.01,0.726,0.8755680096940321,6617,6587
15,13304,10,100,0.0001,0.01,0.732,0.8791340950090198,6667,6637
15,13404,10,100,0.0001,0.01,0.74,0.8797373918233363,6717,6687
15,13504,10,100,0.0001,0.01,0.734,0.8878110189573459,6762,6742
15,13604,10,100,0.0001,0.01,0.744,0.8890032343428403,6803,6801
15,13704,10,100,0.0001,0.01,0.738,0.8869673088149446,6840,6864
15,13804,10,100,0.0001,0.01,0.738,0.884164010431759,6888,6916
15,13904,10,100,0.0001,0.01,0.758,0.8883055235903338,6942,6962
15,14004,10,100,0.0001,0.01,0.744,0.884318766066838,7001,7003
15,14104,10,100,0.0001,0.01,0.734,0.8740782756664776,7052,7052
15,14204,10,100,0.0001,0.01,0.738,0.8805266122219093,7108,7096
15,14304,10,100,0.0001,0.01,0.748,0.8870945190156599,7156,7148
15,14404,10,100,0.0001,0.01,0.768,0.8873923910024993,7207,7197
15,14504,10,100,0.0001,0.01,0.772,0.8794815223386652,7258,7246
15,14604,10,100,0.0001,0.01,0.764,0.8860586140783347,7303,7301
15,14704,10,100,0.0001,0.01,0.758,0.885677366702938,7351,7353
15,14804,10,100,0.0001,0.01,0.756,0.8857741151040259,7407,7397
15,14904,10,100,0.0001,0.01,0.748,0.8891572732152442,7456,7448
15,15004,10,100,0.0001,0.01,0.75,0.8873633697680618,7504,7500
16,104,10,100,0.0001,0.01,0.492,0.5961538461538461,50,54
16,204,10,100,0.0001,0.01,0.534,0.5098039215686274,100,104
16,304,10,100,0.0001,0.01,0.516,0.631578947368421,148,156
16,404,10,100,0.0001,0.01,0.472,0.5321782178217822,194,210
16,504,10,100,0.0001,0.01,0.508,0.6309523809523809,247,257
16,604,10,100,0.0001,0.01,0.526,0.6192052980132451,300,304
16,704,10,100,0.0001,0.01,0.536,0.6150568181818182,353,351
16,804,10,100,0.0001,0.01,0.518,0.5932835820895522,401,403
16,904,10,100,0.0001,0.01,0.488,0.6272123893805309,456,448
16,1004,10,100,0.0001,0.01,0.536,0.6364541832669323,508,496
16,1104,10,100,0.0001,0.01,0.536,0.6367753623188406,545,559
16,1204,10,100,0.0001,0.01,0.49,0.6362126245847176,592,612
16,1304,10,100,0.0001,0.01,0.52,0.6280674846625767,641,663
16,1404,10,100,0.0001,0.01,0.516,0.6467236467236467,693,711
16,1504,10,100,0.0001,0.01,0.522,0.660904255319149,740,764
16,1604,10,100,0.0001,0.01,0.506,0.6708229426433915,794,810
16,1704,10,100,0.0001,0.01,0.554,0.6725352112676056,840,864
16,1804,10,100,0.0001,0.01,0.52,0.6757206208425721,890,914
16,1904,10,100,0.0001,0.01,0.528,0.6680672268907563,938,966
16,2004,10,100,0.0001,0.01,0.528,0.6996007984031936,986,1018
16,2104,10,100,0.0001,0.01,0.516,0.6877376425855514,1032,1072
16,2204,10,100,0.0001,0.01,0.55,0.7037205081669692,1081,1123
16,2304,10,100,0.0001,0.01,0.548,0.6927083333333334,1135,1169
16,2404,10,100,0.0001,0.01,0.544,0.7059068219633944,1189,1215
16,2504,10,100,0.0001,0.01,0.54,0.6888977635782748,1241,1263
16,2604,10,100,0.0001,0.01,0.538,0.7188940092165899,1294,1310
16,2704,10,100,0.0001,0.01,0.522,0.7119082840236687,1350,1354
16,2804,10,100,0.0001,0.01,0.51,0.7300285306704708,1396,1408
16,2904,10,100,0.0001,0.01,0.522,0.7234848484848485,1443,1461
16,3004,10,100,0.0001,0.01,0.522,0.7423435419440746,1494,1510
16,3104,10,100,0.0001,0.01,0.526,0.7545103092783505,1543,1561
16,3204,10,100,0.0001,0.01,0.554,0.7406367041198502,1597,1607
16,3304,10,100,0.0001,0.01,0.496,0.7188256658595642,1646,1658
16,3404,10,100,0.0001,0.01,0.52,0.7223854289071681,1694,1710
16,3504,10,100,0.0001,0.01,0.514,0.7223173515981736,1739,1765
16,3604,10,100,0.0001,0.01,0.52,0.7494450610432852,1791,1813
16,3704,10,100,0.0001,0.01,0.552,0.7529697624190065,1843,1861
16,3804,10,100,0.0001,0.01,0.522,0.7741850683491062,1897,1907
16,3904,10,100,0.0001,0.01,0.542,0.7589651639344263,1951,1953
16,4004,10,100,0.0001,0.01,0.562,0.7682317682317682,1999,2005
16,4104,10,100,0.0001,0.01,0.51,0.74317738791423,2044,2060
16,4204,10,100,0.0001,0.01,0.518,0.7502378686964796,2095,2109
16,4304,10,100,0.0001,0.01,0.536,0.7597583643122676,2146,2158
16,4404,10,100,0.0001,0.01,0.536,0.7688465031789282,2200,2204
16,4504,10,100,0.0001,0.01,0.556,0.7868561278863233,2247,2257
16,4604,10,100,0.0001,0.01,0.55,0.8003909643788011,2305,2299
16,4704,10,100,0.0001,0.01,0.54,0.810374149659864,2365,2339
16,4804,10,100,0.0001,0.01,0.538,0.802248126561199,2422,2382
16,4904,10,100,0.0001,0.01,0.562,0.816068515497553,2472,2432
16,5004,10,100,0.0001,0.01,0.57,0.8165467625899281,2530,2474
16,5104,10,100,0.0001,0.01,0.572,0.8275862068965517,2578,2526
16,5204,10,100,0.0001,0.01,0.582,0.8191775557263643,2623,2581
16,5304,10,100,0.0001,0.01,0.574,0.7880844645550528,2666,2638
16,5404,10,100,0.0001,0.01,0.548,0.7964470762398224,2721,2683
16,5504,10,100,0.0001,0.01,0.56,0.8055959302325582,2769,2735
16,5604,10,100,0.0001,0.01,0.59,0.8253033547466095,2814,2790
16,5704,10,100,0.0001,0.01,0.594,0.8278401122019635,2863,2841
16,5804,10,100,0.0001,0.01,0.604,0.8373535492763611,2909,2895
16,5904,10,100,0.0001,0.01,0.61,0.842140921409214,2963,2941
16,6004,10,100,0.0001,0.01,0.642,0.8379413724183877,3017,2987
16,6104,10,100,0.0001,0.01,0.6,0.8396133682830931,3063,3041
16,6204,10,100,0.0001,0.01,0.634,0.8452611218568665,3119,3085
16,6304,10,100,0.0001,0.01,0.614,0.8565989847715736,3176,3128
16,6404,10,100,0.0001,0.01,0.642,0.8583697688944409,3233,3171
16,6504,10,100,0.0001,0.01,0.634,0.859009840098401,3282,3222
16,6604,10,100,0.0001,0.01,0.626,0.8588734100545125,3333,3271
16,6704,10,100,0.0001,0.01,0.642,0.8581443914081146,3383,3321
16,6804,10,100,0.0001,0.01,0.63,0.8669900058788947,3434,3370
16,6904,10,100,0.0001,0.01,0.658,0.8752896871378911,3486,3418
16,7004,10,100,0.0001,0.01,0.658,0.8742147344374643,3544,3460
16,7104,10,100,0.0001,0.01,0.642,0.857545045045045,3597,3507
16,7204,10,100,0.0001,0.01,0.648,0.8736812881732371,3641,3563
16,7304,10,100,0.0001,0.01,0.618,0.8607612267250822,3698,3606
16,7404,10,100,0.0001,0.01,0.61,0.8725013506212858,3752,3652
16,7504,10,100,0.0001,0.01,0.632,0.8606076759061834,3816,3688
16,7604,10,100,0.0001,0.01,0.626,0.8778274592319831,3859,3745
16,7704,10,100,0.0001,0.01,0.658,0.8826583592938733,3915,3789
16,7804,10,100,0.0001,0.01,0.674,0.891465914915428,3955,3849
16,7904,10,100,0.0001,0.01,0.654,0.8706983805668016,4008,3896
16,8004,10,100,0.0001,0.01,0.652,0.8849325337331334,4058,3946
16,8104,10,100,0.0001,0.01,0.656,0.8884501480750246,4112,3992
16,8204,10,100,0.0001,0.01,0.652,0.8872501218917601,4164,4040
16,8304,10,100,0.0001,0.01,0.684,0.8886078998073218,4212,4092
16,8404,10,100,0.0001,0.01,0.662,0.8907663017610662,4253,4151
16,8504,10,100,0.0001,0.01,0.672,0.853480714957667,4300,4204
16,8604,10,100,0.0001,0.01,0.664,0.8830776383077639,4351,4253
16,8704,10,100,0.0001,0.01,0.67,0.90234375,4403,4301
16,8804,10,100,0.0001,0.01,0.7,0.8923216719672876,4456,4348
16,8904,10,100,0.0001,0.01,0.674,0.8871293800539084,4501,4403
16,9004,10,100,0.0001,0.01,0.656,0.8804975566414927,4540,4464
16,9104,10,100,0.0001,0.01,0.688,0.9023506151142355,4584,4520
16,9204,10,100,0.0001,0.01,0.71,0.8926553672316384,4637,4567
16,9304,10,100,0.0001,0.01,0.7,0.8881126397248496,4677,4627
16,9404,10,100,0.0001,0.01,0.706,0.8870693321990643,4717,4687
16,9504,10,100,0.0001,0.01,0.732,0.8802609427609428,4764,4740
16,9604,10,100,0.0001,0.01,0.726,0.8916076634735527,4811,4793
16,9704,10,100,0.0001,0.01,0.752,0.8996290189612531,4864,4840
16,9804,10,100,0.0001,0.01,0.716,0.9032027743778049,4916,4888
16,9904,10,100,0.0001,0.01,0.74,0.8922657512116317,4965,4939
16,10004,10,100,0.0001,0.01,0.696,0.9002399040383846,5011,4993
16,10104,10,100,0.0001,0.01,0.698,0.8959817893903405,5060,5044
16,10204,10,100,0.0001,0.01,0.72,0.9130733045864367,5102,5102
16,10304,10,100,0.0001,0.01,0.74,0.906638198757764,5156,5148
16,10404,10,100,0.0001,0.01,0.736,0.9063821607074202,5215,5189
16,10504,10,100,0.0001,0.01,0.73,0.892041127189642,5257,5247
16,10604,10,100,0.0001,0.01,0.702,0.8931535269709544,5305,5299
16,10704,10,100,0.0001,0.01,0.672,0.8327727952167414,5346,5358
16,10804,10,100,0.0001,0.01,0.684,0.8654202147352832,5394,5410
16,10904,10,100,0.0001,0.01,0.708,0.8775678650036683,5447,5457
16,11004,10,100,0.0001,0.01,0.7,0.8879498364231189,5496,5508
16,11104,10,100,0.0001,0.01,0.726,0.8909402017291066,5549,5555
16,11204,10,100,0.0001,0.01,0.732,0.9040521242413424,5602,5602
16,11304,10,100,0.0001,0.01,0.732,0.9026008492569002,5652,5652
16,11404,10,100,0.0001,0.01,0.738,0.9128376008418099,5685,5719
16,11504,10,100,0.0001,0.01,0.774,0.9042072322670376,5736,5768
16,11604,10,100,0.0001,0.01,0.734,0.9197690451568424,5782,5822
16,11704,10,100,0.0001,0.01,0.742,0.9317327409432673,5821,5883
16,11804,10,100,0.0001,0.01,0.754,0.9134191799390037,5881,5923
16,11904,10,100,0.0001,0.01,0.754,0.9249831989247311,5935,5969
16,12004,10,100,0.0001,0.01,0.784,0.935021659446851,5983,6021
16,12104,10,100,0.0001,0.01,0.77,0.9258096497025776,6033,6071
16,12204,10,100,0.0001,0.01,0.736,0.8919206817436905,6081,6123
16,12304,10,100,0.0001,0.01,0.756,0.9055591677503251,6130,6174
16,12404,10,100,0.0001,0.01,0.77,0.9206707513705257,6179,6225
16,12504,10,100,0.0001,0.01,0.77,0.9374600127959053,6240,6264
16,12604,10,100,0.0001,0.01,0.796,0.9393843224373215,6282,6322
16,12704,10,100,0.0001,0.01,0.81,0.9434036523929471,6330,6374
16,12804,10,100,0.0001,0.01,0.786,0.932911590128085,6384,6420
16,12904,10,100,0.0001,0.01,0.8,0.9319590824550527,6434,6470
16,13004,10,100,0.0001,0.01,0.828,0.9419409412488465,6487,6517
16,13104,10,100,0.0001,0.01,0.808,0.9417735042735043,6533,6571
16,13204,10,100,0.0001,0.01,0.8,0.9416843380793699,6582,6622
16,13304,10,100,0.0001,0.01,0.81,0.9528713168971737,6642,6662
16,13404,10,100,0.0001,0.01,0.804,0.9369591166815876,6689,6715
16,13504,10,100,0.0001,0.01,0.814,0.9471267772511849,6743,6761
16,13604,10,100,0.0001,0.01,0.822,0.9407527197882976,6784,6820
16,13704,10,100,0.0001,0.01,0.814,0.9387040280210157,6839,6865
16,13804,10,100,0.0001,0.01,0.818,0.9279918864097363,6894,6910
16,13904,10,100,0.0001,0.01,0.838,0.9556962025316456,6945,6959
16,14004,10,100,0.0001,0.01,0.84,0.9520851185375607,6994,7010
16,14104,10,100,0.0001,0.01,0.838,0.9544809982983551,7042,7062
16,14204,10,100,0.0001,0.01,0.83,0.94128414531118,7088,7116
16,14304,10,100,0.0001,0.01,0.858,0.9530900447427293,7139,7165
16,14404,10,100,0.0001,0.01,0.846,0.9510552624271036,7185,7219
16,14504,10,100,0.0001,0.01,0.834,0.9481522338665196,7231,7273
16,14604,10,100,0.0001,0.01,0.84,0.9500136948781156,7279,7325
16,14704,10,100,0.0001,0.01,0.862,0.9655195865070729,7330,7374
16,14804,10,100,0.0001,0.01,0.838,0.9581869764928398,7389,7415
16,14904,10,100,0.0001,0.01,0.842,0.9502147074610843,7440,7464
16,15004,10,100,0.0001,0.01,0.852,0.9665422553985604,7488,7516
17,104,10,100,0.0001,0.01,0.542,0.47115384615384615,55,49
17,204,10,100,0.0001,0.01,0.486,0.6127450980392157,109,95
17,304,10,100,0.0001,0.01,0.462,0.6710526315789473,159,145
17,404,10,100,0.0001,0.01,0.438,0.6460396039603961,211,193
17,504,10,100,0.0001,0.01,0.464,0.6448412698412699,263,241
17,604,10,100,0.0001,0.01,0.492,0.6456953642384106,312,292
17,704,10,100,0.0001,0.01,0.472,0.6690340909090909,366,338
17,804,10,100,0.0001,0.01,0.466,0.6654228855721394,421,383
17,904,10,100,0.0001,0.01,0.492,0.6891592920353983,470,434
17,1004,10,100,0.0001,0.01,0.492,0.701195219123506,519,485
17,1104,10,100,0.0001,0.01,0.49,0.6847826086956522,574,530
17,1204,10,100,0.0001,0.01,0.522,0.7068106312292359,625,579
17,1304,10,100,0.0001,0.01,0.508,0.7177914110429447,672,632
17,1404,10,100,0.0001,0.01,0.514,0.7293447293447294,717,687
17,1504,10,100,0.0001,0.01,0.526,0.7014627659574468,767,737
17,1604,10,100,0.0001,0.01,0.492,0.7618453865336658,816,788
17,1704,10,100,0.0001,0.01,0.514,0.7376760563380281,871,833
17,1804,10,100,0.0001,0.01,0.524,0.6895787139689579,925,879
17,1904,10,100,0.0001,0.01,0.508,0.7352941176470589,973,931
17,2004,10,100,0.0001,0.01,0.468,0.7000998003992016,1027,977
17,2104,10,100,0.0001,0.01,0.5,0.779467680608365,1079,1025
17,2204,10,100,0.0001,0.01,0.502,0.7867513611615246,1127,1077
17,2304,10,100,0.0001,0.01,0.502,0.8003472222222222,1174,1130
17,2404,10,100,0.0001,0.01,0.484,0.7999168053244592,1223,1181
17,2504,10,100,0.0001,0.01,0.488,0.78314696485623,1275,1229
17,2604,10,100,0.0001,0.01,0.498,0.8056835637480799,1319,1285
17,2704,10,100,0.0001,0.01,0.468,0.8158284023668639,1371,1333
17,2804,10,100,0.0001,0.01,0.494,0.81169757489301,1417,1387
17,2904,10,100,0.0001,0.01,0.486,0.8143939393939394,1473,1431
17,3004,10,100,0.0001,0.01,0.502,0.8322237017310253,1525,1479
17,3104,10,100,0.0001,0.01,0.534,0.8302190721649485,1572,1532
17,3204,10,100,0.0001,0.01,0.546,0.8333333333333334,1621,1583
17,3304,10,100,0.0001,0.01,0.468,0.8005447941888619,1668,1636
17,3404,10,100,0.0001,0.01,0.542,0.8563454759106933,1722,1682
17,3504,10,100,0.0001,0.01,0.546,0.8524543378995434,1769,1735
17,3604,10,100,0.0001,0.01,0.536,0.8740288568257492,1822,1782
17,3704,10,100,0.0001,0.01,0.556,0.8776997840172787,1874,1830
17,3804,10,100,0.0001,0.01,0.56,0.8961619348054679,1918,1886
17,3904,10,100,0.0001,0.01,0.562,0.8844774590163934,1964,1940
17,4004,10,100,0.0001,0.01,0.562,0.9005994005994006,2011,1993
17,4104,10,100,0.0001,0.01,0.574,0.8991228070175439,2062,2042
17,4204,10,100,0.0001,0.01,0.57,0.9058039961941009,2106,2098
17,4304,10,100,0.0001,0.01,0.574,0.9091542750929368,2159,2145
17,4404,10,100,0.0001,0.01,0.586,0.8885104450499546,2206,2198
17,4504,10,100,0.0001,0.01,0.574,0.8043960923623446,2251,2253
17,4604,10,100,0.0001,0.01,0.588,0.8468722849695917,2292,2312
17,4704,10,100,0.0001,0.01,0.596,0.8877551020408163,2350,2354
17,4804,10,100,0.0001,0.01,0.602,0.8832223147377186,2393,2411
17,4904,10,100,0.0001,0.01,0.636,0.8803017944535073,2444,2460
17,5004,10,100,0.0001,0.01,0.626,0.9040767386091128,2493,2511
17,5104,10,100,0.0001,0.01,0.63,0.9026253918495298,2540,2564
17,5204,10,100,0.0001,0.01,0.61,0.8706764027671022,2594,2610
17,5304,10,100,0.0001,0.01,0.64,0.9021493212669683,2640,2664
17,5404,10,100,0.0001,0.01,0.652,0.903219837157661,2691,2713
17,5504,10,100,0.0001,0.01,0.638,0.9115188953488372,2740,2764
17,5604,10,100,0.0001,0.01,0.622,0.9263026409707352,2790,2814
17,5704,10,100,0.0001,0.01,0.61,0.9016479663394109,2837,2867
17,5804,10,100,0.0001,0.01,0.654,0.914197105444521,2892,2912
17,5904,10,100,0.0001,0.01,0.652,0.9056571815718157,2939,2965
17,6004,10,100,0.0001,0.01,0.682,0.9237175216522319,2993,3011
17,6104,10,100,0.0001,0.01,0.656,0.9233289646133683,3042,3062
17,6204,10,100,0.0001,0.01,0.688,0.9126370083816893,3091,3113
17,6304,10,100,0.0001,0.01,0.694,0.8599302030456852,3140,3164
17,6404,10,100,0.0001,0.01,0.672,0.8847595252966896,3190,3214
17,6504,10,100,0.0001,0.01,0.704,0.8866851168511685,3233,3271
17,6604,10,100,0.0001,0.01,0.722,0.9109630526953362,3285,3319
17,6704,10,100,0.0001,0.01,0.688,0.9285501193317423,3338,3366
17,6804,10,100,0.0001,0.01,0.698,0.9235743680188124,3389,3415
17,6904,10,100,0.0001,0.01,0.69,0.9132387022016223,3440,3464
17,7004,10,100,0.0001,0.01,0.712,0.9216162193032553,3480,3524
17,7104,10,100,0.0001,0.01,0.686,0.926661036036036,3534,3570
17,7204,10,100,0.0001,0.01,0.698,0.9346196557468073,3585,3619
17,7304,10,100,0.0001,0.01,0.678,0.9273001095290252,3634,3670
17,7404,10,100,0.0001,0.01,0.686,0.9411129119394922,3680,3724
17,7504,10,100,0.0001,0.01,0.684,0.9416311300639659,3737,3767
17,7604,10,100,0.0001,0.01,0.674,0.9358232509205682,3785,3819
17,7704,10,100,0.0001,0.01,0.694,0.9036863966770509,3844,3860
17,7804,10,100,0.0001,0.01,0.698,0.9222193746796514,3890,3914
17,7904,10,100,0.0001,0.01,0.714,0.916497975708502,3937,3967
17,8004,10,100,0.0001,0.01,0.702,0.9324087956021989,3979,4025
17,8104,10,100,0.0001,0.01,0.694,0.9362043435340572,4031,4073
17,8204,10,100,0.0001,0.01,0.708,0.9378352023403218,4083,4121
17,8304,10,100,0.0001,0.01,0.706,0.9334055876685935,4138,4166
17,8404,10,100,0.0001,0.01,0.716,0.9407425035697287,4181,4223
17,8504,10,100,0.0001,0.01,0.726,0.9419096895578551,4244,4260
17,8604,10,100,0.0001,0.01,0.72,0.9292189679218968,4298,4306
17,8704,10,100,0.0001,0.01,0.692,0.8882123161764706,4350,4354
17,8804,10,100,0.0001,0.01,0.724,0.912994093593821,4390,4414
17,8904,10,100,0.0001,0.01,0.722,0.8931940700808625,4445,4459
17,9004,10,100,0.0001,0.01,0.734,0.9140382052421147,4502,4502
17,9104,10,100,0.0001,0.01,0.72,0.8891695957820738,4546,4558
17,9204,10,100,0.0001,0.01,0.726,0.9104737070838765,4600,4604
17,9304,10,100,0.0001,0.01,0.718,0.9179922613929493,4655,4649
17,9404,10,100,0.0001,0.01,0.718,0.9273713313483624,4708,4696
17,9504,10,100,0.0001,0.01,0.726,0.9228745791245792,4757,4747
17,9604,10,100,0.0001,0.01,0.726,0.9177426072469804,4814,4790
17,9704,10,100,0.0001,0.01,0.722,0.9360057708161583,4862,4842
17,9804,10,100,0.0001,0.01,0.726,0.9391064871481029,4922,4882
17,9904,10,100,0.0001,0.01,0.726,0.9276050080775444,4970,4934
17,10004,10,100,0.0001,0.01,0.738,0.9363254698120752,5021,4983
17,10104,10,100,0.0001,0.01,0.754,0.9373515439429929,5073,5031
17,10204,10,100,0.0001,0.01,0.766,0.933359466875735,5119,5085
17,10304,10,100,0.0001,0.01,0.722,0.9074145962732919,5168,5136
17,10404,10,100,0.0001,0.01,0.736,0.9204152249134948,5220,5184
17,10504,10,100,0.0001,0.01,0.726,0.9272658035034272,5273,5231
17,10604,10,100,0.0001,0.01,0.734,0.9461523953225198,5321,5283
17,10704,10,100,0.0001,0.01,0.756,0.9492713004484304,5378,5326
17,10804,10,100,0.0001,0.01,0.756,0.9475194372454646,5429,5375
17,10904,10,100,0.0001,0.01,0.782,0.9519442406456347,5481,5423
17,11004,10,100,0.0001,0.01,0.778,0.9501090512540894,5536,5468
17,11104,10,100,0.0001,0.01,0.76,0.9483969740634006,5578,5526
17,11204,10,100,0.0001,0.01,0.758,0.94109246697608,5626,5578
17,11304,10,100,0.0001,0.01,0.756,0.9500176928520877,5673,5631
17,11404,10,100,0.0001,0.01,0.75,0.9323044545773412,5714,5690
17,11504,10,100,0.0001,0.01,0.768,0.93115438108484,5765,5739
17,11604,10,100,0.0001,0.01,0.762,0.93717683557394,5817,5787
17,11704,10,100,0.0001,0.01,0.74,0.9384825700615175,5864,5840
17,11804,10,100,0.0001,0.01,0.778,0.9487461877329719,5907,5897
17,11904,10,100,0.0001,0.01,0.76,0.9396841397849462,5961,5943
17,12004,10,100,0.0001,0.01,0.792,0.9499333555481506,6011,5993
17,12104,10,100,0.0001,0.01,0.788,0.9510905485789821,6062,6042
17,12204,10,100,0.0001,0.01,0.762,0.9493608652900688,6122,6082
17,12304,10,100,0.0001,0.01,0.802,0.9539986996098829,6166,6138
17,12404,10,100,0.0001,0.01,0.776,0.9475975491776846,6224,6180
17,12504,10,100,0.0001,0.01,0.76,0.9557741522712732,6276,6228
17,12604,10,100,0.0001,0.01,0.79,0.962710250714059,6323,6281
17,12704,10,100,0.0001,0.01,0.804,0.9597764483627204,6371,6333
17,12804,10,100,0.0001,0.01,0.744,0.9303342705404561,6423,6381
17,12904,10,100,0.0001,0.01,0.726,0.8691878487290763,6467,6437
17,13004,10,100,0.0001,0.01,0.746,0.9143340510612119,6525,6479
17,13104,10,100,0.0001,0.01,0.772,0.9260531135531136,6570,6534
17,13204,10,100,0.0001,0.01,0.762,0.9355498333838231,6624,6580
17,13304,10,100,0.0001,0.01,0.778,0.9271647624774504,6673,6631
17,13404,10,100,0.0001,0.01,0.792,0.9404655326768129,6726,6678
17,13504,10,100,0.0001,0.01,0.798,0.9501629146919431,6781,6723
17,13604,10,100,0.0001,0.01,0.78,0.9218612172890326,6824,6780
17,13704,10,100,0.0001,0.01,0.78,0.9168126094570929,6875,6829
17,13804,10,100,0.0001,0.01,0.794,0.9224137931034483,6910,6894
17,13904,10,100,0.0001,0.01,0.778,0.9423906789413119,6963,6941
17,14004,10,100,0.0001,0.01,0.818,0.9423736075407027,7014,6990
17,14104,10,100,0.0001,0.01,0.812,0.9488797504254113,7065,7039
17,14204,10,100,0.0001,0.01,0.82,0.9557166995212616,7123,7081
17,14304,10,100,0.0001,0.01,0.806,0.9475671140939598,7172,7132
17,14404,10,100,0.0001,0.01,0.808,0.9516106637045265,7219,7185
17,14504,10,100,0.0001,0.01,0.834,0.9579426365140651,7271,7233
17,14604,10,100,0.0001,0.01,0.84,0.9556285949055053,7318,7286
17,14704,10,100,0.0001,0.01,0.84,0.9630712731229597,7367,7337
17,14804,10,100,0.0001,0.01,0.798,0.9458930018913807,7425,7379
17,14904,10,100,0.0001,0.01,0.84,0.9509527643585615,7474,7430
17,15004,10,100,0.0001,0.01,0.842,0.9640762463343109,7523,7481
18,104,10,100,0.0001,0.01,0.518,0.6057692307692307,47,57
18,204,10,100,0.0001,0.01,0.498,0.5490196078431373,104,100
18,304,10,100,0.0001,0.01,0.492,0.6151315789473685,153,151
18,404,10,100,0.0001,0.01,0.51,0.551980198019802,201,203
18,504,10,100,0.0001,0.01,0.478,0.5773809523809523,252,252
18,604,10,100,0.0001,0.01,0.49,0.6506622516556292,303,301
18,704,10,100,0.0001,0.01,0.55,0.6306818181818182,352,352
18,804,10,100,0.0001,0.01,0.538,0.6616915422885572,398,406
18,904,10,100,0.0001,0.01,0.492,0.6084070796460177,445,459
18,1004,10,100,0.0001,0.01,0.49,0.6254980079681275,487,517
18,1104,10,100,0.0001,0.01,0.488,0.6259057971014492,548,556
18,1204,10,100,0.0001,0.01,0.516,0.6528239202657807,592,612
18,1304,10,100,0.0001,0.01,0.514,0.6549079754601227,639,665
18,1404,10,100,0.0001,0.01,0.528,0.6673789173789174,689,715
18,1504,10,100,0.0001,0.01,0.502,0.6449468085106383,746,758
18,1604,10,100,0.0001,0.01,0.536,0.6864089775561097,806,798
18,1704,10,100,0.0001,0.01,0.542,0.6713615023474179,861,843
18,1804,10,100,0.0001,0.01,0.52,0.697339246119734,915,889
18,1904,10,100,0.0001,0.01,0.554,0.7043067226890757,961,943
18,2004,10,100,0.0001,0.01,0.538,0.718562874251497,1010,994
18,2104,10,100,0.0001,0.01,0.528,0.6924904942965779,1062,1042
18,2204,10,100,0.0001,0.01,0.538,0.707350272232305,1121,1083
18,2304,10,100,0.0001,0.01,0.53,0.7300347222222222,1171,1133
18,2404,10,100,0.0001,0.01,0.552,0.742928452579035,1224,1180
18,2504,10,100,0.0001,0.01,0.548,0.7432108626198083,1275,1229
18,2604,10,100,0.0001,0.01,0.552,0.7311827956989247,1325,1279
18,2704,10,100,0.0001,0.01,0.53,0.7056213017751479,1371,1333
18,2804,10,100,0.0001,0.01,0.544,0.723965763195435,1416,1388
18,2904,10,100,0.0001,0.01,0.542,0.7400137741046832,1469,1435
18,3004,10,100,0.0001,0.01,0.56,0.7486684420772304,1521,1483
18,3104,10,100,0.0001,0.01,0.558,0.739368556701031,1571,1533
18,3204,10,100,0.0001,0.01,0.582,0.7874531835205992,1619,1585
18,3304,10,100,0.0001,0.01,0.574,0.7596852300242131,1667,1637
18,3404,10,100,0.0001,0.01,0.572,0.7855464159811986,1725,1679
18,3504,10,100,0.0001,0.01,0.576,0.7659817351598174,1778,1726
18,3604,10,100,0.0001,0.01,0.55,0.7380688124306326,1833,1771
18,3704,10,100,0.0001,0.01,0.59,0.7686285097192225,1885,1819
18,3804,10,100,0.0001,0.01,0.612,0.7920609884332281,1939,1865
18,3904,10,100,0.0001,0.01,0.606,0.8050717213114754,1990,1914
18,4004,10,100,0.0001,0.01,0.574,0.8044455544455544,2035,1969
18,4104,10,100,0.0001,0.01,0.598,0.8184697855750487,2087,2017
18,4204,10,100,0.0001,0.01,0.592,0.8042340627973359,2137,2067
18,4304,10,100,0.0001,0.01,0.59,0.7493029739776952,2186,2118
18,4404,10,100,0.0001,0.01,0.59,0.7633969118982743,2239,2165
18,4504,10,100,0.0001,0.01,0.59,0.7955150976909414,2283,2221
18,4604,10,100,0.0001,0.01,0.588,0.7947437011294527,2334,2270
18,4704,10,100,0.0001,0.01,0.604,0.7899659863945578,2371,2333
18,4804,10,100,0.0001,0.01,0.628,0.8005828476269775,2416,2388
18,4904,10,100,0.0001,0.01,0.61,0.8350326264274062,2465,2439
18,5004,10,100,0.0001,0.01,0.628,0.820343725019984,2520,2484
18,5104,10,100,0.0001,0.01,0.618,0.8313087774294671,2563,2541
18,5204,10,100,0.0001,0.01,0.626,0.8257109915449654,2614,2590
18,5304,10,100,0.0001,0.01,0.612,0.8421945701357466,2665,2639
18,5404,10,100,0.0001,0.01,0.658,0.8510362694300518,2710,2694
18,5504,10,100,0.0001,0.01,0.604,0.8510174418604651,2759,2745
18,5604,10,100,0.0001,0.01,0.64,0.8572448251249107,2814,2790
18,5704,10,100,0.0001,0.01,0.638,0.8509817671809257,2859,2845
18,5804,10,100,0.0001,0.01,0.67,0.8476912474155754,2909,2895
18,5904,10,100,0.0001,0.01,0.672,0.8301151761517616,2954,2950
18,6004,10,100,0.0001,0.01,0.652,0.8542638241172552,3005,2999
18,6104,10,100,0.0001,0.01,0.642,0.8519003931847968,3057,3047
18,6204,10,100,0.0001,0.01,0.678,0.8486460348162476,3108,3096
18,6304,10,100,0.0001,0.01,0.662,0.845019035532995,3160,3144
18,6404,10,100,0.0001,0.01,0.678,0.8652404747033104,3213,3191
18,6504,10,100,0.0001,0.01,0.674,0.8582410824108241,3270,3234
18,6604,10,100,0.0001,0.01,0.67,0.8625075711689885,3323,3281
18,6704,10,100,0.0001,0.01,0.666,0.8429295942720764,3367,3337
18,6804,10,100,0.0001,0.01,0.672,0.8499412110523221,3412,3392
18,6904,10,100,0.0001,0.01,0.684,0.8547219003476245,3458,3446
18,7004,10,100,0.0001,0.01,0.686,0.8675042832667047,3512,3492
18,7104,10,100,0.0001,0.01,0.684,0.8710585585585585,3568,3536
18,7204,10,100,0.0001,0.01,0.682,0.8797890061077179,3618,3586
18,7304,10,100,0.0001,0.01,0.702,0.882803943044907,3659,3645
18,7404,10,100,0.0001,0.01,0.688,0.8758779038357645,3702,3702
18,7504,10,100,0.0001,0.01,0.694,0.8805970149253731,3753,3751
18,7604,10,100,0.0001,0.01,0.692,0.8755917937927407,3800,3804
18,7704,10,100,0.0001,0.01,0.718,0.8734423676012462,3845,3859
18,7804,10,100,0.0001,0.01,0.69,0.8771143003587903,3894,3910
18,7904,10,100,0.0001,0.01,0.682,0.8733552631578947,3946,3958
18,8004,10,100,0.0001,0.01,0.718,0.883808095952024,3992,4012
18,8104,10,100,0.0001,0.01,0.702,0.8704343534057256,4040,4064
18,8204,10,100,0.0001,0.01,0.68,0.8750609458800586,4094,4110
18,8304,10,100,0.0001,0.01,0.698,0.8931840077071291,4142,4162
18,8404,10,100,0.0001,0.01,0.688,0.8713707758210376,4197,4207
18,8504,10,100,0.0001,0.01,0.688,0.8740592662276576,4231,4273
18,8604,10,100,0.0001,0.01,0.702,0.8641329614132961,4274,4330
18,8704,10,100,0.0001,0.01,0.688,0.8767233455882353,4324,4380
18,8804,10,100,0.0001,0.01,0.714,0.8828941390277146,4377,4427
18,8904,10,100,0.0001,0.01,0.74,0.8831985624438454,4429,4475
18,9004,10,100,0.0001,0.01,0.734,0.8930475344291426,4473,4531
18,9104,10,100,0.0001,0.01,0.728,0.8999340949033392,4520,4584
18,9204,10,100,0.0001,0.01,0.72,0.9021077792264233,4581,4623
18,9304,10,100,0.0001,0.01,0.714,0.8875752364574376,4622,4682
18,9404,10,100,0.0001,0.01,0.75,0.8958953636750319,4671,4733
18,9504,10,100,0.0001,0.01,0.74,0.8990951178451179,4728,4776
18,9604,10,100,0.0001,0.01,0.744,0.9031653477717617,4775,4829
18,9704,10,100,0.0001,0.01,0.758,0.92219703215169,4829,4875
18,9804,10,100,0.0001,0.01,0.768,0.9077927376580988,4878,4926
18,9904,10,100,0.0001,0.01,0.764,0.8889337641357028,4932,4972
18,10004,10,100,0.0001,0.01,0.776,0.8957417033186725,4979,5025
18,10104,10,100,0.0001,0.01,0.772,0.9160728424386382,5028,5076
18,10204,10,100,0.0001,0.01,0.792,0.9367894943159545,5077,5127
18,10304,10,100,0.0001,0.01,0.784,0.9317740683229814,5126,5178
18,10404,10,100,0.0001,0.01,0.772,0.936562860438293,5171,5233
18,10504,10,100,0.0001,0.01,0.792,0.9342155369383092,5214,5290
18,10604,10,100,0.0001,0.01,0.778,0.9301207091663524,5268,5336
18,10704,10,100,0.0001,0.01,0.79,0.9288116591928252,5328,5376
18,10804,10,100,0.0001,0.01,0.8,0.9409477971121807,5376,5428
18,10904,10,100,0.0001,0.01,0.79,0.9334189288334556,5413,5491
18,11004,10,100,0.0001,0.01,0.774,0.9322973464194838,5457,5547
18,11104,10,100,0.0001,0.01,0.828,0.9540706051873199,5506,5598
18,11204,10,100,0.0001,0.01,0.814,0.9512674044983934,5573,5631
18,11304,10,100,0.0001,0.01,0.792,0.9394904458598726,5627,5677
18,11404,10,100,0.0001,0.01,0.83,0.9482637670992634,5680,5724
18,11504,10,100,0.0001,0.01,0.836,0.9528859527121002,5733,5771
18,11604,10,100,0.0001,0.01,0.834,0.9550155118924509,5791,5813
18,11704,10,100,0.0001,0.01,0.808,0.9283151059466849,5825,5879
18,11804,10,100,0.0001,0.01,0.822,0.9057099288376821,5875,5929
18,11904,10,100,0.0001,0.01,0.822,0.8889448924731183,5922,5982
18,12004,10,100,0.0001,0.01,0.824,0.8831222925691437,5970,6034
18,12104,10,100,0.0001,0.01,0.824,0.8802875082617316,6021,6083
18,12204,10,100,0.0001,0.01,0.828,0.9155195018026876,6071,6133
18,12304,10,100,0.0001,0.01,0.85,0.9281534460338101,6130,6174
18,12404,10,100,0.0001,0.01,0.874,0.9314737181554338,6190,6214
18,12504,10,100,0.0001,0.01,0.846,0.9252239283429302,6234,6270
18,12604,10,100,0.0001,0.01,0.87,0.9477943509996827,6280,6324
18,12704,10,100,0.0001,0.01,0.856,0.9395465994962217,6332,6372
18,12804,10,100,0.0001,0.01,0.896,0.9639956263667604,6377,6427
18,12904,10,100,0.0001,0.01,0.858,0.9455207687538748,6423,6481
18,13004,10,100,0.0001,0.01,0.902,0.9600123039064903,6483,6521
18,13104,10,100,0.0001,0.01,0.896,0.9700091575091575,6537,6567
18,13204,10,100,0.0001,0.01,0.872,0.9525901242047864,6587,6617
18,13304,10,100,0.0001,0.01,0.882,0.9627931449188214,6641,6663
18,13404,10,100,0.0001,0.01,0.896,0.9662041181736795,6688,6716
18,13504,10,100,0.0001,0.01,0.894,0.9732671800947867,6733,6771
18,13604,10,100,0.0001,0.01,0.894,0.9689797118494561,6780,6824
18,13704,10,100,0.0001,0.01,0.918,0.98482194979568,6834,6870
18,13804,10,100,0.0001,0.01,0.914,0.9848594610257896,6886,6918
18,13904,10,100,0.0001,0.01,0.928,0.9851841196777905,6929,6975
18,14004,10,100,0.0001,0.01,0.894,0.9700799771493859,6981,7023
18,14104,10,100,0.0001,0.01,0.924,0.9800056721497448,7032,7072
18,14204,10,100,0.0001,0.01,0.912,0.9657842861165868,7080,7124
18,14304,10,100,0.0001,0.01,0.916,0.9673517897091722,7134,7170
18,14404,10,100,0.0001,0.01,0.904,0.9618855873368509,7190,7214
18,14504,10,100,0.0001,0.01,0.918,0.9679398786541644,7241,7263
18,14604,10,100,0.0001,0.01,0.918,0.9708299096138044,7293,7311
18,14704,10,100,0.0001,0.01,0.922,0.9766730141458106,7349,7355
18,14804,10,100,0.0001,0.01,0.912,0.9752094028640907,7396,7408
18,14904,10,100,0.0001,0.01,0.942,0.9828234031132582,7445,7459
18,15004,10,100,0.0001,0.01,0.934,0.9828045854438816,7503,7501
19,104,10,100,0.0001,0.01,0.462,0.6538461538461539,48,56
19,204,10,100,0.0001,0.01,0.51,0.5343137254901961,104,100
19,304,10,100,0.0001,0.01,0.5,0.6348684210526315,154,150
19,404,10,100,0.0001,0.01,0.472,0.6113861386138614,202,202
19,504,10,100,0.0001,0.01,0.48,0.6329365079365079,243,261
19,604,10,100,0.0001,0.01,0.49,0.5844370860927153,303,301
19,704,10,100,0.0001,0.01,0.51,0.6065340909090909,345,359
19,804,10,100,0.0001,0.01,0.492,0.6293532338308457,389,415
19,904,10,100,0.0001,0.01,0.486,0.6349557522123894,432,472
19,1004,10,100,0.0001,0.01,0.502,0.649402390438247,479,525
19,1104,10,100,0.0001,0.01,0.494,0.6730072463768116,532,572
19,1204,10,100,0.0001,0.01,0.474,0.6586378737541528,583,621
19,1304,10,100,0.0001,0.01,0.482,0.6602760736196319,633,671
19,1404,10,100,0.0001,0.01,0.496,0.6837606837606838,679,725
19,1504,10,100,0.0001,0.01,0.504,0.6988031914893617,734,770
19,1604,10,100,0.0001,0.01,0.49,0.683291770573566,782,822
19,1704,10,100,0.0001,0.01,0.5,0.7095070422535211,835,869
19,1804,10,100,0.0001,0.01,0.506,0.7100886917960089,886,918
19,1904,10,100,0.0001,0.01,0.522,0.694327731092437,933,971
19,2004,10,100,0.0001,0.01,0.528,0.7310379241516967,989,1015
19,2104,10,100,0.0001,0.01,0.542,0.7343155893536122,1036,1068
19,2204,10,100,0.0001,0.01,0.546,0.7558983666061706,1084,1120
19,2304,10,100,0.0001,0.01,0.53,0.7543402777777778,1132,1172
19,2404,10,100,0.0001,0.01,0.558,0.7666389351081531,1188,1216
19,2504,10,100,0.0001,0.01,0.536,0.7947284345047924,1242,1262
19,2604,10,100,0.0001,0.01,0.568,0.7983870967741935,1298,1306
19,2704,10,100,0.0001,0.01,0.58,0.8243343195266272,1350,1354
19,2804,10,100,0.0001,0.01,0.606,0.8502139800285307,1400,1404
19,2904,10,100,0.0001,0.01,0.622,0.7930440771349863,1449,1455
19,3004,10,100,0.0001,0.01,0.592,0.7576564580559254,1502,1502
19,3104,10,100,0.0001,0.01,0.572,0.7071520618556701,1549,1555
19,3204,10,100,0.0001,0.01,0.61,0.7865168539325843,1593,1611
19,3304,10,100,0.0001,0.01,0.66,0.822639225181598,1652,1652
19,3404,10,100,0.0001,0.01,0.65,0.8404817861339601,1710,1694
19,3504,10,100,0.0001,0.01,0.65,0.831906392694064,1755,1749
19,3604,10,100,0.0001,0.01,0.648,0.8446170921198668,1804,1800
19,3704,10,100,0.0001,0.01,0.668,0.8193844492440605,1862,1842
19,3804,10,100,0.0001,0.01,0.662,0.8567297581493165,1907,1897
19,3904,10,100,0.0001,0.01,0.672,0.8427254098360656,1958,1946
19,4004,10,100,0.0001,0.01,0.666,0.8426573426573427,2012,1992
19,4104,10,100,0.0001,0.01,0.69,0.8881578947368421,2060,2044
19,4204,10,100,0.0001,0.01,0.708,0.8777354900095148,2111,2093
19,4304,10,100,0.0001,0.01,0.694,0.8689591078066915,2160,2144
19,4404,10,100,0.0001,0.01,0.688,0.8580835603996367,2203,2201
19,4504,10,100,0.0001,0.01,0.684,0.8712255772646537,2251,2253
19,4604,10,100,0.0001,0.01,0.71,0.891398783666377,2298,2306
19,4704,10,100,0.0001,0.01,0.684,0.9030612244897959,2343,2361
19,4804,10,100,0.0001,0.01,0.686,0.8846794338051623,2395,2409
19,4904,10,100,0.0001,0.01,0.72,0.9145595432300163,2443,2461
19,5004,10,100,0.0001,0.01,0.684,0.8968824940047961,2502,2502
19,5104,10,100,0.0001,0.01,0.698,0.8769592476489029,2558,2546
19,5204,10,100,0.0001,0.01,0.68,0.8795157571099155,2603,2601
19,5304,10,100,0.0001,0.01,0.72,0.8659502262443439,2650,2654
19,5404,10,100,0.0001,0.01,0.726,0.8910066617320503,2699,2705
19,5504,10,100,0.0001,0.01,0.706,0.879905523255814,2744,2760
19,5604,10,100,0.0001,0.01,0.702,0.8977516059957173,2795,2809
19,5704,10,100,0.0001,0.01,0.714,0.89726507713885,2843,2861
19,5804,10,100,0.0001,0.01,0.746,0.9164369400413508,2890,2914
19,5904,10,100,0.0001,0.01,0.724,0.9141260162601627,2944,2960
19,6004,10,100,0.0001,0.01,0.75,0.9248834110592938,2997,3007
19,6104,10,100,0.0001,0.01,0.724,0.9302096985583224,3046,3058
19,6204,10,100,0.0001,0.01,0.75,0.9186009026434558,3093,3111
19,6304,10,100,0.0001,0.01,0.714,0.9249682741116751,3137,3167
19,6404,10,100,0.0001,0.01,0.748,0.920049968769519,3195,3209
19,6504,10,100,0.0001,0.01,0.718,0.9135916359163592,3244,3260
19,6604,10,100,0.0001,0.01,0.736,0.9200484554815264,3299,3305
19,6704,10,100,0.0001,0.01,0.77,0.9146778042959427,3343,3361
19,6804,10,100,0.0001,0.01,0.738,0.9235743680188124,3394,3410
19,6904,10,100,0.0001,0.01,0.75,0.9342410196987254,3444,3460
19,7004,10,100,0.0001,0.01,0.736,0.9384637350085665,3495,3509
19,7104,10,100,0.0001,0.01,0.736,0.9494650900900901,3551,3553
19,7204,10,100,0.0001,0.01,0.77,0.9423931149361466,3600,3604
19,7304,10,100,0.0001,0.01,0.76,0.9355147864184009,3644,3660
19,7404,10,100,0.0001,0.01,0.748,0.9166666666666666,3696,3708
19,7504,10,100,0.0001,0.01,0.752,0.9450959488272921,3752,3752
19,7604,10,100,0.0001,0.01,0.756,0.9339821146764861,3806,3798
19,7704,10,100,0.0001,0.01,0.764,0.9456126687435099,3856,3848
19,7804,10,100,0.0001,0.01,0.764,0.9383649410558688,3911,3893
19,7904,10,100,0.0001,0.01,0.752,0.940915991902834,3963,3941
19,8004,10,100,0.0001,0.01,0.754,0.9249125437281359,4021,3983
19,8104,10,100,0.0001,0.01,0.774,0.9403998025666338,4065,4039
19,8204,10,100,0.0001,0.01,0.782,0.9369819600195027,4119,4085
19,8304,10,100,0.0001,0.01,0.768,0.915582851637765,4166,4138
19,8404,10,100,0.0001,0.01,0.746,0.91432651118515,4214,4190
19,8504,10,100,0.0001,0.01,0.772,0.909689557855127,4268,4236
19,8604,10,100,0.0001,0.01,0.788,0.9351464435146444,4317,4287
19,8704,10,100,0.0001,0.01,0.762,0.9461167279411765,4361,4343
19,8804,10,100,0.0001,0.01,0.776,0.9460472512494321,4410,4394
19,8904,10,100,0.0001,0.01,0.796,0.9211590296495957,4457,4447
19,9004,10,100,0.0001,0.01,0.782,0.9376943580630831,4503,4501
19,9104,10,100,0.0001,0.01,0.776,0.9199253075571178,4552,4552
19,9204,10,100,0.0001,0.01,0.794,0.934593654932638,4601,4603
19,9304,10,100,0.0001,0.01,0.772,0.9349742046431643,4649,4655
19,9404,10,100,0.0001,0.01,0.782,0.9424712888132709,4698,4706
19,9504,10,100,0.0001,0.01,0.812,0.9559132996632996,4740,4764
19,9604,10,100,0.0001,0.01,0.798,0.9518950437317785,4784,4820
19,9704,10,100,0.0001,0.01,0.796,0.9483718054410553,4835,4869
19,9804,10,100,0.0001,0.01,0.788,0.9424724602203183,4878,4926
19,9904,10,100,0.0001,0.01,0.8,0.9376009693053312,4929,4975
19,10004,10,100,0.0001,0.01,0.802,0.9364254298280688,4980,5024
19,10104,10,100,0.0001,0.01,0.802,0.9239904988123515,5022,5082
19,10204,10,100,0.0001,0.01,0.798,0.9311054488435907,5074,5130
19,10304,10,100,0.0001,0.01,0.826,0.9573951863354038,5125,5179
19,10404,10,100,0.0001,0.01,0.782,0.9168589004229143,5173,5231
19,10504,10,100,0.0001,0.01,0.792,0.9403084539223153,5227,5277
19,10604,10,100,0.0001,0.01,0.798,0.9346473029045643,5272,5332
19,10704,10,100,0.0001,0.01,0.798,0.9442264573991032,5318,5386
19,10804,10,100,0.0001,0.01,0.806,0.9396519807478712,5363,5441
19,10904,10,100,0.0001,0.01,0.826,0.9535950110051358,5412,5492
19,11004,10,100,0.0001,0.01,0.814,0.9591057797164667,5465,5539
19,11104,10,100,0.0001,0.01,0.824,0.9539805475504323,5518,5586
19,11204,10,100,0.0001,0.01,0.822,0.9549268118529097,5573,5631
19,11304,10,100,0.0001,0.01,0.824,0.9523177636234961,5623,5681
19,11404,10,100,0.0001,0.01,0.804,0.9633461943177832,5668,5736
19,11504,10,100,0.0001,0.01,0.808,0.9522774687065368,5722,5782
19,11604,10,100,0.0001,0.01,0.82,0.9690623922785246,5772,5832
19,11704,10,100,0.0001,0.01,0.83,0.9647129186602871,5823,5881
19,11804,10,100,0.0001,0.01,0.79,0.9384954252795662,5874,5930
19,11904,10,100,0.0001,0.01,0.802,0.9551411290322581,5922,5982
19,12004,10,100,0.0001,0.01,0.806,0.9408530489836721,5983,6021
19,12104,10,100,0.0001,0.01,0.812,0.9237442167878387,6037,6067
19,12204,10,100,0.0001,0.01,0.822,0.9462471320878401,6081,6123
19,12304,10,100,0.0001,0.01,0.82,0.9622886866059818,6139,6165
19,12404,10,100,0.0001,0.01,0.82,0.9622702354079329,6183,6221
19,12504,10,100,0.0001,0.01,0.822,0.9495361484325016,6232,6272
19,12604,10,100,0.0001,0.01,0.822,0.9569977784830213,6276,6328
19,12704,10,100,0.0001,0.01,0.842,0.9712688916876574,6323,6381
19,12804,10,100,0.0001,0.01,0.828,0.9603248984692284,6362,6442
19,12904,10,100,0.0001,0.01,0.82,0.9531153130812151,6415,6489
19,13004,10,100,0.0001,0.01,0.836,0.9542448477391572,6458,6546
19,13104,10,100,0.0001,0.01,0.842,0.9734432234432234,6513,6591
19,13204,10,100,0.0001,0.01,0.844,0.9752347773401999,6562,6642
19,13304,10,100,0.0001,0.01,0.842,0.967077570655442,6619,6685
19,13404,10,100,0.0001,0.01,0.824,0.9550880334228589,6684,6720
19,13504,10,100,0.0001,0.01,0.848,0.9612707345971564,6736,6768
19,13604,10,100,0.0001,0.01,0.846,0.9630990885033813,6789,6815
19,13704,10,100,0.0001,0.01,0.852,0.9727086981903094,6835,6869
19,13804,10,100,0.0001,0.01,0.834,0.9532019704433498,6885,6919
19,13904,10,100,0.0001,0.01,0.862,0.9506616800920599,6931,6973
19,14004,10,100,0.0001,0.01,0.858,0.9726506712367895,6983,7021
19,14104,10,100,0.0001,0.01,0.876,0.9751134429948951,7037,7067
19,14204,10,100,0.0001,0.01,0.864,0.9714869050971557,7089,7115
19,14304,10,100,0.0001,0.01,0.866,0.9563758389261745,7141,7163
19,14404,10,100,0.0001,0.01,0.846,0.9582060538739239,7191,7213
19,14504,10,100,0.0001,0.01,0.862,0.9747655819084391,7245,7259
19,14604,10,100,0.0001,0.01,0.858,0.9560394412489729,7299,7305
19,14704,10,100,0.0001,0.01,0.894,0.9715723612622416,7350,7354
19,14804,10,100,0.0001,0.01,0.882,0.9790597135909214,7395,7409
19,14904,10,100,0.0001,0.01,0.864,0.9668545356951154,7450,7454
19,15004,10,100,0.0001,0.01,0.874,0.9698747000799787,7495,7509
20,104,10,100,0.0001,0.01,0.5,0.5096153846153846,53,51
20,204,10,100,0.0001,0.01,0.452,0.6715686274509803,96,108
20,304,10,100,0.0001,0.01,0.51,0.6447368421052632,145,159
20,404,10,100,0.0001,0.01,0.498,0.6584158415841584,192,212
20,504,10,100,0.0001,0.01,0.494,0.6190476190476191,238,266
20,604,10,100,0.0001,0.01,0.532,0.6225165562913907,298,306
20,704,10,100,0.0001,0.01,0.48,0.6463068181818182,347,357
20,804,10,100,0.0001,0.01,0.504,0.667910447761194,400,404
20,904,10,100,0.0001,0.01,0.47,0.672566371681416,450,454
20,1004,10,100,0.0001,0.01,0.494,0.6852589641434262,499,505
20,1104,10,100,0.0001,0.01,0.504,0.6648550724637681,553,551
20,1204,10,100,0.0001,0.01,0.466,0.7026578073089701,604,600
20,1304,10,100,0.0001,0.01,0.498,0.7085889570552147,652,652
20,1404,10,100,0.0001,0.01,0.526,0.7279202279202279,700,704
20,1504,10,100,0.0001,0.01,0.506,0.7041223404255319,748,756
20,1604,10,100,0.0001,0.01,0.536,0.7013715710723192,786,818
20,1704,10,100,0.0001,0.01,0.514,0.7142018779342723,835,869
20,1804,10,100,0.0001,0.01,0.506,0.7283813747228381,887,917
20,1904,10,100,0.0001,0.01,0.53,0.729516806722689,937,967
20,2004,10,100,0.0001,0.01,0.552,0.7345309381237525,987,1017
20,2104,10,100,0.0001,0.01,0.506,0.7404942965779467,1044,1060
20,2204,10,100,0.0001,0.01,0.522,0.7568058076225045,1090,1114
20,2304,10,100,0.0001,0.01,0.482,0.7378472222222222,1147,1157
20,2404,10,100,0.0001,0.01,0.518,0.7354409317803661,1201,1203
20,2504,10,100,0.0001,0.01,0.496,0.764776357827476,1256,1248
20,2604,10,100,0.0001,0.01,0.522,0.7761136712749616,1302,1302
20,2704,10,100,0.0001,0.01,0.492,0.7618343195266272,1347,1357
20,2804,10,100,0.0001,0.01,0.544,0.7845934379457917,1391,1413
20,2904,10,100,0.0001,0.01,0.506,0.7537878787878788,1440,1464
20,3004,10,100,0.0001,0.01,0.5,0.7816245006657789,1493,1511
20,3104,10,100,0.0001,0.01,0.51,0.8025128865979382,1537,1567
20,3204,10,100,0.0001,0.01,0.52,0.7971285892634207,1578,1626
20,3304,10,100,0.0001,0.01,0.544,0.8274818401937046,1633,1671
20,3404,10,100,0.0001,0.01,0.53,0.8249118683901293,1685,1719
20,3504,10,100,0.0001,0.01,0.516,0.819634703196347,1728,1776
20,3604,10,100,0.0001,0.01,0.546,0.8293562708102109,1789,1815
20,3704,10,100,0.0001,0.01,0.556,0.8482721382289417,1833,1871
20,3804,10,100,0.0001,0.01,0.568,0.8251840168243953,1886,1918
20,3904,10,100,0.0001,0.01,0.562,0.8212090163934426,1935,1969
20,4004,10,100,0.0001,0.01,0.56,0.8404095904095904,1984,2020
20,4104,10,100,0.0001,0.01,0.566,0.8530701754385965,2038,2066
20,4204,10,100,0.0001,0.01,0.568,0.838011417697431,2094,2110
20,4304,10,100,0.0001,0.01,0.574,0.8633828996282528,2142,2162
20,4404,10,100,0.0001,0.01,0.572,0.8569482288828338,2197,2207
20,4504,10,100,0.0001,0.01,0.592,0.8634547069271759,2252,2252
20,4604,10,100,0.0001,0.01,0.6,0.8362293657688966,2300,2304
20,4704,10,100,0.0001,0.01,0.612,0.85671768707483,2353,2351
20,4804,10,100,0.0001,0.01,0.616,0.8422148209825145,2406,2398
20,4904,10,100,0.0001,0.01,0.62,0.8568515497553018,2458,2446
20,5004,10,100,0.0001,0.01,0.592,0.863709032773781,2505,2499
20,5104,10,100,0.0001,0.01,0.628,0.8550156739811913,2559,2545
20,5204,10,100,0.0001,0.01,0.62,0.8572252113758647,2615,2589
20,5304,10,100,0.0001,0.01,0.632,0.8578431372549019,2672,2632
20,5404,10,100,0.0001,0.01,0.66,0.8662102146558105,2721,2683
20,5504,10,100,0.0001,0.01,0.624,0.838844476744186,2768,2736
20,5604,10,100,0.0001,0.01,0.622,0.8559957173447538,2817,2787
20,5704,10,100,0.0001,0.01,0.62,0.8309957924263675,2867,2837
20,5804,10,100,0.0001,0.01,0.628,0.8533769813921434,2905,2899
20,5904,10,100,0.0001,0.01,0.65,0.8592479674796748,2956,2948
20,6004,10,100,0.0001,0.01,0.654,0.8662558294470353,2999,3005
20,6104,10,100,0.0001,0.01,0.648,0.8630406290956749,3045,3059
20,6204,10,100,0.0001,0.01,0.666,0.884107027724049,3094,3110
20,6304,10,100,0.0001,0.01,0.664,0.871510152284264,3141,3163
20,6404,10,100,0.0001,0.01,0.692,0.891317926296065,3190,3214
20,6504,10,100,0.0001,0.01,0.654,0.8834563345633456,3234,3270
20,6604,10,100,0.0001,0.01,0.662,0.8779527559055118,3289,3315
20,6704,10,100,0.0001,0.01,0.684,0.8727625298329356,3338,3366
20,6804,10,100,0.0001,0.01,0.672,0.8852145796590241,3391,3413
20,6904,10,100,0.0001,0.01,0.686,0.8942641946697567,3438,3466
20,7004,10,100,0.0001,0.01,0.678,0.9029126213592233,3490,3514
20,7104,10,100,0.0001,0.01,0.7,0.8826013513513513,3543,3561
20,7204,10,100,0.0001,0.01,0.68,0.8892282065519156,3595,3609
20,7304,10,100,0.0001,0.01,0.678,0.8854052573932092,3649,3655
20,7404,10,100,0.0001,0.01,0.688,0.9007293354943274,3692,3712
20,7504,10,100,0.0001,0.01,0.68,0.8933901918976546,3736,3768
20,7604,10,100,0.0001,0.01,0.688,0.9025512887953708,3795,3809
20,7704,10,100,0.0001,0.01,0.696,0.9123831775700935,3849,3855
20,7804,10,100,0.0001,0.01,0.68,0.8898001025115325,3890,3914
20,7904,10,100,0.0001,0.01,0.696,0.8942307692307693,3940,3964
20,8004,10,100,0.0001,0.01,0.668,0.8968015992003998,3989,4015
20,8104,10,100,0.0001,0.01,0.688,0.9063425468904245,4038,4066
20,8204,10,100,0.0001,0.01,0.694,0.9001706484641638,4091,4113
20,8304,10,100,0.0001,0.01,0.68,0.8736753371868978,4148,4156
20,8404,10,100,0.0001,0.01,0.698,0.8908852927177534,4198,4206
20,8504,10,100,0.0001,0.01,0.672,0.8964016933207902,4248,4256
20,8604,10,100,0.0001,0.01,0.67,0.903533240353324,4297,4307
20,8704,10,100,0.0001,0.01,0.718,0.8922334558823529,4347,4357
20,8804,10,100,0.0001,0.01,0.682,0.8957292139936393,4391,4413
20,8904,10,100,0.0001,0.01,0.706,0.9079065588499551,4435,4469
20,9004,10,100,0.0001,0.01,0.69,0.9012661039537984,4492,4512
20,9104,10,100,0.0001,0.01,0.698,0.9057557117750439,4543,4561
20,9204,10,100,0.0001,0.01,0.71,0.8857018687527162,4590,4614
20,9304,10,100,0.0001,0.01,0.724,0.9208942390369733,4631,4673
20,9404,10,100,0.0001,0.01,0.714,0.9237558485750744,4684,4720
20,9504,10,100,0.0001,0.01,0.716,0.9039351851851852,4734,4770
20,9604,10,100,0.0001,0.01,0.694,0.8934818825489379,4793,4811
20,9704,10,100,0.0001,0.01,0.734,0.8891178895300906,4853,4851
20,9804,10,100,0.0001,0.01,0.722,0.9157486740106079,4905,4899
20,9904,10,100,0.0001,0.01,0.726,0.9148828756058158,4955,4949
20,10004,10,100,0.0001,0.01,0.746,0.9128348660535786,5004,5000
20,10104,10,100,0.0001,0.01,0.746,0.9000395882818686,5056,5048
20,10204,10,100,0.0001,0.01,0.75,0.909937279498236,5112,5092
20,10304,10,100,0.0001,0.01,0.736,0.9143051242236024,5159,5145
20,10404,10,100,0.0001,0.01,0.766,0.918396770472895,5208,5196
20,10504,10,100,0.0001,0.01,0.724,0.9162223914699162,5262,5242
20,10604,10,100,0.0001,0.01,0.724,0.926442851754055,5309,5295
20,10704,10,100,0.0001,0.01,0.75,0.9322683109118086,5363,5341
20,10804,10,100,0.0001,0.01,0.752,0.9277119585338763,5412,5392
20,10904,10,100,0.0001,0.01,0.73,0.9220469552457814,5460,5444
20,11004,10,100,0.0001,0.01,0.778,0.9302071973827699,5508,5496
20,11104,10,100,0.0001,0.01,0.768,0.9184077809798271,5563,5541
20,11204,10,100,0.0001,0.01,0.726,0.9244019992859693,5614,5590
20,11304,10,100,0.0001,0.01,0.728,0.8964083510261854,5659,5645
20,11404,10,100,0.0001,0.01,0.76,0.9034549280954052,5715,5689
20,11504,10,100,0.0001,0.01,0.744,0.9222009735744089,5771,5733
20,11604,10,100,0.0001,0.01,0.75,0.927524991382282,5822,5782
20,11704,10,100,0.0001,0.01,0.772,0.9319890635680109,5871,5833
20,11804,10,100,0.0001,0.01,0.746,0.9277363605557438,5926,5878
20,11904,10,100,0.0001,0.01,0.772,0.9376680107526881,5967,5937
20,12004,10,100,0.0001,0.01,0.768,0.9256914361879374,6010,5994
20,12104,10,100,0.0001,0.01,0.8,0.940846001321877,6059,6045
20,12204,10,100,0.0001,0.01,0.79,0.9375614552605703,6111,6093
20,12304,10,100,0.0001,0.01,0.768,0.9352243172951885,6156,6148
20,12404,10,100,0.0001,0.01,0.778,0.9197033215091905,6208,6196
20,12504,10,100,0.0001,0.01,0.752,0.9220249520153551,6269,6235
20,12604,10,100,0.0001,0.01,0.786,0.9435893367185021,6311,6293
20,12704,10,100,0.0001,0.01,0.778,0.9395465994962217,6370,6334
20,12804,10,100,0.0001,0.01,0.808,0.9533739456419869,6414,6390
20,12904,10,100,0.0001,0.01,0.808,0.9459082455052696,6468,6436
20,13004,10,100,0.0001,0.01,0.824,0.9460935096893264,6518,6486
20,13104,10,100,0.0001,0.01,0.794,0.9294871794871795,6558,6546
20,13204,10,100,0.0001,0.01,0.824,0.9406997879430475,6608,6596
20,13304,10,100,0.0001,0.01,0.802,0.926037282020445,6661,6643
20,13404,10,100,0.0001,0.01,0.814,0.9499403163234855,6714,6690
20,13504,10,100,0.0001,0.01,0.824,0.9553465639810427,6758,6746
20,13604,10,100,0.0001,0.01,0.816,0.9377389003234343,6797,6807
20,13704,10,100,0.0001,0.01,0.836,0.9572387624051372,6849,6855
20,13804,10,100,0.0001,0.01,0.83,0.9434946392350043,6898,6906
20,13904,10,100,0.0001,0.01,0.806,0.9518843498273878,6953,6951
20,14004,10,100,0.0001,0.01,0.794,0.9388031990859754,7003,7001
20,14104,10,100,0.0001,0.01,0.814,0.9495887691435054,7045,7059
20,14204,10,100,0.0001,0.01,0.802,0.9372711912137426,7099,7105
20,14304,10,100,0.0001,0.01,0.818,0.9506431767337807,7151,7153
20,14404,10,100,0.0001,0.01,0.808,0.9428630935851152,7197,7207
20,14504,10,100,0.0001,0.01,0.832,0.9436017650303364,7247,7257
20,14604,10,100,0.0001,0.01,0.798,0.9436455765543686,7297,7307
20,14704,10,100,0.0001,0.01,0.784,0.9152611534276387,7351,7353
20,14804,10,100,0.0001,0.01,0.802,0.9447446636044312,7400,7404
20,14904,10,100,0.0001,0.01,0.822,0.9518250134192163,7450,7454
20,15004,10,100,0.0001,0.01,0.812,0.9458144494801386,7502,7502
1,104,10,100,0.001,0.01,0.498,0.49038461538461536,53,51
1,204,10,100,0.001,0.01,0.486,0.6176470588235294,97,107
1,304,10,100,0.001,0.01,0.508,0.5493421052631579,143,161
1,404,10,100,0.001,0.01,0.5,0.6336633663366337,189,215
1,504,10,100,0.001,0.01,0.536,0.6091269841269841,245,259
1,604,10,100,0.001,0.01,0.542,0.6274834437086093,294,310
1,704,10,100,0.001,0.01,0.54,0.6292613636363636,335,369
1,804,10,100,0.001,0.01,0.54,0.654228855721393,388,416
1,904,10,100,0.001,0.01,0.506,0.6592920353982301,433,471
1,1004,10,100,0.001,0.01,0.524,0.6683266932270916,484,520
1,1104,10,100,0.001,0.01,0.496,0.6784420289855072,531,573
1,1204,10,100,0.001,0.01,0.562,0.7142857142857143,576,628
1,1304,10,100,0.001,0.01,0.536,0.7062883435582822,618,686
1,1404,10,100,0.001,0.01,0.532,0.7136752136752137,670,734
1,1504,10,100,0.001,0.01,0.536,0.7094414893617021,723,781
1,1604,10,100,0.001,0.01,0.548,0.7412718204488778,771,833
1,1704,10,100,0.001,0.01,0.524,0.7165492957746479,815,889
1,1804,10,100,0.001,0.01,0.576,0.75,858,946
1,1904,10,100,0.001,0.01,0.59,0.7489495798319328,900,1004
1,2004,10,100,0.001,0.01,0.556,0.8093812375249501,953,1051
1,2104,10,100,0.001,0.01,0.548,0.7756653992395437,1003,1101
1,2204,10,100,0.001,0.01,0.572,0.8176043557168784,1058,1146
1,2304,10,100,0.001,0.01,0.58,0.7599826388888888,1092,1212
1,2404,10,100,0.001,0.01,0.58,0.8148918469217971,1140,1264
1,2504,10,100,0.001,0.01,0.552,0.8134984025559105,1187,1317
1,2604,10,100,0.001,0.01,0.578,0.8241167434715821,1242,1362
1,2704,10,100,0.001,0.01,0.61,0.8258136094674556,1304,1400
1,2804,10,100,0.001,0.01,0.616,0.8470042796005706,1342,1462
1,2904,10,100,0.001,0.01,0.62,0.8453856749311295,1394,1510
1,3004,10,100,0.001,0.01,0.664,0.8804926764314248,1453,1551
1,3104,10,100,0.001,0.01,0.678,0.8936855670103093,1505,1599
1,3204,10,100,0.001,0.01,0.648,0.8954431960049938,1557,1647
1,3304,10,100,0.001,0.01,0.7,0.9240314769975787,1611,1693
1,3404,10,100,0.001,0.01,0.696,0.9004112808460635,1658,1746
1,3504,10,100,0.001,0.01,0.682,0.89412100456621,1707,1797
1,3604,10,100,0.001,0.01,0.668,0.857103218645949,1754,1850
1,3704,10,100,0.001,0.01,0.698,0.9136069114470843,1811,1893
1,3804,10,100,0.001,0.01,0.724,0.908254468980021,1864,1940
1,3904,10,100,0.001,0.01,0.718,0.9098360655737705,1913,1991
1,4004,10,100,0.001,0.01,0.786,0.9368131868131868,1967,2037
1,4104,10,100,0.001,0.01,0.78,0.9398148148148148,2010,2094
1,4204,10,100,0.001,0.01,0.79,0.9374405328258801,2067,2137
1,4304,10,100,0.001,0.01,0.79,0.9154275092936803,2112,2192
1,4404,10,100,0.001,0.01,0.808,0.9348319709355132,2161,2243
1,4504,10,100,0.001,0.01,0.822,0.9460479573712256,2206,2298
1,4604,10,100,0.001,0.01,0.844,0.9615551694178974,2254,2350
1,4704,10,100,0.001,0.01,0.85,0.9585459183673469,2307,2397
1,4804,10,100,0.001,0.01,0.878,0.9766860949208993,2349,2455
1,4904,10,100,0.001,0.01,0.882,0.9861337683523654,2397,2507
1,5004,10,100,0.001,0.01,0.898,0.9896083133493205,2450,2554
1,5104,10,100,0.001,0.01,0.906,0.9909874608150471,2497,2607
1,5204,10,100,0.001,0.01,0.93,0.9926979246733282,2541,2663
1,5304,10,100,0.001,0.01,0.912,0.9926470588235294,2597,2707
1,5404,10,100,0.001,0.01,0.922,0.9863064396743153,2644,2760
1,5504,10,100,0.001,0.01,0.91,0.9890988372093024,2693,2811
1,5604,10,100,0.001,0.01,0.918,0.9867951463240543,2728,2876
1,5704,10,100,0.001,0.01,0.914,0.988078541374474,2779,2925
1,5804,10,100,0.001,0.01,0.918,0.994486560992419,2829,2975
1,5904,10,100,0.001,0.01,0.934,0.994579945799458,2875,3029
1,6004,10,100,0.001,0.01,0.914,0.9870086608927382,2927,3077
1,6104,10,100,0.001,0.01,0.938,0.9865661861074705,2982,3122
1,6204,10,100,0.001,0.01,0.936,0.9935525467440361,3030,3174
1,6304,10,100,0.001,0.01,0.938,0.9922271573604061,3077,3227
1,6404,10,100,0.001,0.01,0.934,0.9965646470955652,3124,3280
1,6504,10,100,0.001,0.01,0.936,0.9933886838868389,3175,3329
1,6604,10,100,0.001,0.01,0.944,0.9894003634161115,3233,3371
1,6704,10,100,0.001,0.01,0.946,0.991945107398568,3282,3422
1,6804,10,100,0.001,0.01,0.902,0.9738389182833628,3333,3471
1,6904,10,100,0.001,0.01,0.936,0.990874855156431,3379,3525
1,7004,10,100,0.001,0.01,0.95,0.9914334665905197,3425,3579
1,7104,10,100,0.001,0.01,0.94,0.9943693693693694,3478,3626
1,7204,10,100,0.001,0.01,0.946,0.9877845641310383,3526,3678
1,7304,10,100,0.001,0.01,0.924,0.9822015334063526,3580,3724
1,7404,10,100,0.001,0.01,0.94,0.9848730415991356,3628,3776
1,7504,10,100,0.001,0.01,0.948,0.9889392324093816,3681,3823
1,7604,10,100,0.001,0.01,0.946,0.9926354550236718,3725,3879
1,7704,10,100,0.001,0.01,0.952,0.989226375908619,3778,3926
1,7804,10,100,0.001,0.01,0.96,0.9942337262942081,3834,3970
1,7904,10,100,0.001,0.01,0.956,0.9946862348178138,3878,4026
1,8004,10,100,0.001,0.01,0.956,0.9921289355322339,3935,4069
1,8104,10,100,0.001,0.01,0.956,0.9876604146100691,3980,4124
1,8204,10,100,0.001,0.01,0.944,0.9842759629449049,4024,4180
1,8304,10,100,0.001,0.01,0.94,0.9869942196531792,4078,4226
1,8404,10,100,0.001,0.01,0.954,0.9953593526891956,4128,4276
1,8504,10,100,0.001,0.01,0.958,0.9925917215428034,4184,4320
1,8604,10,100,0.001,0.01,0.942,0.9868665736866574,4237,4367
1,8704,10,100,0.001,0.01,0.95,0.9948299632352942,4285,4419
1,8804,10,100,0.001,0.01,0.964,0.9925034075420264,4341,4463
1,8904,10,100,0.001,0.01,0.958,0.9912398921832885,4388,4516
1,9004,10,100,0.001,0.01,0.956,0.9954464682363394,4436,4568
1,9104,10,100,0.001,0.01,0.956,0.9940685413005272,4476,4628
1,9204,10,100,0.001,0.01,0.96,0.9941329856584094,4522,4682
1,9304,10,100,0.001,0.01,0.95,0.9905417024935511,4577,4727
1,9404,10,100,0.001,0.01,0.958,0.991811994895789,4638,4766
1,9504,10,100,0.001,0.01,0.966,0.9909511784511784,4695,4809
1,9604,10,100,0.001,0.01,0.962,0.9906289046230737,4751,4853
1,9704,10,100,0.001,0.01,0.94,0.9764014839241549,4800,4904
1,9804,10,100,0.001,0.01,0.966,0.9915340677274582,4834,4970
1,9904,10,100,0.001,0.01,0.968,0.9930331179321487,4885,5019
1,10004,10,100,0.001,0.01,0.97,0.9960015993602559,4931,5073
1,10104,10,100,0.001,0.01,0.97,0.9955463182897862,4971,5133
1,10204,10,100,0.001,0.01,0.972,0.9947079576636613,5030,5174
1,10304,10,100,0.001,0.01,0.974,0.9979619565217391,5080,5224
1,10404,10,100,0.001,0.01,0.972,0.998558246828143,5132,5272
1,10504,10,100,0.001,0.01,0.972,0.9967631378522468,5182,5322
1,10604,10,100,0.001,0.01,0.97,0.9937759336099585,5238,5366
1,10704,10,100,0.001,0.01,0.97,0.9895366218236173,5292,5412
1,10804,10,100,0.001,0.01,0.956,0.98870788596816,5336,5468
1,10904,10,100,0.001,0.01,0.97,0.9931217901687455,5386,5518
1,11004,10,100,0.001,0.01,0.972,0.9945474372955289,5432,5572
1,11104,10,100,0.001,0.01,0.962,0.993335734870317,5479,5625
1,11204,10,100,0.001,0.01,0.972,0.9964298464833988,5536,5668
1,11304,10,100,0.001,0.01,0.978,0.9983191790516631,5591,5713
1,11404,10,100,0.001,0.01,0.964,0.9935987372851631,5630,5774
1,11504,10,100,0.001,0.01,0.976,0.9945236439499304,5680,5824
1,11604,10,100,0.001,0.01,0.964,0.9937090658393657,5723,5881
1,11704,10,100,0.001,0.01,0.976,0.9959842788790157,5769,5935
1,11804,10,100,0.001,0.01,0.976,0.9961030159268045,5819,5985
1,11904,10,100,0.001,0.01,0.976,0.9982358870967742,5876,6028
1,12004,10,100,0.001,0.01,0.98,0.9970843052315894,5929,6075
1,12104,10,100,0.001,0.01,0.972,0.9957865168539326,5986,6118
1,12204,10,100,0.001,0.01,0.972,0.9910685021304491,6030,6174
1,12304,10,100,0.001,0.01,0.972,0.9945546163849155,6095,6209
1,12404,10,100,0.001,0.01,0.97,0.9921799419542083,6149,6255
1,12504,10,100,0.001,0.01,0.978,0.9944017914267435,6197,6307
1,12604,10,100,0.001,0.01,0.976,0.9957949857188194,6255,6349
1,12704,10,100,0.001,0.01,0.984,0.9977959697732998,6311,6393
1,12804,10,100,0.001,0.01,0.98,0.9957825679475164,6358,6446
1,12904,10,100,0.001,0.01,0.98,0.9989150650960942,6408,6496
1,13004,10,100,0.001,0.01,0.982,0.9976930175330667,6454,6550
1,13104,10,100,0.001,0.01,0.976,0.9964133089133089,6511,6593
1,13204,10,100,0.001,0.01,0.974,0.9953801878218722,6559,6645
1,13304,10,100,0.001,0.01,0.982,0.991882140709561,6606,6698
1,13404,10,100,0.001,0.01,0.982,0.9897045658012533,6667,6737
1,13504,10,100,0.001,0.01,0.982,0.9968898104265402,6717,6787
1,13604,10,100,0.001,0.01,0.974,0.9947809467803587,6767,6837
1,13704,10,100,0.001,0.01,0.98,0.9916082895504962,6821,6883
1,13804,10,100,0.001,0.01,0.98,0.9961605331787887,6872,6932
1,13904,10,100,0.001,0.01,0.982,0.9979861910241657,6924,6980
1,14004,10,100,0.001,0.01,0.982,0.9955726935161382,6974,7030
1,14104,10,100,0.001,0.01,0.978,0.9946823596142939,7027,7077
1,14204,10,100,0.001,0.01,0.984,0.9887355674457899,7070,7134
1,14304,10,100,0.001,0.01,0.976,0.9916107382550335,7120,7184
1,14404,10,100,0.001,0.01,0.98,0.9950708136628714,7177,7227
1,14504,10,100,0.001,0.01,0.986,0.9979316050744622,7235,7269
1,14604,10,100,0.001,0.01,0.968,0.9778827718433306,7290,7314
1,14704,10,100,0.001,0.01,0.982,0.9892546245919478,7344,7360
1,14804,10,100,0.001,0.01,0.984,0.9953390975412051,7396,7408
1,14904,10,100,0.001,0.01,0.984,0.9943639291465378,7449,7455
1,15004,10,100,0.001,0.01,0.982,0.9958011197014129,7501,7503
2,104,10,100,0.001,0.01,0.484,0.5192307692307693,54,50
2,204,10,100,0.001,0.01,0.518,0.6519607843137255,104,100
2,304,10,100,0.001,0.01,0.52,0.569078947368421,154,150
2,404,10,100,0.001,0.01,0.55,0.6262376237623762,195,209
2,504,10,100,0.001,0.01,0.5,0.5793650793650794,244,260
2,604,10,100,0.001,0.01,0.524,0.6307947019867549,295,309
2,704,10,100,0.001,0.01,0.53,0.6463068181818182,351,353
2,804,10,100,0.001,0.01,0.544,0.6592039800995025,405,399
2,904,10,100,0.001,0.01,0.56,0.6747787610619469,457,447
2,1004,10,100,0.001,0.01,0.552,0.6683266932270916,507,497
2,1104,10,100,0.001,0.01,0.552,0.6666666666666666,562,542
2,1204,10,100,0.001,0.01,0.544,0.7009966777408638,603,601
2,1304,10,100,0.001,0.01,0.516,0.6878834355828221,652,652
2,1404,10,100,0.001,0.01,0.55,0.7108262108262108,709,695
2,1504,10,100,0.001,0.01,0.524,0.7101063829787234,765,739
2,1604,10,100,0.001,0.01,0.554,0.7238154613466334,818,786
2,1704,10,100,0.001,0.01,0.522,0.7294600938967136,876,828
2,1804,10,100,0.001,0.01,0.56,0.761640798226164,930,874
2,1904,10,100,0.001,0.01,0.544,0.773109243697479,970,934
2,2004,10,100,0.001,0.01,0.55,0.781437125748503,1022,982
2,2104,10,100,0.001,0.01,0.568,0.7723384030418251,1076,1028
2,2204,10,100,0.001,0.01,0.572,0.7699637023593466,1123,1081
2,2304,10,100,0.001,0.01,0.586,0.8307291666666666,1172,1132
2,2404,10,100,0.001,0.01,0.608,0.8007487520798668,1209,1195
2,2504,10,100,0.001,0.01,0.604,0.8274760383386581,1260,1244
2,2604,10,100,0.001,0.01,0.598,0.8567588325652842,1306,1298
2,2704,10,100,0.001,0.01,0.614,0.8298816568047337,1360,1344
2,2804,10,100,0.001,0.01,0.596,0.8363052781740371,1414,1390
2,2904,10,100,0.001,0.01,0.638,0.8433195592286501,1463,1441
2,3004,10,100,0.001,0.01,0.658,0.8581890812250332,1512,1492
2,3104,10,100,0.001,0.01,0.628,0.8195876288659794,1566,1538
2,3204,10,100,0.001,0.01,0.652,0.8489388264669163,1604,1600
2,3304,10,100,0.001,0.01,0.682,0.8529055690072639,1647,1657
2,3404,10,100,0.001,0.01,0.674,0.881903642773208,1709,1695
2,3504,10,100,0.001,0.01,0.69,0.8584474885844748,1755,1749
2,3604,10,100,0.001,0.01,0.71,0.888457269700333,1805,1799
2,3704,10,100,0.001,0.01,0.716,0.8855291576673866,1840,1864
2,3804,10,100,0.001,0.01,0.716,0.867770767613039,1894,1910
2,3904,10,100,0.001,0.01,0.704,0.8783299180327869,1941,1963
2,4004,10,100,0.001,0.01,0.75,0.8778721278721279,1987,2017
2,4104,10,100,0.001,0.01,0.698,0.8944931773879142,2038,2066
2,4204,10,100,0.001,0.01,0.724,0.8794005708848716,2084,2120
2,4304,10,100,0.001,0.01,0.686,0.8183085501858736,2133,2171
2,4404,10,100,0.001,0.01,0.73,0.8458219800181653,2179,2225
2,4504,10,100,0.001,0.01,0.74,0.8581261101243339,2231,2273
2,4604,10,100,0.001,0.01,0.752,0.8607732406602954,2288,2316
2,4704,10,100,0.001,0.01,0.71,0.8382227891156463,2334,2370
2,4804,10,100,0.001,0.01,0.75,0.8807243963363863,2384,2420
2,4904,10,100,0.001,0.01,0.778,0.9106851549755302,2433,2471
2,5004,10,100,0.001,0.01,0.774,0.9092725819344525,2484,2520
2,5104,10,100,0.001,0.01,0.806,0.9220219435736677,2524,2580
2,5204,10,100,0.001,0.01,0.808,0.9208301306687163,2573,2631
2,5304,10,100,0.001,0.01,0.82,0.9226998491704375,2622,2682
2,5404,10,100,0.001,0.01,0.796,0.9243153219837158,2664,2740
2,5504,10,100,0.001,0.01,0.808,0.9331395348837209,2709,2795
2,5604,10,100,0.001,0.01,0.854,0.942005710206995,2764,2840
2,5704,10,100,0.001,0.01,0.84,0.9381136044880786,2814,2890
2,5804,10,100,0.001,0.01,0.854,0.9458993797381117,2862,2942
2,5904,10,100,0.001,0.01,0.846,0.9476626016260162,2913,2991
2,6004,10,100,0.001,0.01,0.836,0.9385409726848768,2957,3047
2,6104,10,100,0.001,0.01,0.808,0.9074377457404981,3009,3095
2,6204,10,100,0.001,0.01,0.86,0.9260154738878144,3051,3153
2,6304,10,100,0.001,0.01,0.834,0.944479695431472,3097,3207
2,6404,10,100,0.001,0.01,0.844,0.9373828856964397,3152,3252
2,6504,10,100,0.001,0.01,0.866,0.9609471094710947,3203,3301
2,6604,10,100,0.001,0.01,0.854,0.9562386432465173,3249,3355
2,6704,10,100,0.001,0.01,0.878,0.9503281622911695,3302,3402
2,6804,10,100,0.001,0.01,0.868,0.9657554379776602,3353,3451
2,6904,10,100,0.001,0.01,0.85,0.9416280417149478,3408,3496
2,7004,10,100,0.001,0.01,0.882,0.960451170759566,3457,3547
2,7104,10,100,0.001,0.01,0.884,0.9522804054054054,3505,3599
2,7204,10,100,0.001,0.01,0.894,0.9609938922820656,3559,3645
2,7304,10,100,0.001,0.01,0.88,0.9648138006571741,3606,3698
2,7404,10,100,0.001,0.01,0.906,0.9636682874122097,3667,3737
2,7504,10,100,0.001,0.01,0.888,0.9720149253731343,3718,3786
2,7604,10,100,0.001,0.01,0.844,0.9475276170436613,3770,3834
2,7704,10,100,0.001,0.01,0.866,0.9354880581516095,3827,3877
2,7804,10,100,0.001,0.01,0.866,0.9557919015889288,3881,3923
2,7904,10,100,0.001,0.01,0.884,0.9649544534412956,3926,3978
2,8004,10,100,0.001,0.01,0.9,0.9751374312843578,3983,4021
2,8104,10,100,0.001,0.01,0.892,0.9724827245804541,4024,4080
2,8204,10,100,0.001,0.01,0.9,0.9785470502194051,4075,4129
2,8304,10,100,0.001,0.01,0.906,0.9801300578034682,4127,4177
2,8404,10,100,0.001,0.01,0.88,0.9623988576868158,4179,4225
2,8504,10,100,0.001,0.01,0.914,0.970131702728128,4234,4270
2,8604,10,100,0.001,0.01,0.918,0.9762900976290098,4284,4320
2,8704,10,100,0.001,0.01,0.906,0.9692095588235294,4332,4372
2,8804,10,100,0.001,0.01,0.912,0.9766015447523853,4390,4414
2,8904,10,100,0.001,0.01,0.92,0.9806828391734053,4441,4463
2,9004,10,100,0.001,0.01,0.91,0.9783429586850289,4498,4506
2,9104,10,100,0.001,0.01,0.9,0.9646309314586995,4542,4562
2,9204,10,100,0.001,0.01,0.904,0.9696870925684485,4590,4614
2,9304,10,100,0.001,0.01,0.932,0.9807609630266552,4632,4672
2,9404,10,100,0.001,0.01,0.904,0.9510846448319864,4684,4720
2,9504,10,100,0.001,0.01,0.892,0.9529671717171717,4736,4768
2,9604,10,100,0.001,0.01,0.928,0.9779258642232403,4791,4813
2,9704,10,100,0.001,0.01,0.934,0.9836150041220115,4832,4872
2,9804,10,100,0.001,0.01,0.95,0.9905140758873929,4883,4921
2,9904,10,100,0.001,0.01,0.936,0.9820274636510501,4931,4973
2,10004,10,100,0.001,0.01,0.932,0.9813074770091963,4987,5017
2,10104,10,100,0.001,0.01,0.938,0.98743072050673,5038,5066
2,10204,10,100,0.001,0.01,0.944,0.9822618580948648,5093,5111
2,10304,10,100,0.001,0.01,0.918,0.9725349378881988,5141,5163
2,10404,10,100,0.001,0.01,0.926,0.9814494425221069,5182,5222
2,10504,10,100,0.001,0.01,0.948,0.9900990099009901,5236,5268
2,10604,10,100,0.001,0.01,0.948,0.9902866842700868,5287,5317
2,10704,10,100,0.001,0.01,0.96,0.9928064275037369,5349,5355
2,10804,10,100,0.001,0.01,0.952,0.986856719733432,5405,5399
2,10904,10,100,0.001,0.01,0.954,0.9857850330154072,5457,5447
2,11004,10,100,0.001,0.01,0.926,0.9800981461286805,5507,5497
2,11104,10,100,0.001,0.01,0.944,0.9769452449567724,5551,5553
2,11204,10,100,0.001,0.01,0.954,0.985540878257765,5605,5599
2,11304,10,100,0.001,0.01,0.948,0.9884111818825194,5652,5652
2,11404,10,100,0.001,0.01,0.956,0.9888635566467906,5699,5705
2,11504,10,100,0.001,0.01,0.948,0.9902642559109874,5753,5751
2,11604,10,100,0.001,0.01,0.954,0.9856084108927956,5794,5810
2,11704,10,100,0.001,0.01,0.952,0.9888072453861928,5838,5866
2,11804,10,100,0.001,0.01,0.958,0.9827177228058286,5889,5915
2,11904,10,100,0.001,0.01,0.954,0.9887432795698925,5935,5969
2,12004,10,100,0.001,0.01,0.958,0.981839386871043,5980,6024
2,12104,10,100,0.001,0.01,0.938,0.9804196959682749,6024,6080
2,12204,10,100,0.001,0.01,0.942,0.9755817764667322,6070,6134
2,12304,10,100,0.001,0.01,0.958,0.9846391417425228,6120,6184
2,12404,10,100,0.001,0.01,0.96,0.9864559819413092,6168,6236
2,12504,10,100,0.001,0.01,0.962,0.9929622520793346,6221,6283
2,12604,10,100,0.001,0.01,0.968,0.9919866708981275,6272,6332
2,12704,10,100,0.001,0.01,0.948,0.9761492443324937,6330,6374
2,12804,10,100,0.001,0.01,0.956,0.9915651358950328,6376,6428
2,12904,10,100,0.001,0.01,0.962,0.990623062616243,6429,6475
2,13004,10,100,0.001,0.01,0.968,0.9936173485081513,6482,6522
2,13104,10,100,0.001,0.01,0.964,0.9916819291819292,6537,6567
2,13204,10,100,0.001,0.01,0.96,0.997046349591033,6593,6611
2,13304,10,100,0.001,0.01,0.974,0.9953397474443776,6646,6658
2,13404,10,100,0.001,0.01,0.972,0.9926887496269771,6700,6704
2,13504,10,100,0.001,0.01,0.968,0.9894845971563981,6753,6751
2,13604,10,100,0.001,0.01,0.976,0.9940458688620993,6804,6800
2,13704,10,100,0.001,0.01,0.97,0.9886894337419732,6853,6851
2,13804,10,100,0.001,0.01,0.978,0.9877571718342509,6901,6903
2,13904,10,100,0.001,0.01,0.972,0.9930955120828538,6955,6949
2,14004,10,100,0.001,0.01,0.97,0.9950014281633819,7005,6999
2,14104,10,100,0.001,0.01,0.978,0.9924134997163925,7054,7050
2,14204,10,100,0.001,0.01,0.982,0.9955646296817798,7109,7095
2,14304,10,100,0.001,0.01,0.988,0.9935682326621924,7161,7143
2,14404,10,100,0.001,0.01,0.972,0.989516800888642,7214,7190
2,14504,10,100,0.001,0.01,0.964,0.988761720904578,7267,7237
2,14604,10,100,0.001,0.01,0.972,0.9953437414407011,7317,7287
2,14704,10,100,0.001,0.01,0.97,0.9927230685527747,7368,7336
2,14804,10,100,0.001,0.01,0.974,0.9908808430154012,7418,7386
2,14904,10,100,0.001,0.01,0.978,0.9893317230273752,7466,7438
2,15004,10,100,0.001,0.01,0.984,0.9898027192748601,7510,7494
3,104,10,100,0.001,0.01,0.524,0.6442307692307693,47,57
3,204,10,100,0.001,0.01,0.528,0.7156862745098039,100,104
3,304,10,100,0.001,0.01,0.524,0.7203947368421053,154,150
3,404,10,100,0.001,0.01,0.494,0.6014851485148515,206,198
3,504,10,100,0.001,0.01,0.516,0.623015873015873,257,247
3,604,10,100,0.001,0.01,0.474,0.6655629139072847,307,297
3,704,10,100,0.001,0.01,0.494,0.6079545454545454,350,354
3,804,10,100,0.001,0.01,0.492,0.6529850746268657,409,395
3,904,10,100,0.001,0.01,0.486,0.668141592920354,458,446
3,1004,10,100,0.001,0.01,0.464,0.6852589641434262,499,505
3,1104,10,100,0.001,0.01,0.47,0.6557971014492754,549,555
3,1204,10,100,0.001,0.01,0.502,0.6735880398671097,612,592
3,1304,10,100,0.001,0.01,0.502,0.6648773006134969,661,643
3,1404,10,100,0.001,0.01,0.502,0.6894586894586895,716,688
3,1504,10,100,0.001,0.01,0.528,0.694813829787234,772,732
3,1604,10,100,0.001,0.01,0.562,0.722568578553616,821,783
3,1704,10,100,0.001,0.01,0.518,0.7183098591549296,861,843
3,1804,10,100,0.001,0.01,0.542,0.725609756097561,904,900
3,1904,10,100,0.001,0.01,0.552,0.7016806722689075,951,953
3,2004,10,100,0.001,0.01,0.524,0.7574850299401198,1004,1000
3,2104,10,100,0.001,0.01,0.524,0.745722433460076,1052,1052
3,2204,10,100,0.001,0.01,0.53,0.7568058076225045,1107,1097
3,2304,10,100,0.001,0.01,0.538,0.7534722222222222,1157,1147
3,2404,10,100,0.001,0.01,0.546,0.7820299500831946,1211,1193
3,2504,10,100,0.001,0.01,0.566,0.7855431309904153,1257,1247
3,2604,10,100,0.001,0.01,0.566,0.804915514592934,1308,1296
3,2704,10,100,0.001,0.01,0.552,0.8076923076923077,1361,1343
3,2804,10,100,0.001,0.01,0.586,0.7785306704707561,1401,1403
3,2904,10,100,0.001,0.01,0.606,0.7830578512396694,1450,1454
3,3004,10,100,0.001,0.01,0.638,0.8262316910785619,1505,1499
3,3104,10,100,0.001,0.01,0.584,0.8147551546391752,1560,1544
3,3204,10,100,0.001,0.01,0.594,0.8227215980024969,1608,1596
3,3304,10,100,0.001,0.01,0.57,0.8162832929782082,1653,1651
3,3404,10,100,0.001,0.01,0.604,0.8319623971797885,1700,1704
3,3504,10,100,0.001,0.01,0.618,0.8467465753424658,1749,1755
3,3604,10,100,0.001,0.01,0.604,0.8457269700332963,1795,1809
3,3704,10,100,0.001,0.01,0.604,0.8453023758099352,1844,1860
3,3804,10,100,0.001,0.01,0.616,0.849894847528917,1895,1909
3,3904,10,100,0.001,0.01,0.63,0.8575819672131147,1948,1956
3,4004,10,100,0.001,0.01,0.614,0.8523976023976024,1995,2009
3,4104,10,100,0.001,0.01,0.626,0.8503898635477583,2049,2055
3,4204,10,100,0.001,0.01,0.62,0.8568030447193149,2101,2103
3,4304,10,100,0.001,0.01,0.658,0.8759293680297398,2163,2141
3,4404,10,100,0.001,0.01,0.614,0.8599000908265213,2207,2197
3,4504,10,100,0.001,0.01,0.634,0.8423623445825933,2256,2248
3,4604,10,100,0.001,0.01,0.656,0.854257167680278,2306,2298
3,4704,10,100,0.001,0.01,0.614,0.8197278911564626,2362,2342
3,4804,10,100,0.001,0.01,0.674,0.8580349708576187,2418,2386
3,4904,10,100,0.001,0.01,0.654,0.8542006525285482,2472,2432
3,5004,10,100,0.001,0.01,0.656,0.8729016786570744,2524,2480
3,5104,10,100,0.001,0.01,0.664,0.8781347962382445,2580,2524
3,5204,10,100,0.001,0.01,0.672,0.8870099923136049,2634,2570
3,5304,10,100,0.001,0.01,0.646,0.8684012066365008,2680,2624
3,5404,10,100,0.001,0.01,0.696,0.8799037749814952,2725,2679
3,5504,10,100,0.001,0.01,0.654,0.8740915697674418,2769,2735
3,5604,10,100,0.001,0.01,0.67,0.882762312633833,2819,2785
3,5704,10,100,0.001,0.01,0.714,0.8904277699859747,2873,2831
3,5804,10,100,0.001,0.01,0.708,0.9054100620261888,2917,2887
3,5904,10,100,0.001,0.01,0.718,0.9063346883468835,2969,2935
3,6004,10,100,0.001,0.01,0.722,0.8935709526982012,3029,2975
3,6104,10,100,0.001,0.01,0.728,0.8961336828309305,3083,3021
3,6204,10,100,0.001,0.01,0.732,0.8970019342359767,3131,3073
3,6304,10,100,0.001,0.01,0.726,0.8941941624365483,3184,3120
3,6404,10,100,0.001,0.01,0.738,0.8947532792004997,3235,3169
3,6504,10,100,0.001,0.01,0.7,0.8965252152521526,3283,3221
3,6604,10,100,0.001,0.01,0.73,0.9097516656571775,3325,3279
3,6704,10,100,0.001,0.01,0.758,0.9207935560859188,3377,3327
3,6804,10,100,0.001,0.01,0.73,0.9063786008230452,3423,3381
3,6904,10,100,0.001,0.01,0.722,0.9068655851680185,3471,3433
3,7004,10,100,0.001,0.01,0.718,0.8923472301541976,3514,3490
3,7104,10,100,0.001,0.01,0.73,0.8951295045045045,3559,3545
3,7204,10,100,0.001,0.01,0.708,0.897140477512493,3608,3596
3,7304,10,100,0.001,0.01,0.736,0.9086801752464403,3656,3648
3,7404,10,100,0.001,0.01,0.732,0.924365207995678,3708,3696
3,7504,10,100,0.001,0.01,0.7,0.9167110874200426,3754,3750
3,7604,10,100,0.001,0.01,0.714,0.9155707522356654,3809,3795
3,7704,10,100,0.001,0.01,0.752,0.9147196261682243,3864,3840
3,7804,10,100,0.001,0.01,0.766,0.9151717068170169,3918,3886
3,7904,10,100,0.001,0.01,0.75,0.9121963562753036,3964,3940
3,8004,10,100,0.001,0.01,0.75,0.9240379810094953,4009,3995
3,8104,10,100,0.001,0.01,0.776,0.930528134254689,4054,4050
3,8204,10,100,0.001,0.01,0.778,0.9101657727937591,4106,4098
3,8304,10,100,0.001,0.01,0.722,0.865606936416185,4166,4138
3,8404,10,100,0.001,0.01,0.766,0.8955259400285578,4219,4185
3,8504,10,100,0.001,0.01,0.774,0.9188617121354656,4262,4242
3,8604,10,100,0.001,0.01,0.772,0.9069037656903766,4310,4294
3,8704,10,100,0.001,0.01,0.756,0.8829273897058824,4360,4344
3,8804,10,100,0.001,0.01,0.782,0.904020899591095,4412,4392
3,8904,10,100,0.001,0.01,0.772,0.9042003593890386,4461,4443
3,9004,10,100,0.001,0.01,0.778,0.9133718347401155,4508,4496
3,9104,10,100,0.001,0.01,0.756,0.8914762741652021,4547,4557
3,9204,10,100,0.001,0.01,0.766,0.9010212950890917,4600,4604
3,9304,10,100,0.001,0.01,0.772,0.9029449699054171,4646,4658
3,9404,10,100,0.001,0.01,0.754,0.9183326244151425,4695,4709
3,9504,10,100,0.001,0.01,0.798,0.9252946127946128,4747,4757
3,9604,10,100,0.001,0.01,0.81,0.9174302374010829,4796,4808
3,9704,10,100,0.001,0.01,0.794,0.919517724649629,4852,4852
3,9804,10,100,0.001,0.01,0.788,0.9226846185230518,4903,4901
3,9904,10,100,0.001,0.01,0.772,0.9047859450726979,4957,4947
3,10004,10,100,0.001,0.01,0.796,0.9243302678928429,5015,4989
3,10104,10,100,0.001,0.01,0.78,0.9320071258907363,5059,5045
3,10204,10,100,0.001,0.01,0.794,0.9271854174833398,5111,5093
3,10304,10,100,0.001,0.01,0.79,0.922263198757764,5160,5144
3,10404,10,100,0.001,0.01,0.776,0.9199346405228758,5204,5200
3,10504,10,100,0.001,0.01,0.808,0.9382140137090632,5242,5262
3,10604,10,100,0.001,0.01,0.82,0.9325726141078838,5298,5306
3,10704,10,100,0.001,0.01,0.788,0.9289050822122571,5351,5353
3,10804,10,100,0.001,0.01,0.828,0.9398370973713439,5398,5406
3,10904,10,100,0.001,0.01,0.832,0.9436903888481292,5444,5460
3,11004,10,100,0.001,0.01,0.818,0.9363867684478372,5500,5504
3,11104,10,100,0.001,0.01,0.808,0.9462355907780979,5552,5552
3,11204,10,100,0.001,0.01,0.83,0.9518029275258836,5595,5609
3,11304,10,100,0.001,0.01,0.824,0.9472753007784855,5643,5661
3,11404,10,100,0.001,0.01,0.826,0.9461592423710978,5693,5711
3,11504,10,100,0.001,0.01,0.834,0.9508866481223922,5736,5768
3,11604,10,100,0.001,0.01,0.82,0.9494139951740779,5794,5810
3,11704,10,100,0.001,0.01,0.818,0.939935064935065,5845,5859
3,11804,10,100,0.001,0.01,0.824,0.9388342934598441,5894,5910
3,11904,10,100,0.001,0.01,0.826,0.9411122311827957,5950,5954
3,12004,10,100,0.001,0.01,0.846,0.9484338553815395,6001,6003
3,12104,10,100,0.001,0.01,0.842,0.9437376074025116,6053,6051
3,12204,10,100,0.001,0.01,0.84,0.9319075712881023,6104,6100
3,12304,10,100,0.001,0.01,0.832,0.9097041612483745,6157,6147
3,12404,10,100,0.001,0.01,0.836,0.9335698161883264,6207,6197
3,12504,10,100,0.001,0.01,0.866,0.9539347408829175,6258,6246
3,12604,10,100,0.001,0.01,0.858,0.946445572834021,6302,6302
3,12704,10,100,0.001,0.01,0.85,0.9389955919395466,6351,6353
3,12804,10,100,0.001,0.01,0.854,0.9512652296157451,6402,6402
3,12904,10,100,0.001,0.01,0.872,0.963034717916925,6453,6451
3,13004,10,100,0.001,0.01,0.85,0.9546293448169794,6503,6501
3,13104,10,100,0.001,0.01,0.874,0.9426129426129426,6555,6549
3,13204,10,100,0.001,0.01,0.866,0.9616025446834293,6600,6604
3,13304,10,100,0.001,0.01,0.858,0.9567799158147925,6649,6655
3,13404,10,100,0.001,0.01,0.856,0.9500895255147717,6705,6699
3,13504,10,100,0.001,0.01,0.878,0.9639366113744076,6759,6745
3,13604,10,100,0.001,0.01,0.884,0.9631725962952072,6809,6795
3,13704,10,100,0.001,0.01,0.878,0.9578225335668418,6855,6849
3,13804,10,100,0.001,0.01,0.866,0.9580556360475224,6905,6899
3,13904,10,100,0.001,0.01,0.888,0.9661248561565017,6948,6956
3,14004,10,100,0.001,0.01,0.882,0.9727934875749786,6995,7009
3,14104,10,100,0.001,0.01,0.88,0.9489506522972206,7047,7057
3,14204,10,100,0.001,0.01,0.892,0.9578991833286398,7097,7107
3,14304,10,100,0.001,0.01,0.86,0.9569351230425056,7147,7157
3,14404,10,100,0.001,0.01,0.886,0.9631352402110525,7197,7207
3,14504,10,100,0.001,0.01,0.88,0.964561500275786,7243,7261
3,14604,10,100,0.001,0.01,0.878,0.9571350314982197,7295,7309
3,14704,10,100,0.001,0.01,0.898,0.9697361262241567,7347,7357
3,14804,10,100,0.001,0.01,0.902,0.9695352607403405,7407,7397
3,14904,10,100,0.001,0.01,0.91,0.9750402576489533,7452,7452
3,15004,10,100,0.001,0.01,0.892,0.9553452412689949,7500,7504
4,104,10,100,0.001,0.01,0.514,0.5769230769230769,53,51
4,204,10,100,0.001,0.01,0.5,0.5588235294117647,105,99
4,304,10,100,0.001,0.01,0.53,0.6381578947368421,157,147
4,404,10,100,0.001,0.01,0.516,0.5915841584158416,208,196
4,504,10,100,0.001,0.01,0.532,0.6329365079365079,254,250
4,604,10,100,0.001,0.01,0.536,0.6009933774834437,305,299
4,704,10,100,0.001,0.01,0.536,0.6335227272727273,349,355
4,804,10,100,0.001,0.01,0.53,0.6492537313432836,397,407
4,904,10,100,0.001,0.01,0.48,0.6559734513274337,449,455
4,1004,10,100,0.001,0.01,0.496,0.6683266932270916,504,500
4,1104,10,100,0.001,0.01,0.524,0.6612318840579711,550,554
4,1204,10,100,0.001,0.01,0.53,0.7059800664451827,601,603
4,1304,10,100,0.001,0.01,0.518,0.7124233128834356,652,652
4,1404,10,100,0.001,0.01,0.526,0.7250712250712251,702,702
4,1504,10,100,0.001,0.01,0.538,0.726063829787234,760,744
4,1604,10,100,0.001,0.01,0.544,0.7562344139650873,819,785
4,1704,10,100,0.001,0.01,0.55,0.767018779342723,867,837
4,1804,10,100,0.001,0.01,0.538,0.7849223946784922,925,879
4,1904,10,100,0.001,0.01,0.564,0.8009453781512605,969,935
4,2004,10,100,0.001,0.01,0.576,0.7869261477045908,1014,990
4,2104,10,100,0.001,0.01,0.582,0.8236692015209125,1067,1037
4,2204,10,100,0.001,0.01,0.596,0.822141560798548,1112,1092
4,2304,10,100,0.001,0.01,0.58,0.7721354166666666,1157,1147
4,2404,10,100,0.001,0.01,0.556,0.7712146422628952,1201,1203
4,2504,10,100,0.001,0.01,0.562,0.7767571884984026,1254,1250
4,2604,10,100,0.001,0.01,0.612,0.815668202764977,1306,1298
4,2704,10,100,0.001,0.01,0.596,0.8099112426035503,1363,1341
4,2804,10,100,0.001,0.01,0.644,0.8519971469329529,1416,1388
4,2904,10,100,0.001,0.01,0.654,0.8791322314049587,1466,1438
4,3004,10,100,0.001,0.01,0.688,0.8831557922769641,1508,1496
4,3104,10,100,0.001,0.01,0.66,0.8505154639175257,1555,1549
4,3204,10,100,0.001,0.01,0.678,0.8739076154806492,1610,1594
4,3304,10,100,0.001,0.01,0.686,0.8801452784503632,1666,1638
4,3404,10,100,0.001,0.01,0.692,0.8954171562867215,1720,1684
4,3504,10,100,0.001,0.01,0.714,0.915810502283105,1758,1746
4,3604,10,100,0.001,0.01,0.748,0.9267480577136515,1811,1793
4,3704,10,100,0.001,0.01,0.762,0.9190064794816415,1870,1834
4,3804,10,100,0.001,0.01,0.734,0.9103575184016824,1917,1887
4,3904,10,100,0.001,0.01,0.768,0.9175204918032787,1974,1930
4,4004,10,100,0.001,0.01,0.754,0.9085914085914086,2025,1979
4,4104,10,100,0.001,0.01,0.746,0.8757309941520468,2064,2040
4,4204,10,100,0.001,0.01,0.758,0.9074690770694577,2112,2092
4,4304,10,100,0.001,0.01,0.776,0.9217007434944238,2158,2146
4,4404,10,100,0.001,0.01,0.81,0.9514078110808356,2203,2201
4,4504,10,100,0.001,0.01,0.82,0.9600355239786856,2256,2248
4,4604,10,100,0.001,0.01,0.818,0.9569939183318853,2309,2295
4,4704,10,100,0.001,0.01,0.84,0.9685374149659864,2358,2346
4,4804,10,100,0.001,0.01,0.844,0.9725228975853455,2408,2396
4,4904,10,100,0.001,0.01,0.844,0.9692088091353996,2463,2441
4,5004,10,100,0.001,0.01,0.854,0.9678257394084733,2509,2495
4,5104,10,100,0.001,0.01,0.858,0.9551332288401254,2565,2539
4,5204,10,100,0.001,0.01,0.854,0.9396617986164489,2612,2592
4,5304,10,100,0.001,0.01,0.874,0.9498491704374057,2664,2640
4,5404,10,100,0.001,0.01,0.884,0.9692820133234641,2715,2689
4,5504,10,100,0.001,0.01,0.908,0.9791061046511628,2767,2737
4,5604,10,100,0.001,0.01,0.918,0.9809064953604568,2819,2785
4,5704,10,100,0.001,0.01,0.898,0.9761570827489481,2875,2829
4,5804,10,100,0.001,0.01,0.896,0.9734665747760165,2916,2888
4,5904,10,100,0.001,0.01,0.908,0.9806910569105691,2970,2934
4,6004,10,100,0.001,0.01,0.922,0.9808461025982678,3011,2993
4,6104,10,100,0.001,0.01,0.932,0.9878768020969856,3055,3049
4,6204,10,100,0.001,0.01,0.906,0.9761444229529336,3102,3102
4,6304,10,100,0.001,0.01,0.926,0.9860406091370558,3159,3145
4,6404,10,100,0.001,0.01,0.918,0.981261711430356,3199,3205
4,6504,10,100,0.001,0.01,0.928,0.9918511685116851,3253,3251
4,6604,10,100,0.001,0.01,0.908,0.9859176256814052,3304,3300
4,6704,10,100,0.001,0.01,0.924,0.9862768496420048,3354,3350
4,6804,10,100,0.001,0.01,0.916,0.9911816578483245,3404,3400
4,6904,10,100,0.001,0.01,0.934,0.9884125144843569,3452,3452
4,7004,10,100,0.001,0.01,0.926,0.9868646487721302,3506,3498
4,7104,10,100,0.001,0.01,0.932,0.9911317567567568,3553,3551
4,7204,10,100,0.001,0.01,0.928,0.9825097168239867,3600,3604
4,7304,10,100,0.001,0.01,0.93,0.989184008762322,3646,3658
4,7404,10,100,0.001,0.01,0.952,0.9890599675850892,3696,3708
4,7504,10,100,0.001,0.01,0.95,0.9840085287846482,3752,3752
4,7604,10,100,0.001,0.01,0.936,0.9798790110468175,3803,3801
4,7704,10,100,0.001,0.01,0.946,0.9855919003115264,3843,3861
4,7804,10,100,0.001,0.01,0.942,0.980138390568939,3899,3905
4,7904,10,100,0.001,0.01,0.936,0.9876012145748988,3953,3951
4,8004,10,100,0.001,0.01,0.948,0.985632183908046,4010,3994
4,8104,10,100,0.001,0.01,0.96,0.9907453109575518,4055,4049
4,8204,10,100,0.001,0.01,0.958,0.9906143344709898,4098,4106
4,8304,10,100,0.001,0.01,0.952,0.9890414258188824,4149,4155
4,8404,10,100,0.001,0.01,0.968,0.9946454069490719,4184,4220
4,8504,10,100,0.001,0.01,0.966,0.9958842897460018,4228,4276
4,8604,10,100,0.001,0.01,0.962,0.9953509995351,4283,4321
4,8704,10,100,0.001,0.01,0.964,0.9849494485294118,4334,4370
4,8804,10,100,0.001,0.01,0.958,0.9886415265788278,4379,4425
4,8904,10,100,0.001,0.01,0.972,0.9919137466307277,4435,4469
4,9004,10,100,0.001,0.01,0.942,0.9827854286983563,4485,4519
4,9104,10,100,0.001,0.01,0.946,0.976603690685413,4538,4566
4,9204,10,100,0.001,0.01,0.962,0.9880486744893524,4591,4613
4,9304,10,100,0.001,0.01,0.948,0.9814058469475494,4640,4664
4,9404,10,100,0.001,0.01,0.966,0.99096129306678,4698,4706
4,9504,10,100,0.001,0.01,0.962,0.9888468013468014,4741,4763
4,9604,10,100,0.001,0.01,0.982,0.9925031236984589,4784,4820
4,9704,10,100,0.001,0.01,0.964,0.9945383347073372,4832,4872
4,9804,10,100,0.001,0.01,0.978,0.9946960424316605,4880,4924
4,9904,10,100,0.001,0.01,0.964,0.992124394184168,4923,4981
4,10004,10,100,0.001,0.01,0.974,0.992702918832467,4976,5028
4,10104,10,100,0.001,0.01,0.974,0.9958432304038005,5027,5077
4,10204,10,100,0.001,0.01,0.97,0.9828498627989024,5078,5126
4,10304,10,100,0.001,0.01,0.96,0.9758346273291926,5125,5179
4,10404,10,100,0.001,0.01,0.964,0.9819300269127259,5175,5229
4,10504,10,100,0.001,0.01,0.974,0.9869573495811119,5228,5276
4,10604,10,100,0.001,0.01,0.974,0.9933044134288948,5278,5326
4,10704,10,100,0.001,0.01,0.968,0.9957025411061285,5325,5379
4,10804,10,100,0.001,0.01,0.976,0.9956497593483895,5375,5429
4,10904,10,100,0.001,0.01,0.976,0.9946808510638298,5426,5478
4,11004,10,100,0.001,0.01,0.976,0.9943656852053798,5482,5522
4,11104,10,100,0.001,0.01,0.978,0.9943263688760807,5536,5568
4,11204,10,100,0.001,0.01,0.974,0.9952695465905034,5590,5614
4,11304,10,100,0.001,0.01,0.974,0.9940728945506015,5636,5668
4,11404,10,100,0.001,0.01,0.974,0.9947386881795861,5678,5726
4,11504,10,100,0.001,0.01,0.98,0.9962621696801113,5726,5778
4,11604,10,100,0.001,0.01,0.986,0.9942261289210617,5780,5824
4,11704,10,100,0.001,0.01,0.966,0.9863294600136705,5830,5874
4,11804,10,100,0.001,0.01,0.968,0.9927990511690952,5885,5919
4,11904,10,100,0.001,0.01,0.976,0.9921875,5937,5967
4,12004,10,100,0.001,0.01,0.966,0.9888370543152283,5990,6014
4,12104,10,100,0.001,0.01,0.976,0.9903337739590218,6041,6063
4,12204,10,100,0.001,0.01,0.976,0.9896755162241888,6094,6110
4,12304,10,100,0.001,0.01,0.972,0.9960988296488946,6149,6155
4,12404,10,100,0.001,0.01,0.966,0.982263785875524,6198,6206
4,12504,10,100,0.001,0.01,0.984,0.9950415866922585,6243,6261
4,12604,10,100,0.001,0.01,0.974,0.9865915582354808,6295,6309
4,12704,10,100,0.001,0.01,0.982,0.9891372795969773,6350,6354
4,12804,10,100,0.001,0.01,0.976,0.9915651358950328,6398,6406
4,12904,10,100,0.001,0.01,0.98,0.9943428394296342,6446,6458
4,13004,10,100,0.001,0.01,0.974,0.9949246385727468,6501,6503
4,13104,10,100,0.001,0.01,0.98,0.9967185592185592,6559,6545
4,13204,10,100,0.001,0.01,0.974,0.9966676764616783,6610,6594
4,13304,10,100,0.001,0.01,0.978,0.9878232110643416,6659,6645
4,13404,10,100,0.001,0.01,0.958,0.9791853178155775,6708,6696
4,13504,10,100,0.001,0.01,0.98,0.9928909952606635,6764,6740
4,13604,10,100,0.001,0.01,0.968,0.988900323434284,6809,6795
4,13704,10,100,0.001,0.01,0.982,0.9905137186223001,6862,6842
4,13804,10,100,0.001,0.01,0.984,0.9939872500724428,6905,6899
4,13904,10,100,0.001,0.01,0.978,0.9889959723820483,6948,6956
4,14004,10,100,0.001,0.01,0.98,0.993573264781491,6998,7006
4,14104,10,100,0.001,0.01,0.98,0.994895065229722,7047,7057
4,14204,10,100,0.001,0.01,0.974,0.9963390594198818,7094,7110
4,14304,10,100,0.001,0.01,0.986,0.9965044742729307,7149,7155
4,14404,10,100,0.001,0.01,0.974,0.9868092196612053,7203,7201
4,14504,10,100,0.001,0.01,0.976,0.9921400992829564,7249,7255
4,14604,10,100,0.001,0.01,0.98,0.989249520679266,7294,7310
4,14704,10,100,0.001,0.01,0.972,0.9911588683351469,7340,7364
4,14804,10,100,0.001,0.01,0.986,0.9899351526614428,7389,7415
4,14904,10,100,0.001,0.01,0.99,0.9925523349436393,7447,7457
4,15004,10,100,0.001,0.01,0.952,0.9730738469741402,7504,7500
5,104,10,100,0.001,0.01,0.452,0.5096153846153846,53,51
5,204,10,100,0.001,0.01,0.534,0.6274509803921569,117,87
5,304,10,100,0.001,0.01,0.52,0.6907894736842105,168,136
5,404,10,100,0.001,0.01,0.466,0.6014851485148515,220,184
5,504,10,100,0.001,0.01,0.558,0.6408730158730159,271,233
5,604,10,100,0.001,0.01,0.55,0.6589403973509934,326,278
5,704,10,100,0.001,0.01,0.54,0.6278409090909091,372,332
5,804,10,100,0.001,0.01,0.556,0.6878109452736318,418,386
5,904,10,100,0.001,0.01,0.546,0.6670353982300885,465,439
5,1004,10,100,0.001,0.01,0.544,0.701195219123506,508,496
5,1104,10,100,0.001,0.01,0.514,0.6875,552,552
5,1204,10,100,0.001,0.01,0.498,0.6960132890365448,598,606
5,1304,10,100,0.001,0.01,0.54,0.6817484662576687,650,654
5,1404,10,100,0.001,0.01,0.552,0.6923076923076923,696,708
5,1504,10,100,0.001,0.01,0.544,0.7340425531914894,751,753
5,1604,10,100,0.001,0.01,0.518,0.7506234413965087,805,799
5,1704,10,100,0.001,0.01,0.54,0.7323943661971831,849,855
5,1804,10,100,0.001,0.01,0.54,0.7472283813747228,899,905
5,1904,10,100,0.001,0.01,0.526,0.7384453781512605,945,959
5,2004,10,100,0.001,0.01,0.502,0.7639720558882236,987,1017
5,2104,10,100,0.001,0.01,0.532,0.7614068441064639,1043,1061
5,2204,10,100,0.001,0.01,0.53,0.7608892921960072,1089,1115
5,2304,10,100,0.001,0.01,0.502,0.7517361111111112,1139,1165
5,2404,10,100,0.001,0.01,0.528,0.800332778702163,1185,1219
5,2504,10,100,0.001,0.01,0.57,0.8067092651757188,1231,1273
5,2604,10,100,0.001,0.01,0.536,0.793010752688172,1288,1316
5,2704,10,100,0.001,0.01,0.564,0.7892011834319527,1327,1377
5,2804,10,100,0.001,0.01,0.588,0.8223965763195435,1379,1425
5,2904,10,100,0.001,0.01,0.61,0.8240358126721763,1430,1474
5,3004,10,100,0.001,0.01,0.636,0.7886151797603196,1481,1523
5,3104,10,100,0.001,0.01,0.598,0.7941365979381443,1531,1573
5,3204,10,100,0.001,0.01,0.64,0.8323970037453183,1572,1632
5,3304,10,100,0.001,0.01,0.624,0.8389830508474576,1622,1682
5,3404,10,100,0.001,0.01,0.652,0.8539952996474736,1680,1724
5,3504,10,100,0.001,0.01,0.666,0.8610159817351598,1730,1774
5,3604,10,100,0.001,0.01,0.672,0.8704217536071032,1778,1826
5,3704,10,100,0.001,0.01,0.66,0.8428725701943844,1831,1873
5,3804,10,100,0.001,0.01,0.662,0.8664563617245006,1880,1924
5,3904,10,100,0.001,0.01,0.686,0.8565573770491803,1935,1969
5,4004,10,100,0.001,0.01,0.682,0.8738761238761239,1981,2023
5,4104,10,100,0.001,0.01,0.684,0.8969298245614035,2030,2074
5,4204,10,100,0.001,0.01,0.688,0.8965271170313986,2079,2125
5,4304,10,100,0.001,0.01,0.714,0.8986988847583643,2139,2165
5,4404,10,100,0.001,0.01,0.736,0.90236148955495,2185,2219
5,4504,10,100,0.001,0.01,0.732,0.9038632326820604,2240,2264
5,4604,10,100,0.001,0.01,0.716,0.8757602085143353,2292,2312
5,4704,10,100,0.001,0.01,0.708,0.8505527210884354,2337,2367
5,4804,10,100,0.001,0.01,0.756,0.8850957535387177,2384,2420
5,4904,10,100,0.001,0.01,0.754,0.8964110929853181,2442,2462
5,5004,10,100,0.001,0.01,0.754,0.9138689048760992,2493,2511
5,5104,10,100,0.001,0.01,0.748,0.9071316614420063,2542,2562
5,5204,10,100,0.001,0.01,0.688,0.8616448885472713,2588,2616
5,5304,10,100,0.001,0.01,0.702,0.8559577677224736,2635,2669
5,5404,10,100,0.001,0.01,0.738,0.8743523316062176,2677,2727
5,5504,10,100,0.001,0.01,0.732,0.8900799418604651,2728,2776
5,5604,10,100,0.001,0.01,0.756,0.9129193433261956,2771,2833
5,5704,10,100,0.001,0.01,0.784,0.9135694249649369,2820,2884
5,5804,10,100,0.001,0.01,0.766,0.9212611991729841,2874,2930
5,5904,10,100,0.001,0.01,0.764,0.9220867208672087,2917,2987
5,6004,10,100,0.001,0.01,0.762,0.8882411725516323,2978,3026
5,6104,10,100,0.001,0.01,0.78,0.9175950196592398,3033,3071
5,6204,10,100,0.001,0.01,0.768,0.9258542875564152,3089,3115
5,6304,10,100,0.001,0.01,0.786,0.9216370558375635,3144,3160
5,6404,10,100,0.001,0.01,0.782,0.9312929419113054,3189,3215
5,6504,10,100,0.001,0.01,0.788,0.9271217712177122,3236,3268
5,6604,10,100,0.001,0.01,0.794,0.9312537855844942,3287,3317
5,6704,10,100,0.001,0.01,0.804,0.9315334128878282,3340,3364
5,6804,10,100,0.001,0.01,0.764,0.9221046443268666,3380,3424
5,6904,10,100,0.001,0.01,0.768,0.9267091541135574,3435,3469
5,7004,10,100,0.001,0.01,0.786,0.9347515705311251,3495,3509
5,7104,10,100,0.001,0.01,0.782,0.9375,3551,3553
5,7204,10,100,0.001,0.01,0.78,0.9390616324264298,3600,3604
5,7304,10,100,0.001,0.01,0.78,0.9459200438116101,3649,3655
5,7404,10,100,0.001,0.01,0.8,0.949216639654241,3689,3715
5,7504,10,100,0.001,0.01,0.796,0.9449626865671642,3748,3756
5,7604,10,100,0.001,0.01,0.772,0.9153077327722251,3794,3810
5,7704,10,100,0.001,0.01,0.806,0.9079698857736241,3850,3854
5,7804,10,100,0.001,0.01,0.788,0.9347770374167094,3896,3908
5,7904,10,100,0.001,0.01,0.79,0.9305414979757085,3953,3951
5,8004,10,100,0.001,0.01,0.792,0.9280359820089955,4006,3998
5,8104,10,100,0.001,0.01,0.81,0.9489141164856861,4055,4049
5,8204,10,100,0.001,0.01,0.796,0.9306435884934179,4102,4102
5,8304,10,100,0.001,0.01,0.808,0.9273843930635838,4146,4158
5,8404,10,100,0.001,0.01,0.812,0.9420514040932889,4199,4205
5,8504,10,100,0.001,0.01,0.802,0.948612417685795,4252,4252
5,8604,10,100,0.001,0.01,0.79,0.9347977684797768,4301,4303
5,8704,10,100,0.001,0.01,0.756,0.9055606617647058,4345,4359
5,8804,10,100,0.001,0.01,0.79,0.9360517946388005,4392,4412
5,8904,10,100,0.001,0.01,0.81,0.9481132075471698,4445,4459
5,9004,10,100,0.001,0.01,0.796,0.9431363838294091,4497,4507
5,9104,10,100,0.001,0.01,0.8,0.9388181019332161,4546,4558
5,9204,10,100,0.001,0.01,0.778,0.941438504997827,4600,4604
5,9304,10,100,0.001,0.01,0.794,0.8987532244196045,4644,4660
5,9404,10,100,0.001,0.01,0.812,0.9355593364525734,4690,4714
5,9504,10,100,0.001,0.01,0.816,0.9437079124579124,4740,4764
5,9604,10,100,0.001,0.01,0.802,0.9372136609745939,4799,4805
5,9704,10,100,0.001,0.01,0.816,0.9494023083264633,4852,4852
5,9804,10,100,0.001,0.01,0.812,0.9493064055487556,4898,4906
5,9904,10,100,0.001,0.01,0.796,0.9418416801292407,4938,4966
5,10004,10,100,0.001,0.01,0.814,0.9433226709316274,4994,5010
5,10104,10,100,0.001,0.01,0.806,0.9484362628661916,5048,5056
5,10204,10,100,0.001,0.01,0.808,0.9486475891807135,5094,5110
5,10304,10,100,0.001,0.01,0.81,0.9548718944099379,5141,5163
5,10404,10,100,0.001,0.01,0.81,0.9617454825067282,5184,5220
5,10504,10,100,0.001,0.01,0.788,0.9464965727341965,5238,5266
5,10604,10,100,0.001,0.01,0.824,0.948321388155413,5289,5315
5,10704,10,100,0.001,0.01,0.79,0.9326420029895366,5338,5366
5,10804,10,100,0.001,0.01,0.816,0.9519622362088116,5383,5421
5,10904,10,100,0.001,0.01,0.8,0.9457997065297139,5426,5478
5,11004,10,100,0.001,0.01,0.812,0.9469283896764813,5476,5528
5,11104,10,100,0.001,0.01,0.82,0.9594740634005764,5535,5569
5,11204,10,100,0.001,0.01,0.82,0.9503748661192432,5590,5614
5,11304,10,100,0.001,0.01,0.808,0.9381634819532909,5635,5669
5,11404,10,100,0.001,0.01,0.804,0.9440547176429323,5689,5715
5,11504,10,100,0.001,0.01,0.824,0.950278164116829,5740,5764
5,11604,10,100,0.001,0.01,0.822,0.9531196139262323,5794,5810
5,11704,10,100,0.001,0.01,0.794,0.9441216678058784,5849,5855
5,11804,10,100,0.001,0.01,0.82,0.9551846831582514,5895,5909
5,11904,10,100,0.001,0.01,0.804,0.9504368279569892,5944,5960
5,12004,10,100,0.001,0.01,0.822,0.9451849383538821,6000,6004
5,12104,10,100,0.001,0.01,0.838,0.9572042300066094,6044,6060
5,12204,10,100,0.001,0.01,0.838,0.9582923631596197,6092,6112
5,12304,10,100,0.001,0.01,0.844,0.9618010403120937,6144,6160
5,12404,10,100,0.001,0.01,0.794,0.9334891970332151,6195,6209
5,12504,10,100,0.001,0.01,0.816,0.9364203454894434,6245,6259
5,12604,10,100,0.001,0.01,0.788,0.9105046017137417,6296,6308
5,12704,10,100,0.001,0.01,0.81,0.8856265743073047,6341,6363
5,12804,10,100,0.001,0.01,0.798,0.9096376132458607,6391,6413
5,12904,10,100,0.001,0.01,0.788,0.9200247985120893,6433,6471
5,13004,10,100,0.001,0.01,0.804,0.9332513072900646,6485,6519
5,13104,10,100,0.001,0.01,0.814,0.925442612942613,6540,6564
5,13204,10,100,0.001,0.01,0.832,0.9403968494395638,6591,6613
5,13304,10,100,0.001,0.01,0.826,0.9513680096211665,6645,6659
5,13404,10,100,0.001,0.01,0.82,0.950313339301701,6696,6708
5,13504,10,100,0.001,0.01,0.836,0.9515699052132701,6745,6759
5,13604,10,100,0.001,0.01,0.836,0.9422963834166421,6801,6803
5,13704,10,100,0.001,0.01,0.826,0.9325744308231173,6842,6862
5,13804,10,100,0.001,0.01,0.826,0.9519704433497537,6891,6913
5,13904,10,100,0.001,0.01,0.846,0.9627445339470656,6931,6973
5,14004,10,100,0.001,0.01,0.818,0.93966009711511,6979,7025
5,14104,10,100,0.001,0.01,0.84,0.9566080544526375,7029,7075
5,14204,10,100,0.001,0.01,0.834,0.9488172345818079,7082,7122
5,14304,10,100,0.001,0.01,0.816,0.9527404921700223,7132,7172
5,14404,10,100,0.001,0.01,0.83,0.9616773118578172,7190,7214
5,14504,10,100,0.001,0.01,0.84,0.954357418643133,7244,7260
5,14604,10,100,0.001,0.01,0.842,0.9632977266502328,7287,7317
5,14704,10,100,0.001,0.01,0.852,0.9607589771490751,7341,7363
5,14804,10,100,0.001,0.01,0.842,0.9607538503107268,7388,7416
5,14904,10,100,0.001,0.01,0.832,0.9662506709608158,7436,7468
5,15004,10,100,0.001,0.01,0.844,0.9629432151426286,7483,7521
6,104,10,100,0.001,0.01,0.552,0.5673076923076923,59,45
6,204,10,100,0.001,0.01,0.538,0.5588235294117647,113,91
6,304,10,100,0.001,0.01,0.502,0.6151315789473685,166,138
6,404,10,100,0.001,0.01,0.47,0.551980198019802,222,182
6,504,10,100,0.001,0.01,0.472,0.6468253968253969,277,227
6,604,10,100,0.001,0.01,0.526,0.6341059602649006,327,277
6,704,10,100,0.001,0.01,0.516,0.6335227272727273,373,331
6,804,10,100,0.001,0.01,0.494,0.6318407960199005,423,381
6,904,10,100,0.001,0.01,0.492,0.6305309734513275,476,428
6,1004,10,100,0.001,0.01,0.478,0.6832669322709163,530,474
6,1104,10,100,0.001,0.01,0.492,0.6875,578,526
6,1204,10,100,0.001,0.01,0.51,0.6943521594684385,618,586
6,1304,10,100,0.001,0.01,0.502,0.6710122699386503,664,640
6,1404,10,100,0.001,0.01,0.516,0.7108262108262108,724,680
6,1504,10,100,0.001,0.01,0.55,0.6855053191489362,776,728
6,1604,10,100,0.001,0.01,0.506,0.7163341645885287,829,775
6,1704,10,100,0.001,0.01,0.508,0.7036384976525821,875,829
6,1804,10,100,0.001,0.01,0.506,0.7400221729490022,926,878
6,1904,10,100,0.001,0.01,0.506,0.7127100840336135,972,932
6,2004,10,100,0.001,0.01,0.524,0.716566866267465,1022,982
6,2104,10,100,0.001,0.01,0.536,0.6972433460076045,1075,1029
6,2204,10,100,0.001,0.01,0.532,0.6991833030852994,1123,1081
6,2304,10,100,0.001,0.01,0.522,0.7105034722222222,1173,1131
6,2404,10,100,0.001,0.01,0.542,0.7154742096505824,1223,1181
6,2504,10,100,0.001,0.01,0.488,0.7024760383386581,1262,1242
6,2604,10,100,0.001,0.01,0.542,0.7154377880184332,1316,1288
6,2704,10,100,0.001,0.01,0.542,0.6856508875739645,1363,1341
6,2804,10,100,0.001,0.01,0.516,0.6954350927246791,1413,1391
6,2904,10,100,0.001,0.01,0.528,0.721763085399449,1467,1437
6,3004,10,100,0.001,0.01,0.5,0.7443408788282291,1512,1492
6,3104,10,100,0.001,0.01,0.514,0.7490335051546392,1557,1547
6,3204,10,100,0.001,0.01,0.5,0.7521847690387016,1606,1598
6,3304,10,100,0.001,0.01,0.512,0.7457627118644068,1662,1642
6,3404,10,100,0.001,0.01,0.506,0.7582256169212691,1709,1695
6,3504,10,100,0.001,0.01,0.53,0.7531392694063926,1763,1741
6,3604,10,100,0.001,0.01,0.518,0.771087680355161,1812,1792
6,3704,10,100,0.001,0.01,0.538,0.7718682505399568,1861,1843
6,3804,10,100,0.001,0.01,0.502,0.7744479495268138,1915,1889
6,3904,10,100,0.001,0.01,0.548,0.7917520491803278,1962,1942
6,4004,10,100,0.001,0.01,0.558,0.7839660339660339,2007,1997
6,4104,10,100,0.001,0.01,0.546,0.7490253411306043,2058,2046
6,4204,10,100,0.001,0.01,0.534,0.7668886774500476,2108,2096
6,4304,10,100,0.001,0.01,0.56,0.7774163568773235,2161,2143
6,4404,10,100,0.001,0.01,0.53,0.7831516802906449,2211,2193
6,4504,10,100,0.001,0.01,0.55,0.8132770870337478,2260,2244
6,4604,10,100,0.001,0.01,0.558,0.8066898349261512,2309,2295
6,4704,10,100,0.001,0.01,0.566,0.7929421768707483,2360,2344
6,4804,10,100,0.001,0.01,0.584,0.8132805995004163,2410,2394
6,4904,10,100,0.001,0.01,0.56,0.8293230016313213,2455,2449
6,5004,10,100,0.001,0.01,0.56,0.8251398880895284,2504,2500
6,5104,10,100,0.001,0.01,0.568,0.8350313479623824,2552,2552
6,5204,10,100,0.001,0.01,0.562,0.8287855495772483,2600,2604
6,5304,10,100,0.001,0.01,0.554,0.8193815987933635,2656,2648
6,5404,10,100,0.001,0.01,0.562,0.8380829015544041,2706,2698
6,5504,10,100,0.001,0.01,0.572,0.8155886627906976,2754,2750
6,5604,10,100,0.001,0.01,0.582,0.8294075660242684,2810,2794
6,5704,10,100,0.001,0.01,0.58,0.8480014025245441,2864,2840
6,5804,10,100,0.001,0.01,0.582,0.8488973121984839,2914,2890
6,5904,10,100,0.001,0.01,0.604,0.8321476964769647,2967,2937
6,6004,10,100,0.001,0.01,0.584,0.8402731512325117,3018,2986
6,6104,10,100,0.001,0.01,0.604,0.8261795543905636,3067,3037
6,6204,10,100,0.001,0.01,0.59,0.8381689232753062,3112,3092
6,6304,10,100,0.001,0.01,0.632,0.853743654822335,3160,3144
6,6404,10,100,0.001,0.01,0.632,0.8463460337289195,3200,3204
6,6504,10,100,0.001,0.01,0.638,0.8440959409594095,3243,3261
6,6604,10,100,0.001,0.01,0.608,0.8561477892186553,3281,3323
6,6704,10,100,0.001,0.01,0.628,0.8784307875894988,3335,3369
6,6804,10,100,0.001,0.01,0.634,0.8740446796002351,3392,3412
6,6904,10,100,0.001,0.01,0.618,0.8770278099652375,3450,3454
6,7004,10,100,0.001,0.01,0.606,0.8803540833809251,3501,3503
6,7104,10,100,0.001,0.01,0.626,0.8780968468468469,3543,3561
6,7204,10,100,0.001,0.01,0.63,0.8685452526374237,3595,3609
6,7304,10,100,0.001,0.01,0.638,0.8377601314348302,3642,3662
6,7404,10,100,0.001,0.01,0.612,0.8557536466774717,3691,3713
6,7504,10,100,0.001,0.01,0.64,0.8736673773987207,3734,3770
6,7604,10,100,0.001,0.01,0.632,0.8798001052077854,3789,3815
6,7704,10,100,0.001,0.01,0.636,0.8711059190031153,3831,3873
6,7804,10,100,0.001,0.01,0.642,0.8612250128139416,3879,3925
6,7904,10,100,0.001,0.01,0.624,0.8665232793522267,3928,3976
6,8004,10,100,0.001,0.01,0.65,0.8725637181409296,3975,4029
6,8104,10,100,0.001,0.01,0.656,0.8846248766041461,4025,4079
6,8204,10,100,0.001,0.01,0.66,0.8812774256460263,4074,4130
6,8304,10,100,0.001,0.01,0.666,0.8898121387283237,4128,4176
6,8404,10,100,0.001,0.01,0.648,0.8824369347929557,4183,4221
6,8504,10,100,0.001,0.01,0.646,0.878645343367827,4224,4280
6,8604,10,100,0.001,0.01,0.664,0.8899349139934914,4274,4330
6,8704,10,100,0.001,0.01,0.66,0.8779871323529411,4322,4382
6,8804,10,100,0.001,0.01,0.67,0.8941390277146751,4374,4430
6,8904,10,100,0.001,0.01,0.664,0.8785938903863432,4426,4478
6,9004,10,100,0.001,0.01,0.664,0.8829409151488228,4478,4526
6,9104,10,100,0.001,0.01,0.656,0.8835676625659051,4537,4567
6,9204,10,100,0.001,0.01,0.662,0.888309430682312,4588,4616
6,9304,10,100,0.001,0.01,0.65,0.8984307824591573,4637,4667
6,9404,10,100,0.001,0.01,0.692,0.8895150999574649,4689,4715
6,9504,10,100,0.001,0.01,0.638,0.8940446127946128,4743,4761
6,9604,10,100,0.001,0.01,0.672,0.9008746355685131,4792,4812
6,9704,10,100,0.001,0.01,0.688,0.8866446826051113,4836,4868
6,9804,10,100,0.001,0.01,0.678,0.8866789065687475,4886,4918
6,9904,10,100,0.001,0.01,0.688,0.8691437802907916,4936,4968
6,10004,10,100,0.001,0.01,0.688,0.890843662534986,4989,5015
6,10104,10,100,0.001,0.01,0.676,0.8767814726840855,5038,5066
6,10204,10,100,0.001,0.01,0.708,0.9036652293218346,5081,5123
6,10304,10,100,0.001,0.01,0.718,0.9121700310559007,5125,5179
6,10404,10,100,0.001,0.01,0.734,0.9038831218762015,5171,5233
6,10504,10,100,0.001,0.01,0.724,0.9086062452399086,5225,5279
6,10604,10,100,0.001,0.01,0.68,0.8921161825726142,5274,5330
6,10704,10,100,0.001,0.01,0.734,0.9264760837070254,5327,5377
6,10804,10,100,0.001,0.01,0.74,0.9107737874861163,5378,5426
6,10904,10,100,0.001,0.01,0.718,0.9054475421863536,5437,5467
6,11004,10,100,0.001,0.01,0.738,0.9241185023627771,5486,5518
6,11104,10,100,0.001,0.01,0.718,0.9276837175792507,5536,5568
6,11204,10,100,0.001,0.01,0.722,0.914762584791146,5583,5621
6,11304,10,100,0.001,0.01,0.724,0.9255130927105449,5634,5670
6,11404,10,100,0.001,0.01,0.746,0.9250263065591021,5680,5724
6,11504,10,100,0.001,0.01,0.746,0.9319367176634215,5735,5769
6,11604,10,100,0.001,0.01,0.722,0.9084798345398138,5776,5828
6,11704,10,100,0.001,0.01,0.72,0.903879015721121,5825,5879
6,11804,10,100,0.001,0.01,0.736,0.9089291765503219,5869,5935
6,11904,10,100,0.001,0.01,0.728,0.894489247311828,5912,5992
6,12004,10,100,0.001,0.01,0.728,0.9044485171609463,5972,6032
6,12104,10,100,0.001,0.01,0.748,0.9234137475214805,6026,6078
6,12204,10,100,0.001,0.01,0.74,0.9242871189773845,6080,6124
6,12304,10,100,0.001,0.01,0.744,0.9200260078023407,6125,6179
6,12404,10,100,0.001,0.01,0.772,0.9446952595936795,6177,6227
6,12504,10,100,0.001,0.01,0.742,0.9261036468330134,6229,6275
6,12604,10,100,0.001,0.01,0.746,0.9179625515709299,6289,6315
6,12704,10,100,0.001,0.01,0.766,0.9306517632241813,6337,6367
6,12804,10,100,0.001,0.01,0.758,0.9322867853795689,6391,6413
6,12904,10,100,0.001,0.01,0.76,0.9283942963422195,6448,6456
6,13004,10,100,0.001,0.01,0.782,0.9408643494309443,6501,6503
6,13104,10,100,0.001,0.01,0.782,0.9292582417582418,6556,6548
6,13204,10,100,0.001,0.01,0.774,0.9328233868524689,6604,6600
6,13304,10,100,0.001,0.01,0.748,0.9018340348767288,6650,6654
6,13404,10,100,0.001,0.01,0.768,0.9243509400179051,6699,6705
6,13504,10,100,0.001,0.01,0.794,0.9328347156398105,6742,6762
6,13604,10,100,0.001,0.01,0.746,0.8852543369597178,6790,6814
6,13704,10,100,0.001,0.01,0.668,0.8131932282545242,6840,6864
6,13804,10,100,0.001,0.01,0.708,0.8440307157345697,6893,6911
6,13904,10,100,0.001,0.01,0.702,0.8685270425776754,6939,6965
6,14004,10,100,0.001,0.01,0.734,0.8788917452156527,6988,7016
6,14104,10,100,0.001,0.01,0.742,0.8849971639251276,7040,7064
6,14204,10,100,0.001,0.01,0.72,0.8884117150098564,7084,7120
6,14304,10,100,0.001,0.01,0.756,0.8984899328859061,7137,7167
6,14404,10,100,0.001,0.01,0.742,0.889128019994446,7187,7217
6,14504,10,100,0.001,0.01,0.748,0.8880998345284059,7233,7271
6,14604,10,100,0.001,0.01,0.744,0.8840728567515749,7281,7323
6,14704,10,100,0.001,0.01,0.784,0.8985310119695321,7331,7373
6,14804,10,100,0.001,0.01,0.75,0.8981356390164821,7373,7431
6,14904,10,100,0.001,0.01,0.758,0.8941894793344068,7424,7480
6,15004,10,100,0.001,0.01,0.78,0.9070247933884298,7476,7528
7,104,10,100,0.001,0.01,0.514,0.4230769230769231,44,60
7,204,10,100,0.001,0.01,0.506,0.7107843137254902,89,115
7,304,10,100,0.001,0.01,0.468,0.5953947368421053,136,168
7,404,10,100,0.001,0.01,0.466,0.6806930693069307,189,215
7,504,10,100,0.001,0.01,0.5,0.626984126984127,238,266
7,604,10,100,0.001,0.01,0.478,0.6754966887417219,295,309
7,704,10,100,0.001,0.01,0.462,0.6732954545454546,347,357
7,804,10,100,0.001,0.01,0.508,0.7077114427860697,395,409
7,904,10,100,0.001,0.01,0.52,0.6327433628318584,446,458
7,1004,10,100,0.001,0.01,0.54,0.6982071713147411,503,501
7,1104,10,100,0.001,0.01,0.518,0.6965579710144928,546,558
7,1204,10,100,0.001,0.01,0.504,0.7317275747508306,599,605
7,1304,10,100,0.001,0.01,0.51,0.7154907975460123,644,660
7,1404,10,100,0.001,0.01,0.516,0.7457264957264957,697,707
7,1504,10,100,0.001,0.01,0.54,0.7121010638297872,750,754
7,1604,10,100,0.001,0.01,0.55,0.7699501246882793,799,805
7,1704,10,100,0.001,0.01,0.538,0.7517605633802817,849,855
7,1804,10,100,0.001,0.01,0.542,0.7854767184035477,902,902
7,1904,10,100,0.001,0.01,0.522,0.7415966386554622,949,955
7,2004,10,100,0.001,0.01,0.542,0.7539920159680639,996,1008
7,2104,10,100,0.001,0.01,0.538,0.7756653992395437,1045,1059
7,2204,10,100,0.001,0.01,0.554,0.7862976406533575,1103,1101
7,2304,10,100,0.001,0.01,0.554,0.7855902777777778,1153,1151
7,2404,10,100,0.001,0.01,0.562,0.7699667221297837,1201,1203
7,2504,10,100,0.001,0.01,0.556,0.7827476038338658,1254,1250
7,2604,10,100,0.001,0.01,0.57,0.8187403993855606,1293,1311
7,2704,10,100,0.001,0.01,0.594,0.8398668639053254,1347,1357
7,2804,10,100,0.001,0.01,0.598,0.8402282453637661,1390,1414
7,2904,10,100,0.001,0.01,0.6,0.8013085399449036,1437,1467
7,3004,10,100,0.001,0.01,0.608,0.8255659121171771,1486,1518
7,3104,10,100,0.001,0.01,0.636,0.8360180412371134,1535,1569
7,3204,10,100,0.001,0.01,0.626,0.8651685393258427,1581,1623
7,3304,10,100,0.001,0.01,0.69,0.860774818401937,1630,1674
7,3404,10,100,0.001,0.01,0.636,0.8742655699177438,1683,1721
7,3504,10,100,0.001,0.01,0.656,0.8681506849315068,1730,1774
7,3604,10,100,0.001,0.01,0.666,0.8781908990011099,1778,1826
7,3704,10,100,0.001,0.01,0.692,0.8952483801295896,1826,1878
7,3804,10,100,0.001,0.01,0.696,0.9121976866456362,1881,1923
7,3904,10,100,0.001,0.01,0.71,0.9252049180327869,1924,1980
7,4004,10,100,0.001,0.01,0.714,0.9205794205794205,1976,2028
7,4104,10,100,0.001,0.01,0.708,0.9251949317738791,2023,2081
7,4204,10,100,0.001,0.01,0.708,0.9074690770694577,2071,2133
7,4304,10,100,0.001,0.01,0.706,0.8536245353159851,2125,2179
7,4404,10,100,0.001,0.01,0.74,0.8941871026339692,2162,2242
7,4504,10,100,0.001,0.01,0.744,0.9027531083481349,2219,2285
7,4604,10,100,0.001,0.01,0.778,0.908123370981755,2270,2334
7,4704,10,100,0.001,0.01,0.77,0.8945578231292517,2327,2377
7,4804,10,100,0.001,0.01,0.758,0.9290174854288094,2372,2432
7,4904,10,100,0.001,0.01,0.76,0.9286296900489397,2423,2481
7,5004,10,100,0.001,0.01,0.774,0.9320543565147882,2466,2538
7,5104,10,100,0.001,0.01,0.778,0.9316222570532915,2522,2582
7,5204,10,100,0.001,0.01,0.76,0.9371637202152191,2572,2632
7,5304,10,100,0.001,0.01,0.774,0.9391025641025641,2625,2679
7,5404,10,100,0.001,0.01,0.794,0.9531828275351591,2679,2725
7,5504,10,100,0.001,0.01,0.768,0.9458575581395349,2734,2770
7,5604,10,100,0.001,0.01,0.792,0.9528907922912205,2777,2827
7,5704,10,100,0.001,0.01,0.776,0.9365357643758766,2824,2880
7,5804,10,100,0.001,0.01,0.808,0.9508959338387319,2883,2921
7,5904,10,100,0.001,0.01,0.788,0.9488482384823849,2925,2979
7,6004,10,100,0.001,0.01,0.796,0.9385409726848768,2971,3033
7,6104,10,100,0.001,0.01,0.786,0.9347968545216252,3028,3076
7,6204,10,100,0.001,0.01,0.778,0.9408446163765313,3075,3129
7,6304,10,100,0.001,0.01,0.802,0.9535215736040609,3126,3178
7,6404,10,100,0.001,0.01,0.8,0.9455028107432855,3180,3224
7,6504,10,100,0.001,0.01,0.792,0.9521832718327183,3240,3264
7,6604,10,100,0.001,0.01,0.816,0.943519079345851,3290,3314
7,6704,10,100,0.001,0.01,0.806,0.9437649164677804,3335,3369
7,6804,10,100,0.001,0.01,0.792,0.9548794826572604,3381,3423
7,6904,10,100,0.001,0.01,0.824,0.9585747392815759,3431,3473
7,7004,10,100,0.001,0.01,0.828,0.950456881781839,3476,3528
7,7104,10,100,0.001,0.01,0.814,0.9481981981981982,3521,3583
7,7204,10,100,0.001,0.01,0.784,0.9483620210993893,3567,3637
7,7304,10,100,0.001,0.01,0.808,0.9579682365826944,3616,3688
7,7404,10,100,0.001,0.01,0.816,0.9674500270124257,3668,3736
7,7504,10,100,0.001,0.01,0.82,0.9769456289978679,3712,3792
7,7604,10,100,0.001,0.01,0.822,0.9608100999473961,3767,3837
7,7704,10,100,0.001,0.01,0.816,0.9554776739356179,3824,3880
7,7804,10,100,0.001,0.01,0.818,0.9497693490517684,3873,3931
7,7904,10,100,0.001,0.01,0.834,0.9702682186234818,3928,3976
7,8004,10,100,0.001,0.01,0.816,0.9632683658170914,3982,4022
7,8104,10,100,0.001,0.01,0.822,0.9479269496544916,4032,4072
7,8204,10,100,0.001,0.01,0.8,0.9484397854705022,4078,4126
7,8304,10,100,0.001,0.01,0.826,0.9381021194605009,4135,4169
7,8404,10,100,0.001,0.01,0.84,0.9544264635887673,4189,4215
7,8504,10,100,0.001,0.01,0.826,0.9519049858889934,4240,4264
7,8604,10,100,0.001,0.01,0.826,0.9602510460251046,4294,4310
7,8704,10,100,0.001,0.01,0.84,0.9539292279411765,4340,4364
7,8804,10,100,0.001,0.01,0.838,0.9555883689232167,4387,4417
7,8904,10,100,0.001,0.01,0.852,0.9709119496855346,4439,4465
7,9004,10,100,0.001,0.01,0.866,0.9651266103953798,4490,4514
7,9104,10,100,0.001,0.01,0.86,0.9733084358523726,4531,4573
7,9204,10,100,0.001,0.01,0.844,0.9676227727075185,4576,4628
7,9304,10,100,0.001,0.01,0.856,0.9787188306104901,4630,4674
7,9404,10,100,0.001,0.01,0.852,0.9667162909400255,4684,4720
7,9504,10,100,0.001,0.01,0.866,0.9653829966329966,4738,4766
7,9604,10,100,0.001,0.01,0.852,0.9723032069970845,4789,4815
7,9704,10,100,0.001,0.01,0.864,0.9666117065127783,4835,4869
7,9804,10,100,0.001,0.01,0.874,0.9682782537739698,4879,4925
7,9904,10,100,0.001,0.01,0.874,0.9770799676898223,4933,4971
7,10004,10,100,0.001,0.01,0.864,0.9744102359056377,4983,5021
7,10104,10,100,0.001,0.01,0.872,0.9697149643705463,5035,5069
7,10204,10,100,0.001,0.01,0.88,0.9644257154057232,5084,5120
7,10304,10,100,0.001,0.01,0.878,0.9761257763975155,5131,5173
7,10404,10,100,0.001,0.01,0.87,0.9758746635909266,5180,5224
7,10504,10,100,0.001,0.01,0.882,0.970011424219345,5225,5279
7,10604,10,100,0.001,0.01,0.884,0.9753866465484723,5279,5325
7,10704,10,100,0.001,0.01,0.89,0.9694506726457399,5334,5370
7,10804,10,100,0.001,0.01,0.888,0.9711218067382451,5387,5417
7,10904,10,100,0.001,0.01,0.884,0.9676265590608951,5432,5472
7,11004,10,100,0.001,0.01,0.874,0.9730098146128681,5490,5514
7,11104,10,100,0.001,0.01,0.886,0.9715417867435159,5533,5571
7,11204,10,100,0.001,0.01,0.88,0.976347732952517,5591,5613
7,11304,10,100,0.001,0.01,0.888,0.9887650389242746,5643,5661
7,11404,10,100,0.001,0.01,0.896,0.9815854086285514,5687,5717
7,11504,10,100,0.001,0.01,0.884,0.980702364394993,5739,5765
7,11604,10,100,0.001,0.01,0.874,0.967683557394002,5777,5827
7,11704,10,100,0.001,0.01,0.862,0.9472829801777171,5822,5882
7,11804,10,100,0.001,0.01,0.882,0.9713656387665198,5872,5932
7,11904,10,100,0.001,0.01,0.894,0.9742103494623656,5918,5986
7,12004,10,100,0.001,0.01,0.906,0.9819226924358547,5967,6037
7,12104,10,100,0.001,0.01,0.912,0.985624586913417,6015,6089
7,12204,10,100,0.001,0.01,0.898,0.9844313339888561,6062,6142
7,12304,10,100,0.001,0.01,0.892,0.9764304291287387,6111,6193
7,12404,10,100,0.001,0.01,0.894,0.9623508545630441,6170,6234
7,12504,10,100,0.001,0.01,0.878,0.9577735124760077,6224,6280
7,12604,10,100,0.001,0.01,0.894,0.9731831164709616,6281,6323
7,12704,10,100,0.001,0.01,0.89,0.9726857682619647,6327,6377
7,12804,10,100,0.001,0.01,0.9,0.9816463605123399,6391,6413
7,12904,10,100,0.001,0.01,0.92,0.9885306881587105,6440,6464
7,13004,10,100,0.001,0.01,0.9,0.968471239618579,6502,6502
7,13104,10,100,0.001,0.01,0.906,0.9694749694749695,6544,6560
7,13204,10,100,0.001,0.01,0.914,0.980990608906392,6602,6602
7,13304,10,100,0.001,0.01,0.918,0.982937462417318,6658,6646
7,13404,10,100,0.001,0.01,0.924,0.9851536854670248,6705,6699
7,13504,10,100,0.001,0.01,0.918,0.9841528436018957,6759,6745
7,13604,10,100,0.001,0.01,0.916,0.9910320493972361,6817,6787
7,13704,10,100,0.001,0.01,0.898,0.967600700525394,6871,6833
7,13804,10,100,0.001,0.01,0.926,0.9826861779194437,6921,6883
7,13904,10,100,0.001,0.01,0.922,0.9826668584579977,6964,6940
7,14004,10,100,0.001,0.01,0.934,0.9903598971722365,7012,6992
7,14104,10,100,0.001,0.01,0.93,0.9931225184344866,7054,7050
7,14204,10,100,0.001,0.01,0.908,0.9832441565756125,7109,7095
7,14304,10,100,0.001,0.01,0.926,0.981753355704698,7155,7149
7,14404,10,100,0.001,0.01,0.932,0.978547625659539,7207,7197
7,14504,10,100,0.001,0.01,0.928,0.9882790954219526,7249,7255
7,14604,10,100,0.001,0.01,0.928,0.9857573267597919,7308,7296
7,14704,10,100,0.001,0.01,0.934,0.9694640914036997,7355,7349
7,14804,10,100,0.001,0.01,0.938,0.9850716022696568,7403,7401
7,14904,10,100,0.001,0.01,0.938,0.9919484702093397,7452,7452
7,15004,10,100,0.001,0.01,0.95,0.996534257531325,7495,7509
8,104,10,100,0.001,0.01,0.478,0.5576923076923077,46,58
8,204,10,100,0.001,0.01,0.512,0.6372549019607843,101,103
8,304,10,100,0.001,0.01,0.522,0.5361842105263158,142,162
8,404,10,100,0.001,0.01,0.558,0.6113861386138614,196,208
8,504,10,100,0.001,0.01,0.528,0.5853174603174603,246,258
8,604,10,100,0.001,0.01,0.538,0.5993377483443708,296,308
8,704,10,100,0.001,0.01,0.534,0.6008522727272727,346,358
8,804,10,100,0.001,0.01,0.5,0.6243781094527363,397,407
8,904,10,100,0.001,0.01,0.516,0.6238938053097345,449,455
8,1004,10,100,0.001,0.01,0.494,0.5796812749003984,490,514
8,1104,10,100,0.001,0.01,0.488,0.6693840579710145,536,568
8,1204,10,100,0.001,0.01,0.47,0.6827242524916943,588,616
8,1304,10,100,0.001,0.01,0.514,0.674079754601227,637,667
8,1404,10,100,0.001,0.01,0.518,0.7015669515669516,698,706
8,1504,10,100,0.001,0.01,0.524,0.7081117021276596,750,754
8,1604,10,100,0.001,0.01,0.526,0.720074812967581,806,798
8,1704,10,100,0.001,0.01,0.522,0.727112676056338,850,854
8,1804,10,100,0.001,0.01,0.554,0.7455654101995566,899,905
8,1904,10,100,0.001,0.01,0.53,0.7410714285714286,949,955
8,2004,10,100,0.001,0.01,0.51,0.7375249500998003,987,1017
8,2104,10,100,0.001,0.01,0.484,0.717680608365019,1041,1063
8,2204,10,100,0.001,0.01,0.524,0.7286751361161524,1095,1109
8,2304,10,100,0.001,0.01,0.51,0.7096354166666666,1154,1150
8,2404,10,100,0.001,0.01,0.51,0.7712146422628952,1205,1199
8,2504,10,100,0.001,0.01,0.496,0.7496006389776357,1256,1248
8,2604,10,100,0.001,0.01,0.522,0.772273425499232,1303,1301
8,2704,10,100,0.001,0.01,0.508,0.7725591715976331,1358,1346
8,2804,10,100,0.001,0.01,0.522,0.7664051355206848,1400,1404
8,2904,10,100,0.001,0.01,0.53,0.746900826446281,1450,1454
8,3004,10,100,0.001,0.01,0.53,0.7709720372836218,1508,1496
8,3104,10,100,0.001,0.01,0.528,0.7764175257731959,1552,1552
8,3204,10,100,0.001,0.01,0.554,0.7802746566791511,1600,1604
8,3304,10,100,0.001,0.01,0.51,0.7518159806295399,1648,1656
8,3404,10,100,0.001,0.01,0.524,0.8040540540540541,1693,1711
8,3504,10,100,0.001,0.01,0.498,0.800513698630137,1741,1763
8,3604,10,100,0.001,0.01,0.524,0.7788568257491676,1792,1812
8,3704,10,100,0.001,0.01,0.528,0.8145248380129589,1845,1859
8,3804,10,100,0.001,0.01,0.5,0.825446898002103,1896,1908
8,3904,10,100,0.001,0.01,0.516,0.8358094262295082,1950,1954
8,4004,10,100,0.001,0.01,0.486,0.8374125874125874,2002,2002
8,4104,10,100,0.001,0.01,0.506,0.8053118908382066,2051,2053
8,4204,10,100,0.001,0.01,0.512,0.8215984776403426,2099,2105
8,4304,10,100,0.001,0.01,0.518,0.8157527881040892,2151,2153
8,4404,10,100,0.001,0.01,0.518,0.8292461398728429,2195,2209
8,4504,10,100,0.001,0.01,0.554,0.8079484902309059,2240,2264
8,4604,10,100,0.001,0.01,0.526,0.8238488271068636,2294,2310
8,4704,10,100,0.001,0.01,0.538,0.8216411564625851,2330,2374
8,4804,10,100,0.001,0.01,0.502,0.8318068276436303,2375,2429
8,4904,10,100,0.001,0.01,0.526,0.807300163132137,2430,2474
8,5004,10,100,0.001,0.01,0.512,0.8327338129496403,2478,2526
8,5104,10,100,0.001,0.01,0.5,0.8358150470219435,2530,2574
8,5204,10,100,0.001,0.01,0.528,0.8383935434281322,2586,2618
8,5304,10,100,0.001,0.01,0.522,0.8431372549019608,2634,2670
8,5404,10,100,0.001,0.01,0.512,0.8488156920799408,2687,2717
8,5504,10,100,0.001,0.01,0.524,0.8571947674418605,2731,2773
8,5604,10,100,0.001,0.01,0.536,0.8652748037116346,2777,2827
8,5704,10,100,0.001,0.01,0.532,0.8792075736325385,2818,2886
8,5804,10,100,0.001,0.01,0.528,0.8664713990351481,2863,2941
8,5904,10,100,0.001,0.01,0.544,0.858739837398374,2925,2979
8,6004,10,100,0.001,0.01,0.562,0.8585942704863424,2973,3031
8,6104,10,100,0.001,0.01,0.554,0.8605832241153342,3026,3078
8,6204,10,100,0.001,0.01,0.538,0.8646034816247582,3077,3127
8,6304,10,100,0.001,0.01,0.542,0.8810279187817259,3120,3184
8,6404,10,100,0.001,0.01,0.556,0.868207370393504,3173,3231
8,6504,10,100,0.001,0.01,0.538,0.8268757687576875,3226,3278
8,6604,10,100,0.001,0.01,0.54,0.8578134463961236,3268,3336
8,6704,10,100,0.001,0.01,0.564,0.8503878281622912,3314,3390
8,6804,10,100,0.001,0.01,0.574,0.8718400940623163,3367,3437
8,6904,10,100,0.001,0.01,0.58,0.8563151796060255,3425,3479
8,7004,10,100,0.001,0.01,0.568,0.8653626499143346,3477,3527
8,7104,10,100,0.001,0.01,0.576,0.8330518018018018,3526,3578
8,7204,10,100,0.001,0.01,0.598,0.8720155469183787,3580,3624
8,7304,10,100,0.001,0.01,0.594,0.8687020810514786,3625,3679
8,7404,10,100,0.001,0.01,0.612,0.8758779038357645,3667,3737
8,7504,10,100,0.001,0.01,0.654,0.8799307036247335,3714,3790
8,7604,10,100,0.001,0.01,0.604,0.890189374013677,3769,3835
8,7704,10,100,0.001,0.01,0.624,0.8925233644859814,3814,3890
8,7804,10,100,0.001,0.01,0.604,0.8630189646335212,3868,3936
8,7904,10,100,0.001,0.01,0.596,0.7682186234817814,3921,3983
8,8004,10,100,0.001,0.01,0.592,0.8209645177411294,3971,4033
8,8104,10,100,0.001,0.01,0.62,0.839832181638697,4024,4080
8,8204,10,100,0.001,0.01,0.62,0.8581179912237933,4071,4133
8,8304,10,100,0.001,0.01,0.614,0.8646435452793835,4122,4182
8,8404,10,100,0.001,0.01,0.642,0.8708948119942884,4174,4230
8,8504,10,100,0.001,0.01,0.646,0.861241768579492,4224,4280
8,8604,10,100,0.001,0.01,0.67,0.8759879125987913,4275,4329
8,8704,10,100,0.001,0.01,0.648,0.8898207720588235,4333,4371
8,8804,10,100,0.001,0.01,0.652,0.8860745115856429,4382,4422
8,8904,10,100,0.001,0.01,0.644,0.8992587601078167,4434,4470
8,9004,10,100,0.001,0.01,0.64,0.8944913371834741,4481,4523
8,9104,10,100,0.001,0.01,0.632,0.8923550087873462,4531,4573
8,9204,10,100,0.001,0.01,0.648,0.8999348109517601,4580,4624
8,9304,10,100,0.001,0.01,0.666,0.8916595012897678,4631,4673
8,9404,10,100,0.001,0.01,0.674,0.9086558911101659,4686,4718
8,9504,10,100,0.001,0.01,0.654,0.9087752525252525,4746,4758
8,9604,10,100,0.001,0.01,0.68,0.9102457309454394,4798,4806
8,9704,10,100,0.001,0.01,0.652,0.9091096455070075,4845,4859
8,9804,10,100,0.001,0.01,0.648,0.9107507139942881,4901,4903
8,9904,10,100,0.001,0.01,0.656,0.9114499192245558,4954,4950
8,10004,10,100,0.001,0.01,0.654,0.9207317073170732,5002,5002
8,10104,10,100,0.001,0.01,0.652,0.9289390340459224,5062,5042
8,10204,10,100,0.001,0.01,0.656,0.907095256762054,5119,5085
8,10304,10,100,0.001,0.01,0.658,0.9188664596273292,5173,5131
8,10404,10,100,0.001,0.01,0.65,0.910803537101115,5220,5184
8,10504,10,100,0.001,0.01,0.666,0.908987052551409,5275,5229
8,10604,10,100,0.001,0.01,0.662,0.9106940777065259,5329,5275
8,10704,10,100,0.001,0.01,0.696,0.9167600896860987,5375,5329
8,10804,10,100,0.001,0.01,0.678,0.9221584598296927,5428,5376
8,10904,10,100,0.001,0.01,0.668,0.9151687454145268,5479,5425
8,11004,10,100,0.001,0.01,0.666,0.9093965830607051,5534,5470
8,11104,10,100,0.001,0.01,0.668,0.922550432276657,5581,5523
8,11204,10,100,0.001,0.01,0.698,0.9258300606926098,5628,5576
8,11304,10,100,0.001,0.01,0.698,0.9294055201698513,5683,5621
8,11404,10,100,0.001,0.01,0.714,0.9280077165906699,5731,5673
8,11504,10,100,0.001,0.01,0.692,0.9350660639777468,5782,5722
8,11604,10,100,0.001,0.01,0.724,0.9389865563598759,5835,5769
8,11704,10,100,0.001,0.01,0.71,0.9295967190704033,5884,5820
8,11804,10,100,0.001,0.01,0.718,0.9184174855981023,5931,5873
8,11904,10,100,0.001,0.01,0.722,0.9247311827956989,5983,5921
8,12004,10,100,0.001,0.01,0.744,0.9282739086971009,6025,5979
8,12104,10,100,0.001,0.01,0.708,0.9168043621943159,6065,6039
8,12204,10,100,0.001,0.01,0.72,0.9288757784333006,6120,6084
8,12304,10,100,0.001,0.01,0.692,0.9010890767230169,6164,6140
8,12404,10,100,0.001,0.01,0.738,0.912850693324734,6218,6186
8,12504,10,100,0.001,0.01,0.71,0.8822776711452335,6266,6238
8,12604,10,100,0.001,0.01,0.708,0.8901142494446208,6323,6281
8,12704,10,100,0.001,0.01,0.662,0.8794080604534005,6367,6337
8,12804,10,100,0.001,0.01,0.71,0.898234926585442,6414,6390
8,12904,10,100,0.001,0.01,0.73,0.907548047117173,6463,6441
8,13004,10,100,0.001,0.01,0.754,0.9267917563826515,6516,6488
8,13104,10,100,0.001,0.01,0.73,0.923992673992674,6570,6534
8,13204,10,100,0.001,0.01,0.756,0.9319903059678886,6620,6584
8,13304,10,100,0.001,0.01,0.768,0.9467077570655442,6668,6636
8,13404,10,100,0.001,0.01,0.74,0.9205461056401074,6721,6683
8,13504,10,100,0.001,0.01,0.76,0.9240225118483413,6774,6730
8,13604,10,100,0.001,0.01,0.75,0.93582769773596,6818,6786
8,13704,10,100,0.001,0.01,0.772,0.940820198482195,6852,6852
8,13804,10,100,0.001,0.01,0.784,0.9469718922051579,6899,6905
8,13904,10,100,0.001,0.01,0.776,0.9465621403912543,6952,6952
8,14004,10,100,0.001,0.01,0.768,0.944515852613539,6996,7008
8,14104,10,100,0.001,0.01,0.784,0.9557572319909245,7047,7057
8,14204,10,100,0.001,0.01,0.808,0.9512813292030414,7102,7102
8,14304,10,100,0.001,0.01,0.808,0.9584731543624161,7151,7153
8,14404,10,100,0.001,0.01,0.776,0.9442515967786725,7204,7200
8,14504,10,100,0.001,0.01,0.776,0.9124379481522339,7258,7246
8,14604,10,100,0.001,0.01,0.8,0.9341961106546152,7310,7294
8,14704,10,100,0.001,0.01,0.79,0.9343715995647442,7352,7352
8,14804,10,100,0.001,0.01,0.816,0.9390705214806809,7405,7399
8,14904,10,100,0.001,0.01,0.824,0.9510869565217391,7453,7451
8,15004,10,100,0.001,0.01,0.802,0.9406158357771262,7491,7513
9,104,10,100,0.001,0.01,0.496,0.5288461538461539,49,55
9,204,10,100,0.001,0.01,0.484,0.6078431372549019,103,101
9,304,10,100,0.001,0.01,0.494,0.6546052631578947,149,155
9,404,10,100,0.001,0.01,0.49,0.556930693069307,195,209
9,504,10,100,0.001,0.01,0.472,0.5773809523809523,249,255
9,604,10,100,0.001,0.01,0.518,0.6258278145695364,302,302
9,704,10,100,0.001,0.01,0.482,0.6278409090909091,353,351
9,804,10,100,0.001,0.01,0.468,0.6393034825870647,392,412
9,904,10,100,0.001,0.01,0.506,0.6327433628318584,441,463
9,1004,10,100,0.001,0.01,0.486,0.646414342629482,484,520
9,1104,10,100,0.001,0.01,0.512,0.6458333333333334,538,566
9,1204,10,100,0.001,0.01,0.496,0.6669435215946844,589,615
9,1304,10,100,0.001,0.01,0.49,0.6710122699386503,643,661
9,1404,10,100,0.001,0.01,0.506,0.6923076923076923,695,709
9,1504,10,100,0.001,0.01,0.498,0.6941489361702128,735,769
9,1604,10,100,0.001,0.01,0.52,0.6951371571072319,781,823
9,1704,10,100,0.001,0.01,0.55,0.6772300469483568,832,872
9,1804,10,100,0.001,0.01,0.502,0.7245011086474501,885,919
9,1904,10,100,0.001,0.01,0.506,0.717436974789916,943,961
9,2004,10,100,0.001,0.01,0.544,0.7445109780439122,992,1012
9,2104,10,100,0.001,0.01,0.502,0.7110266159695817,1039,1065
9,2204,10,100,0.001,0.01,0.518,0.7286751361161524,1088,1116
9,2304,10,100,0.001,0.01,0.512,0.7204861111111112,1138,1166
9,2404,10,100,0.001,0.01,0.502,0.7354409317803661,1192,1212
9,2504,10,100,0.001,0.01,0.516,0.7619808306709265,1247,1257
9,2604,10,100,0.001,0.01,0.512,0.7622887864823349,1302,1302
9,2704,10,100,0.001,0.01,0.546,0.7414940828402367,1354,1350
9,2804,10,100,0.001,0.01,0.552,0.7692582025677603,1405,1399
9,2904,10,100,0.001,0.01,0.56,0.7909779614325069,1455,1449
9,3004,10,100,0.001,0.01,0.564,0.8105858854860186,1507,1497
9,3104,10,100,0.001,0.01,0.568,0.8224871134020618,1561,1543
9,3204,10,100,0.001,0.01,0.572,0.8008739076154806,1609,1595
9,3304,10,100,0.001,0.01,0.55,0.7808716707021792,1660,1644
9,3404,10,100,0.001,0.01,0.586,0.7987661574618097,1707,1697
9,3504,10,100,0.001,0.01,0.578,0.7819634703196348,1750,1754
9,3604,10,100,0.001,0.01,0.6,0.8210321864594895,1803,1801
9,3704,10,100,0.001,0.01,0.576,0.8161447084233261,1845,1859
9,3804,10,100,0.001,0.01,0.612,0.8401682439537329,1893,1911
9,3904,10,100,0.001,0.01,0.606,0.8148053278688525,1938,1966
9,4004,10,100,0.001,0.01,0.624,0.8421578421578422,1988,2016
9,4104,10,100,0.001,0.01,0.596,0.8489278752436648,2038,2066
9,4204,10,100,0.001,0.01,0.628,0.8579923882017126,2085,2119
9,4304,10,100,0.001,0.01,0.61,0.8443308550185874,2140,2164
9,4404,10,100,0.001,0.01,0.618,0.8399182561307902,2188,2216
9,4504,10,100,0.001,0.01,0.604,0.8299289520426287,2231,2273
9,4604,10,100,0.001,0.01,0.668,0.8562119895742832,2279,2325
9,4704,10,100,0.001,0.01,0.654,0.8596938775510204,2332,2372
9,4804,10,100,0.001,0.01,0.618,0.8567860116569526,2380,2424
9,4904,10,100,0.001,0.01,0.654,0.8603181076672104,2429,2475
9,5004,10,100,0.001,0.01,0.656,0.8878896882494005,2475,2529
9,5104,10,100,0.001,0.01,0.676,0.8961598746081505,2521,2583
9,5204,10,100,0.001,0.01,0.67,0.8743274404304381,2572,2632
9,5304,10,100,0.001,0.01,0.644,0.8476621417797888,2627,2677
9,5404,10,100,0.001,0.01,0.682,0.865099925980755,2678,2726
9,5504,10,100,0.001,0.01,0.656,0.8795421511627907,2729,2775
9,5604,10,100,0.001,0.01,0.67,0.8945396145610278,2778,2826
9,5704,10,100,0.001,0.01,0.68,0.8970897615708275,2841,2863
9,5804,10,100,0.001,0.01,0.692,0.8880082701585114,2895,2909
9,5904,10,100,0.001,0.01,0.71,0.8699186991869918,2945,2959
9,6004,10,100,0.001,0.01,0.712,0.9003997335109927,3002,3002
9,6104,10,100,0.001,0.01,0.69,0.8899082568807339,3052,3052
9,6204,10,100,0.001,0.01,0.688,0.9095744680851063,3112,3092
9,6304,10,100,0.001,0.01,0.696,0.9092639593908629,3164,3140
9,6404,10,100,0.001,0.01,0.71,0.9047470331043098,3214,3190
9,6504,10,100,0.001,0.01,0.716,0.9060578105781057,3277,3227
9,6604,10,100,0.001,0.01,0.724,0.9076317383403998,3319,3285
9,6704,10,100,0.001,0.01,0.7,0.9006563245823389,3377,3327
9,6804,10,100,0.001,0.01,0.702,0.9053497942386831,3428,3376
9,6904,10,100,0.001,0.01,0.73,0.8997682502896871,3474,3430
9,7004,10,100,0.001,0.01,0.706,0.8923472301541976,3527,3477
9,7104,10,100,0.001,0.01,0.684,0.8817567567567568,3566,3538
9,7204,10,100,0.001,0.01,0.73,0.9069961132704053,3619,3585
9,7304,10,100,0.001,0.01,0.726,0.9059419496166484,3670,3634
9,7404,10,100,0.001,0.01,0.732,0.8999189627228525,3718,3686
9,7504,10,100,0.001,0.01,0.728,0.8524786780383795,3768,3736
9,7604,10,100,0.001,0.01,0.73,0.8832193582325092,3816,3788
9,7704,10,100,0.001,0.01,0.732,0.898104880581516,3869,3835
9,7804,10,100,0.001,0.01,0.722,0.9090210148641722,3917,3887
9,7904,10,100,0.001,0.01,0.74,0.9257338056680162,3972,3932
9,8004,10,100,0.001,0.01,0.74,0.9279110444777611,4025,3979
9,8104,10,100,0.001,0.01,0.746,0.9380552813425469,4081,4023
9,8204,10,100,0.001,0.01,0.752,0.9269868356899074,4135,4069
9,8304,10,100,0.001,0.01,0.746,0.9263005780346821,4173,4131
9,8404,10,100,0.001,0.01,0.754,0.9250356972870062,4220,4184
9,8504,10,100,0.001,0.01,0.76,0.9330903104421449,4268,4236
9,8604,10,100,0.001,0.01,0.77,0.9274755927475593,4310,4294
9,8704,10,100,0.001,0.01,0.756,0.9073988970588235,4355,4349
9,8804,10,100,0.001,0.01,0.768,0.9249204906860518,4404,4400
9,8904,10,100,0.001,0.01,0.76,0.9303683737646001,4446,4458
9,9004,10,100,0.001,0.01,0.768,0.9303642825410928,4495,4509
9,9104,10,100,0.001,0.01,0.778,0.9260764499121266,4545,4559
9,9204,10,100,0.001,0.01,0.756,0.924380704041721,4594,4610
9,9304,10,100,0.001,0.01,0.76,0.913907996560619,4645,4659
9,9404,10,100,0.001,0.01,0.764,0.9184389621437686,4694,4710
9,9504,10,100,0.001,0.01,0.756,0.9289772727272727,4742,4762
9,9604,10,100,0.001,0.01,0.734,0.913890045814244,4787,4817
9,9704,10,100,0.001,0.01,0.746,0.9091096455070075,4836,4868
9,9804,10,100,0.001,0.01,0.734,0.9191146470828233,4886,4918
9,9904,10,100,0.001,0.01,0.752,0.9170032310177706,4934,4970
9,10004,10,100,0.001,0.01,0.778,0.9337265093962415,4988,5016
9,10104,10,100,0.001,0.01,0.76,0.9347783056215361,5044,5060
9,10204,10,100,0.001,0.01,0.798,0.9452175617404939,5097,5107
9,10304,10,100,0.001,0.01,0.786,0.9462344720496895,5150,5154
9,10404,10,100,0.001,0.01,0.786,0.9338715878508266,5206,5198
9,10504,10,100,0.001,0.01,0.808,0.9427837014470678,5254,5250
9,10604,10,100,0.001,0.01,0.794,0.9354017351942663,5316,5288
9,10704,10,100,0.001,0.01,0.81,0.9208707025411061,5363,5341
9,10804,10,100,0.001,0.01,0.8,0.9341910403554239,5416,5388
9,10904,10,100,0.001,0.01,0.796,0.9240645634629494,5461,5443
9,11004,10,100,0.001,0.01,0.772,0.9078516902944384,5511,5493
9,11104,10,100,0.001,0.01,0.796,0.9221902017291066,5555,5549
9,11204,10,100,0.001,0.01,0.816,0.9374330596215638,5605,5599
9,11304,10,100,0.001,0.01,0.814,0.9387827317763624,5657,5647
9,11404,10,100,0.001,0.01,0.794,0.9415117502630655,5707,5697
9,11504,10,100,0.001,0.01,0.782,0.9098574408901252,5753,5751
9,11604,10,100,0.001,0.01,0.79,0.932092381937263,5803,5801
9,11704,10,100,0.001,0.01,0.808,0.9349794941900205,5852,5852
9,11804,10,100,0.001,0.01,0.806,0.951118264994917,5907,5897
9,11904,10,100,0.001,0.01,0.798,0.951192876344086,5958,5946
9,12004,10,100,0.001,0.01,0.804,0.9498500499833389,6007,5997
9,12104,10,100,0.001,0.01,0.802,0.9499339061467283,6051,6053
9,12204,10,100,0.001,0.01,0.812,0.9469845952146837,6108,6096
9,12304,10,100,0.001,0.01,0.812,0.9589564369310793,6156,6148
9,12404,10,100,0.001,0.01,0.808,0.9454208319896807,6207,6197
9,12504,10,100,0.001,0.01,0.812,0.9430582213691618,6257,6247
9,12604,10,100,0.001,0.01,0.82,0.956125039669946,6304,6300
9,12704,10,100,0.001,0.01,0.832,0.966624685138539,6356,6348
9,12804,10,100,0.001,0.01,0.816,0.9495470165573259,6398,6406
9,12904,10,100,0.001,0.01,0.81,0.93978611283323,6454,6450
9,13004,10,100,0.001,0.01,0.822,0.9497077822208552,6496,6508
9,13104,10,100,0.001,0.01,0.848,0.9595543345543346,6539,6565
9,13204,10,100,0.001,0.01,0.818,0.9645561950923962,6590,6614
9,13304,10,100,0.001,0.01,0.85,0.9645971136500301,6641,6663
9,13404,10,100,0.001,0.01,0.836,0.9468815279021188,6685,6719
9,13504,10,100,0.001,0.01,0.774,0.9147659952606635,6729,6775
9,13604,10,100,0.001,0.01,0.812,0.9279623640105851,6787,6817
9,13704,10,100,0.001,0.01,0.844,0.9611792177466433,6835,6869
9,13804,10,100,0.001,0.01,0.876,0.9576934221964648,6891,6913
9,13904,10,100,0.001,0.01,0.828,0.9508055235903338,6940,6964
9,14004,10,100,0.001,0.01,0.832,0.9484433019137389,6996,7008
9,14104,10,100,0.001,0.01,0.874,0.9677396483267158,7054,7050
9,14204,10,100,0.001,0.01,0.876,0.9666995212616164,7100,7104
9,14304,10,100,0.001,0.01,0.872,0.9704977628635347,7148,7156
9,14404,10,100,0.001,0.01,0.892,0.9663982227159122,7200,7204
9,14504,10,100,0.001,0.01,0.892,0.9706287920573635,7255,7249
9,14604,10,100,0.001,0.01,0.878,0.9616543412763626,7313,7291
9,14704,10,100,0.001,0.01,0.878,0.9593307943416758,7368,7336
9,14804,10,100,0.001,0.01,0.902,0.9750067549310997,7405,7399
9,14904,10,100,0.001,0.01,0.872,0.9676596886741814,7452,7452
9,15004,10,100,0.001,0.01,0.874,0.9779392162090109,7499,7505
10,104,10,100,0.001,0.01,0.494,0.7692307692307693,51,53
10,204,10,100,0.001,0.01,0.488,0.7009803921568627,103,101
10,304,10,100,0.001,0.01,0.468,0.7072368421052632,144,160
10,404,10,100,0.001,0.01,0.516,0.6534653465346535,186,218
10,504,10,100,0.001,0.01,0.496,0.6607142857142857,238,266
10,604,10,100,0.001,0.01,0.476,0.6870860927152318,279,325
10,704,10,100,0.001,0.01,0.526,0.6676136363636364,327,377
10,804,10,100,0.001,0.01,0.516,0.6878109452736318,378,426
10,904,10,100,0.001,0.01,0.526,0.7002212389380531,423,481
10,1004,10,100,0.001,0.01,0.512,0.6653386454183267,472,532
10,1104,10,100,0.001,0.01,0.49,0.7010869565217391,527,577
10,1204,10,100,0.001,0.01,0.498,0.7383720930232558,577,627
10,1304,10,100,0.001,0.01,0.528,0.7346625766871165,615,689
10,1404,10,100,0.001,0.01,0.484,0.7371794871794872,674,730
10,1504,10,100,0.001,0.01,0.5,0.7406914893617021,722,782
10,1604,10,100,0.001,0.01,0.524,0.7468827930174564,770,834
10,1704,10,100,0.001,0.01,0.514,0.761150234741784,815,889
10,1804,10,100,0.001,0.01,0.524,0.7888026607538803,863,941
10,1904,10,100,0.001,0.01,0.51,0.8009453781512605,915,989
10,2004,10,100,0.001,0.01,0.502,0.7689620758483033,968,1036
10,2104,10,100,0.001,0.01,0.546,0.7846958174904943,1024,1080
10,2204,10,100,0.001,0.01,0.55,0.7971869328493648,1074,1130
10,2304,10,100,0.001,0.01,0.58,0.8263888888888888,1122,1182
10,2404,10,100,0.001,0.01,0.586,0.8490016638935108,1173,1231
10,2504,10,100,0.001,0.01,0.58,0.8562300319488818,1225,1279
10,2604,10,100,0.001,0.01,0.586,0.8605990783410138,1281,1323
10,2704,10,100,0.001,0.01,0.618,0.8731508875739645,1333,1371
10,2804,10,100,0.001,0.01,0.604,0.8994293865905849,1398,1406
10,2904,10,100,0.001,0.01,0.606,0.8908402203856749,1451,1453
10,3004,10,100,0.001,0.01,0.644,0.8971371504660453,1501,1503
10,3104,10,100,0.001,0.01,0.672,0.8701675257731959,1541,1563
10,3204,10,100,0.001,0.01,0.678,0.8835830212234707,1601,1603
10,3304,10,100,0.001,0.01,0.666,0.9004237288135594,1658,1646
10,3404,10,100,0.001,0.01,0.674,0.9106933019976499,1707,1697
10,3504,10,100,0.001,0.01,0.676,0.8867009132420092,1763,1741
10,3604,10,100,0.001,0.01,0.68,0.9067702552719201,1809,1795
10,3704,10,100,0.001,0.01,0.688,0.9144168466522679,1859,1845
10,3804,10,100,0.001,0.01,0.686,0.9169295478443743,1898,1906
10,3904,10,100,0.001,0.01,0.704,0.9228995901639344,1943,1961
10,4004,10,100,0.001,0.01,0.716,0.9263236763236763,1991,2013
10,4104,10,100,0.001,0.01,0.75,0.9376218323586745,2043,2061
10,4204,10,100,0.001,0.01,0.728,0.9155566127497621,2094,2110
10,4304,10,100,0.001,0.01,0.744,0.9440055762081785,2146,2158
10,4404,10,100,0.001,0.01,0.718,0.917574931880109,2198,2206
10,4504,10,100,0.001,0.01,0.722,0.8645648312611013,2253,2251
10,4604,10,100,0.001,0.01,0.74,0.9109470026064292,2305,2299
10,4704,10,100,0.001,0.01,0.736,0.9241071428571429,2350,2354
10,4804,10,100,0.001,0.01,0.764,0.9086178184845962,2403,2401
10,4904,10,100,0.001,0.01,0.73,0.8807096247960848,2451,2453
10,5004,10,100,0.001,0.01,0.766,0.9144684252597922,2494,2510
10,5104,10,100,0.001,0.01,0.758,0.890282131661442,2538,2566
10,5204,10,100,0.001,0.01,0.774,0.9083397386625672,2584,2620
10,5304,10,100,0.001,0.01,0.784,0.9113876319758673,2628,2676
10,5404,10,100,0.001,0.01,0.78,0.9302368615840119,2681,2723
10,5504,10,100,0.001,0.01,0.778,0.9454941860465116,2744,2760
10,5604,10,100,0.001,0.01,0.762,0.9493219129193433,2795,2809
10,5704,10,100,0.001,0.01,0.78,0.9544179523141655,2838,2866
10,5804,10,100,0.001,0.01,0.756,0.9409028256374914,2891,2913
10,5904,10,100,0.001,0.01,0.784,0.9451219512195121,2950,2954
10,6004,10,100,0.001,0.01,0.802,0.9458694203864091,2997,3007
10,6104,10,100,0.001,0.01,0.8,0.9426605504587156,3048,3056
10,6204,10,100,0.001,0.01,0.796,0.9576079948420374,3101,3103
10,6304,10,100,0.001,0.01,0.794,0.965260152284264,3152,3152
10,6404,10,100,0.001,0.01,0.812,0.9414428482198626,3199,3205
10,6504,10,100,0.001,0.01,0.798,0.9240467404674046,3256,3248
10,6604,10,100,0.001,0.01,0.828,0.9377649909145972,3305,3299
10,6704,10,100,0.001,0.01,0.802,0.945554892601432,3355,3349
10,6804,10,100,0.001,0.01,0.822,0.952527924750147,3407,3397
10,6904,10,100,0.001,0.01,0.806,0.9575608342989571,3451,3453
10,7004,10,100,0.001,0.01,0.812,0.9590234151913193,3496,3508
10,7104,10,100,0.001,0.01,0.83,0.9601632882882883,3540,3564
10,7204,10,100,0.001,0.01,0.818,0.9532204330927263,3596,3608
10,7304,10,100,0.001,0.01,0.822,0.9327765607886089,3650,3654
10,7404,10,100,0.001,0.01,0.836,0.9500270124257159,3690,3714
10,7504,10,100,0.001,0.01,0.848,0.9640191897654584,3744,3760
10,7604,10,100,0.001,0.01,0.854,0.9610731194108364,3791,3813
10,7704,10,100,0.001,0.01,0.838,0.9674195223260644,3839,3865
10,7804,10,100,0.001,0.01,0.836,0.9513070220399795,3881,3923
10,7904,10,100,0.001,0.01,0.812,0.9251012145748988,3933,3971
10,8004,10,100,0.001,0.01,0.832,0.9377811094452774,3989,4015
10,8104,10,100,0.001,0.01,0.81,0.898568608094768,4035,4069
10,8204,10,100,0.001,0.01,0.842,0.9263773768893223,4085,4119
10,8304,10,100,0.001,0.01,0.854,0.9318400770712909,4133,4171
10,8404,10,100,0.001,0.01,0.866,0.9516896715849595,4185,4219
10,8504,10,100,0.001,0.01,0.866,0.9560206961429916,4235,4269
10,8604,10,100,0.001,0.01,0.85,0.9653649465364946,4283,4321
10,8704,10,100,0.001,0.01,0.856,0.9644990808823529,4327,4377
10,8804,10,100,0.001,0.01,0.866,0.9637664697864607,4371,4433
10,8904,10,100,0.001,0.01,0.854,0.9666442048517521,4423,4481
10,9004,10,100,0.001,0.01,0.83,0.932252332296757,4466,4538
10,9104,10,100,0.001,0.01,0.88,0.9576010544815465,4520,4584
10,9204,10,100,0.001,0.01,0.87,0.9624076488483269,4563,4641
10,9304,10,100,0.001,0.01,0.874,0.9679707652622528,4618,4686
10,9404,10,100,0.001,0.01,0.872,0.9715014887282007,4672,4732
10,9504,10,100,0.001,0.01,0.862,0.9646464646464646,4725,4779
10,9604,10,100,0.001,0.01,0.836,0.9229487713452728,4770,4834
10,9704,10,100,0.001,0.01,0.852,0.9210634789777411,4814,4890
10,9804,10,100,0.001,0.01,0.884,0.9568543451652387,4859,4945
10,9904,10,100,0.001,0.01,0.878,0.9634491114701131,4913,4991
10,10004,10,100,0.001,0.01,0.87,0.9729108356657337,4960,5044
10,10104,10,100,0.001,0.01,0.878,0.9652612826603325,5009,5095
10,10204,10,100,0.001,0.01,0.884,0.973735789886319,5065,5139
10,10304,10,100,0.001,0.01,0.86,0.9737965838509317,5120,5184
10,10404,10,100,0.001,0.01,0.864,0.961361014994233,5174,5230
10,10504,10,100,0.001,0.01,0.868,0.9541127189642041,5217,5287
10,10604,10,100,0.001,0.01,0.87,0.9617125612976235,5269,5335
10,10704,10,100,0.001,0.01,0.854,0.9728139013452914,5321,5383
10,10804,10,100,0.001,0.01,0.872,0.9621436504998149,5372,5432
10,10904,10,100,0.001,0.01,0.874,0.9689104915627292,5425,5479
10,11004,10,100,0.001,0.01,0.89,0.9742820792439113,5466,5538
10,11104,10,100,0.001,0.01,0.874,0.9734329971181557,5510,5594
10,11204,10,100,0.001,0.01,0.89,0.9754551945733666,5567,5637
10,11304,10,100,0.001,0.01,0.864,0.9492215145081387,5614,5690
10,11404,10,100,0.001,0.01,0.888,0.9587863907400912,5662,5742
10,11504,10,100,0.001,0.01,0.882,0.9687065368567455,5705,5799
10,11604,10,100,0.001,0.01,0.862,0.9416580489486384,5750,5854
10,11704,10,100,0.001,0.01,0.892,0.959501025290499,5805,5899
10,11804,10,100,0.001,0.01,0.89,0.9723822433073535,5855,5949
10,11904,10,100,0.001,0.01,0.9,0.9761424731182796,5906,5998
10,12004,10,100,0.001,0.01,0.878,0.9665944685104965,5958,6046
10,12104,10,100,0.001,0.01,0.89,0.9818241903502974,6008,6096
10,12204,10,100,0.001,0.01,0.884,0.9780399868895444,6049,6155
10,12304,10,100,0.001,0.01,0.878,0.9685468140442133,6107,6197
10,12404,10,100,0.001,0.01,0.896,0.9742824895195098,6159,6245
10,12504,10,100,0.001,0.01,0.902,0.9615323096609085,6205,6299
10,12604,10,100,0.001,0.01,0.882,0.9635829895271343,6252,6352
10,12704,10,100,0.001,0.01,0.906,0.9828400503778337,6309,6395
10,12804,10,100,0.001,0.01,0.91,0.9807872539831303,6359,6445
10,12904,10,100,0.001,0.01,0.902,0.976673899566026,6411,6493
10,13004,10,100,0.001,0.01,0.908,0.979621654875423,6460,6544
10,13104,10,100,0.001,0.01,0.91,0.9822954822954822,6509,6595
10,13204,10,100,0.001,0.01,0.892,0.9796273856407149,6571,6633
10,13304,10,100,0.001,0.01,0.914,0.9809079975947084,6622,6682
10,13404,10,100,0.001,0.01,0.906,0.9795583407937929,6676,6728
10,13504,10,100,0.001,0.01,0.914,0.9759330568720379,6736,6768
10,13604,10,100,0.001,0.01,0.916,0.9730226403998824,6784,6820
10,13704,10,100,0.001,0.01,0.918,0.969424985405721,6842,6862
10,13804,10,100,0.001,0.01,0.928,0.9829759490002897,6894,6910
10,13904,10,100,0.001,0.01,0.916,0.9841052934407365,6942,6962
10,14004,10,100,0.001,0.01,0.932,0.9891459582976293,6990,7014
10,14104,10,100,0.001,0.01,0.918,0.9879466817923993,7041,7063
10,14204,10,100,0.001,0.01,0.902,0.975147845677274,7094,7110
10,14304,10,100,0.001,0.01,0.908,0.9681208053691275,7144,7160
10,14404,10,100,0.001,0.01,0.914,0.9729936128853096,7191,7213
10,14504,10,100,0.001,0.01,0.902,0.9800744622173193,7241,7263
10,14604,10,100,0.001,0.01,0.93,0.9915776499589154,7290,7314
10,14704,10,100,0.001,0.01,0.914,0.9897306855277476,7340,7364
10,14804,10,100,0.001,0.01,0.918,0.9843285598486895,7397,7407
10,14904,10,100,0.001,0.01,0.896,0.9799382716049383,7443,7461
10,15004,10,100,0.001,0.01,0.926,0.9845374566782191,7505,7499
11,104,10,100,0.001,0.01,0.486,0.5480769230769231,57,47
11,204,10,100,0.001,0.01,0.43,0.6127450980392157,112,92
11,304,10,100,0.001,0.01,0.452,0.625,167,137
11,404,10,100,0.001,0.01,0.478,0.6237623762376238,218,186
11,504,10,100,0.001,0.01,0.468,0.6309523809523809,267,237
11,604,10,100,0.001,0.01,0.472,0.609271523178808,311,293
11,704,10,100,0.001,0.01,0.48,0.6505681818181818,368,336
11,804,10,100,0.001,0.01,0.496,0.6455223880597015,417,387
11,904,10,100,0.001,0.01,0.51,0.6592920353982301,482,422
11,1004,10,100,0.001,0.01,0.498,0.6713147410358565,543,461
11,1104,10,100,0.001,0.01,0.52,0.6893115942028986,594,510
11,1204,10,100,0.001,0.01,0.512,0.7093023255813954,651,553
11,1304,10,100,0.001,0.01,0.506,0.6679447852760736,701,603
11,1404,10,100,0.001,0.01,0.514,0.6759259259259259,740,664
11,1504,10,100,0.001,0.01,0.498,0.6529255319148937,789,715
11,1604,10,100,0.001,0.01,0.486,0.6452618453865336,839,765
11,1704,10,100,0.001,0.01,0.53,0.6936619718309859,892,812
11,1804,10,100,0.001,0.01,0.53,0.717849223946785,939,865
11,1904,10,100,0.001,0.01,0.508,0.6980042016806722,993,911
11,2004,10,100,0.001,0.01,0.53,0.719061876247505,1042,962
11,2104,10,100,0.001,0.01,0.488,0.7024714828897338,1096,1008
11,2204,10,100,0.001,0.01,0.5,0.7264065335753176,1146,1058
11,2304,10,100,0.001,0.01,0.49,0.7118055555555556,1194,1110
11,2404,10,100,0.001,0.01,0.49,0.7292013311148087,1243,1161
11,2504,10,100,0.001,0.01,0.512,0.7368210862619808,1289,1215
11,2604,10,100,0.001,0.01,0.518,0.7438556067588326,1338,1266
11,2704,10,100,0.001,0.01,0.5,0.7496301775147929,1389,1315
11,2804,10,100,0.001,0.01,0.526,0.7596291012838802,1435,1369
11,2904,10,100,0.001,0.01,0.524,0.7555096418732782,1477,1427
11,3004,10,100,0.001,0.01,0.51,0.7603195739014648,1526,1478
11,3104,10,100,0.001,0.01,0.528,0.7599871134020618,1579,1525
11,3204,10,100,0.001,0.01,0.526,0.7503121098626716,1628,1576
11,3304,10,100,0.001,0.01,0.522,0.7503026634382567,1673,1631
11,3404,10,100,0.001,0.01,0.526,0.7787896592244419,1723,1681
11,3504,10,100,0.001,0.01,0.502,0.7785388127853882,1774,1730
11,3604,10,100,0.001,0.01,0.51,0.7766370699223085,1832,1772
11,3704,10,100,0.001,0.01,0.496,0.787257019438445,1874,1830
11,3804,10,100,0.001,0.01,0.484,0.7584121976866456,1920,1884
11,3904,10,100,0.001,0.01,0.524,0.7494877049180327,1963,1941
11,4004,10,100,0.001,0.01,0.512,0.7762237762237763,2014,1990
11,4104,10,100,0.001,0.01,0.552,0.7909356725146199,2068,2036
11,4204,10,100,0.001,0.01,0.55,0.8011417697431018,2120,2084
11,4304,10,100,0.001,0.01,0.544,0.7723048327137546,2164,2140
11,4404,10,100,0.001,0.01,0.57,0.797683923705722,2216,2188
11,4504,10,100,0.001,0.01,0.578,0.8066163410301954,2263,2241
11,4604,10,100,0.001,0.01,0.574,0.8192875760208514,2318,2286
11,4704,10,100,0.001,0.01,0.568,0.8216411564625851,2372,2332
11,4804,10,100,0.001,0.01,0.538,0.8166111573688593,2424,2380
11,4904,10,100,0.001,0.01,0.564,0.8209624796084829,2481,2423
11,5004,10,100,0.001,0.01,0.554,0.8289368505195843,2527,2477
11,5104,10,100,0.001,0.01,0.554,0.7480407523510971,2580,2524
11,5204,10,100,0.001,0.01,0.57,0.7892006149116064,2627,2577
11,5304,10,100,0.001,0.01,0.562,0.8133484162895928,2677,2627
11,5404,10,100,0.001,0.01,0.574,0.8323464100666174,2726,2678
11,5504,10,100,0.001,0.01,0.554,0.837390988372093,2775,2729
11,5604,10,100,0.001,0.01,0.566,0.833868665239115,2822,2782
11,5704,10,100,0.001,0.01,0.592,0.8052244039270687,2868,2836
11,5804,10,100,0.001,0.01,0.606,0.8239145416953825,2924,2880
11,5904,10,100,0.001,0.01,0.578,0.8267276422764228,2976,2928
11,6004,10,100,0.001,0.01,0.6,0.8352764823451032,3028,2976
11,6104,10,100,0.001,0.01,0.592,0.7971821756225426,3089,3015
11,6204,10,100,0.001,0.01,0.588,0.8343004513217279,3148,3056
11,6304,10,100,0.001,0.01,0.584,0.8466053299492385,3194,3110
11,6404,10,100,0.001,0.01,0.604,0.8497813866333541,3248,3156
11,6504,10,100,0.001,0.01,0.618,0.8416359163591636,3300,3204
11,6604,10,100,0.001,0.01,0.648,0.8525136281041793,3352,3252
11,6704,10,100,0.001,0.01,0.636,0.8436754176610979,3394,3310
11,6804,10,100,0.001,0.01,0.634,0.8672839506172839,3438,3366
11,6904,10,100,0.001,0.01,0.608,0.8799246813441484,3485,3419
11,7004,10,100,0.001,0.01,0.66,0.8745002855511137,3534,3470
11,7104,10,100,0.001,0.01,0.618,0.8631756756756757,3582,3522
11,7204,10,100,0.001,0.01,0.642,0.8745141588006663,3632,3572
11,7304,10,100,0.001,0.01,0.63,0.867196056955093,3685,3619
11,7404,10,100,0.001,0.01,0.636,0.8683144246353323,3737,3667
11,7504,10,100,0.001,0.01,0.626,0.853411513859275,3781,3723
11,7604,10,100,0.001,0.01,0.648,0.8602051551814834,3833,3771
11,7704,10,100,0.001,0.01,0.63,0.868380062305296,3891,3813
11,7804,10,100,0.001,0.01,0.658,0.8682726806765761,3937,3867
11,7904,10,100,0.001,0.01,0.652,0.8804402834008097,3987,3917
11,8004,10,100,0.001,0.01,0.648,0.888055972013993,4044,3960
11,8104,10,100,0.001,0.01,0.682,0.8809230009871668,4088,4016
11,8204,10,100,0.001,0.01,0.674,0.8781082398829839,4128,4076
11,8304,10,100,0.001,0.01,0.672,0.8876445086705202,4174,4130
11,8404,10,100,0.001,0.01,0.674,0.8914802475011899,4226,4178
11,8504,10,100,0.001,0.01,0.652,0.8907572906867357,4266,4238
11,8604,10,100,0.001,0.01,0.678,0.8938865643886564,4320,4284
11,8704,10,100,0.001,0.01,0.678,0.8848805147058824,4369,4335
11,8804,10,100,0.001,0.01,0.688,0.8816447069513857,4425,4379
11,8904,10,100,0.001,0.01,0.652,0.8611859838274932,4473,4431
11,9004,10,100,0.001,0.01,0.664,0.8693913816081742,4519,4485
11,9104,10,100,0.001,0.01,0.69,0.8651142355008787,4563,4541
11,9204,10,100,0.001,0.01,0.704,0.8721208170360712,4611,4593
11,9304,10,100,0.001,0.01,0.7,0.8725279449699054,4653,4651
11,9404,10,100,0.001,0.01,0.714,0.8761165461505742,4704,4700
11,9504,10,100,0.001,0.01,0.67,0.8615319865319865,4760,4744
11,9604,10,100,0.001,0.01,0.686,0.8789046230737193,4813,4791
11,9704,10,100,0.001,0.01,0.71,0.8873660346248969,4865,4839
11,9804,10,100,0.001,0.01,0.7,0.8841289269685843,4901,4903
11,9904,10,100,0.001,0.01,0.69,0.8555129240710824,4954,4950
11,10004,10,100,0.001,0.01,0.698,0.875749700119952,5007,4997
11,10104,10,100,0.001,0.01,0.694,0.8786619160728424,5057,5047
11,10204,10,100,0.001,0.01,0.69,0.8696589572716582,5111,5093
11,10304,10,100,0.001,0.01,0.702,0.8805318322981367,5156,5148
11,10404,10,100,0.001,0.01,0.726,0.8884083044982699,5217,5187
11,10504,10,100,0.001,0.01,0.702,0.8914699162223915,5269,5235
11,10604,10,100,0.001,0.01,0.72,0.8888155413051678,5325,5279
11,10704,10,100,0.001,0.01,0.694,0.8970478325859492,5377,5327
11,10804,10,100,0.001,0.01,0.714,0.8775453535727509,5429,5375
11,10904,10,100,0.001,0.01,0.68,0.8567498165810712,5477,5427
11,11004,10,100,0.001,0.01,0.698,0.8681388585968739,5527,5477
11,11104,10,100,0.001,0.01,0.716,0.8854466858789626,5571,5533
11,11204,10,100,0.001,0.01,0.72,0.8817386647625848,5625,5579
11,11304,10,100,0.001,0.01,0.71,0.8655343241330502,5675,5629
11,11404,10,100,0.001,0.01,0.722,0.8869694843914416,5719,5685
11,11504,10,100,0.001,0.01,0.718,0.8824756606397774,5769,5735
11,11604,10,100,0.001,0.01,0.716,0.8909858669424336,5814,5790
11,11704,10,100,0.001,0.01,0.71,0.8838858509911142,5869,5835
11,11804,10,100,0.001,0.01,0.734,0.8855472721111488,5927,5877
11,11904,10,100,0.001,0.01,0.708,0.8734038978494624,5977,5927
11,12004,10,100,0.001,0.01,0.718,0.8875374875041653,6028,5976
11,12104,10,100,0.001,0.01,0.748,0.8967283542630535,6077,6027
11,12204,10,100,0.001,0.01,0.75,0.9048672566371682,6128,6076
11,12304,10,100,0.001,0.01,0.762,0.909297789336801,6174,6130
11,12404,10,100,0.001,0.01,0.752,0.9050306352789422,6222,6182
11,12504,10,100,0.001,0.01,0.784,0.9133077415227128,6271,6233
11,12604,10,100,0.001,0.01,0.782,0.9173278324341478,6327,6277
11,12704,10,100,0.001,0.01,0.764,0.9142002518891688,6376,6328
11,12804,10,100,0.001,0.01,0.768,0.9101843174008123,6431,6373
11,12904,10,100,0.001,0.01,0.802,0.9235895846249225,6471,6433
11,13004,10,100,0.001,0.01,0.778,0.9152568440479852,6528,6476
11,13104,10,100,0.001,0.01,0.766,0.9097222222222222,6574,6530
11,13204,10,100,0.001,0.01,0.786,0.9066192063011209,6625,6579
11,13304,10,100,0.001,0.01,0.788,0.9240078171978352,6680,6624
11,13404,10,100,0.001,0.01,0.78,0.9305431214562817,6725,6679
11,13504,10,100,0.001,0.01,0.786,0.9137292654028436,6772,6732
11,13604,10,100,0.001,0.01,0.786,0.9268597471331961,6824,6780
11,13704,10,100,0.001,0.01,0.78,0.9150612959719789,6868,6836
11,13804,10,100,0.001,0.01,0.772,0.9120544769631991,6915,6889
11,13904,10,100,0.001,0.01,0.806,0.9341915995397008,6960,6944
11,14004,10,100,0.001,0.01,0.8,0.9325906883747501,7002,7002
11,14104,10,100,0.001,0.01,0.796,0.9335649461145774,7049,7055
11,14204,10,100,0.001,0.01,0.796,0.9381864263587721,7103,7101
11,14304,10,100,0.001,0.01,0.792,0.921420581655481,7153,7151
11,14404,10,100,0.001,0.01,0.794,0.9250902527075813,7211,7193
11,14504,10,100,0.001,0.01,0.806,0.9079564258135687,7265,7239
11,14604,10,100,0.001,0.01,0.812,0.9215283483976993,7320,7284
11,14704,10,100,0.001,0.01,0.816,0.9276387377584331,7372,7332
11,14804,10,100,0.001,0.01,0.808,0.9338692245339097,7421,7383
11,14904,10,100,0.001,0.01,0.808,0.9334406870638755,7466,7438
11,15004,10,100,0.001,0.01,0.818,0.9358171154358838,7509,7495
12,104,10,100,0.001,0.01,0.504,0.6153846153846154,44,60
12,204,10,100,0.001,0.01,0.478,0.6225490196078431,93,111
12,304,10,100,0.001,0.01,0.512,0.5888157894736842,138,166
12,404,10,100,0.001,0.01,0.508,0.6460396039603961,198,206
12,504,10,100,0.001,0.01,0.498,0.6130952380952381,256,248
12,604,10,100,0.001,0.01,0.488,0.6324503311258278,304,300
12,704,10,100,0.001,0.01,0.496,0.6676136363636364,350,354
12,804,10,100,0.001,0.01,0.518,0.6753731343283582,399,405
12,904,10,100,0.001,0.01,0.492,0.6703539823008849,448,456
12,1004,10,100,0.001,0.01,0.506,0.6812749003984063,497,507
12,1104,10,100,0.001,0.01,0.52,0.6956521739130435,556,548
12,1204,10,100,0.001,0.01,0.522,0.7134551495016611,605,599
12,1304,10,100,0.001,0.01,0.51,0.700920245398773,649,655
12,1404,10,100,0.001,0.01,0.534,0.7215099715099715,707,697
12,1504,10,100,0.001,0.01,0.512,0.7367021276595744,755,749
12,1604,10,100,0.001,0.01,0.488,0.756857855361596,808,796
12,1704,10,100,0.001,0.01,0.484,0.7646713615023474,855,849
12,1804,10,100,0.001,0.01,0.482,0.7854767184035477,910,894
12,1904,10,100,0.001,0.01,0.506,0.7746848739495799,961,943
12,2004,10,100,0.001,0.01,0.502,0.7799401197604791,1005,999
12,2104,10,100,0.001,0.01,0.492,0.8041825095057035,1058,1046
12,2204,10,100,0.001,0.01,0.508,0.7903811252268602,1102,1102
12,2304,10,100,0.001,0.01,0.518,0.8098958333333334,1150,1154
12,2404,10,100,0.001,0.01,0.534,0.8211314475873545,1202,1202
12,2504,10,100,0.001,0.01,0.532,0.8182907348242812,1258,1246
12,2604,10,100,0.001,0.01,0.518,0.8145161290322581,1303,1301
12,2704,10,100,0.001,0.01,0.532,0.7644230769230769,1341,1363
12,2804,10,100,0.001,0.01,0.546,0.81169757489301,1390,1414
12,2904,10,100,0.001,0.01,0.558,0.8081955922865014,1437,1467
12,3004,10,100,0.001,0.01,0.556,0.7989347536617842,1484,1520
12,3104,10,100,0.001,0.01,0.576,0.7986469072164949,1539,1565
12,3204,10,100,0.001,0.01,0.566,0.8211610486891385,1596,1608
12,3304,10,100,0.001,0.01,0.544,0.8296004842615012,1643,1661
12,3404,10,100,0.001,0.01,0.554,0.854876615746181,1695,1709
12,3504,10,100,0.001,0.01,0.592,0.843607305936073,1738,1766
12,3604,10,100,0.001,0.01,0.566,0.8371254162042175,1784,1820
12,3704,10,100,0.001,0.01,0.59,0.833963282937365,1842,1862
12,3804,10,100,0.001,0.01,0.614,0.8714511041009464,1886,1918
12,3904,10,100,0.001,0.01,0.654,0.8842213114754098,1940,1964
12,4004,10,100,0.001,0.01,0.616,0.8958541458541458,1985,2019
12,4104,10,100,0.001,0.01,0.63,0.8923001949317739,2040,2064
12,4204,10,100,0.001,0.01,0.644,0.8860608943862988,2092,2112
12,4304,10,100,0.001,0.01,0.61,0.8963754646840149,2143,2161
12,4404,10,100,0.001,0.01,0.59,0.8887375113533151,2191,2213
12,4504,10,100,0.001,0.01,0.628,0.9056394316163411,2246,2258
12,4604,10,100,0.001,0.01,0.608,0.8662033014769766,2295,2309
12,4704,10,100,0.001,0.01,0.61,0.8660714285714286,2341,2363
12,4804,10,100,0.001,0.01,0.618,0.8890507910074937,2396,2408
12,4904,10,100,0.001,0.01,0.618,0.8635807504078303,2454,2450
12,5004,10,100,0.001,0.01,0.642,0.8886890487609912,2498,2506
12,5104,10,100,0.001,0.01,0.662,0.9000783699059561,2540,2564
12,5204,10,100,0.001,0.01,0.646,0.8939277478862413,2586,2618
12,5304,10,100,0.001,0.01,0.66,0.916289592760181,2635,2669
12,5404,10,100,0.001,0.01,0.668,0.9095114729829755,2684,2720
12,5504,10,100,0.001,0.01,0.64,0.857921511627907,2735,2769
12,5604,10,100,0.001,0.01,0.648,0.8813347608850821,2783,2821
12,5704,10,100,0.001,0.01,0.648,0.8742987377279102,2833,2871
12,5804,10,100,0.001,0.01,0.648,0.8919710544452102,2878,2926
12,5904,10,100,0.001,0.01,0.684,0.8985433604336044,2928,2976
12,6004,10,100,0.001,0.01,0.656,0.9112258494337109,2973,3031
12,6104,10,100,0.001,0.01,0.668,0.9146461336828309,3024,3080
12,6204,10,100,0.001,0.01,0.694,0.9153771760154739,3074,3130
12,6304,10,100,0.001,0.01,0.658,0.8811865482233503,3123,3181
12,6404,10,100,0.001,0.01,0.674,0.8988132417239225,3173,3231
12,6504,10,100,0.001,0.01,0.678,0.9085178351783518,3216,3288
12,6604,10,100,0.001,0.01,0.666,0.9229254996971532,3271,3333
12,6704,10,100,0.001,0.01,0.682,0.9127386634844868,3313,3391
12,6804,10,100,0.001,0.01,0.662,0.9169606114050558,3363,3441
12,6904,10,100,0.001,0.01,0.684,0.8852838933951332,3415,3489
12,7004,10,100,0.001,0.01,0.69,0.904768703597944,3468,3536
12,7104,10,100,0.001,0.01,0.678,0.9066722972972973,3524,3580
12,7204,10,100,0.001,0.01,0.716,0.9147695724597446,3567,3637
12,7304,10,100,0.001,0.01,0.694,0.9208652792990142,3619,3685
12,7404,10,100,0.001,0.01,0.722,0.9296326310102647,3666,3738
12,7504,10,100,0.001,0.01,0.7,0.9268390191897654,3716,3788
12,7604,10,100,0.001,0.01,0.706,0.9262230405049974,3772,3832
12,7704,10,100,0.001,0.01,0.738,0.9322429906542056,3820,3884
12,7804,10,100,0.001,0.01,0.716,0.931701691440287,3875,3929
12,7904,10,100,0.001,0.01,0.736,0.9207995951417004,3923,3981
12,8004,10,100,0.001,0.01,0.72,0.915792103948026,3967,4037
12,8104,10,100,0.001,0.01,0.764,0.9348469891411648,4014,4090
12,8204,10,100,0.001,0.01,0.764,0.9413700633837152,4061,4143
12,8304,10,100,0.001,0.01,0.772,0.9317196531791907,4108,4196
12,8404,10,100,0.001,0.01,0.754,0.9284864350309376,4157,4247
12,8504,10,100,0.001,0.01,0.762,0.9285042333019755,4208,4296
12,8604,10,100,0.001,0.01,0.724,0.9225941422594143,4265,4339
12,8704,10,100,0.001,0.01,0.736,0.9071691176470589,4317,4387
12,8804,10,100,0.001,0.01,0.78,0.9354838709677419,4366,4438
12,8904,10,100,0.001,0.01,0.762,0.941711590296496,4417,4487
12,9004,10,100,0.001,0.01,0.734,0.9338071968014215,4472,4532
12,9104,10,100,0.001,0.01,0.774,0.921682776801406,4519,4585
12,9204,10,100,0.001,0.01,0.79,0.9373098652759669,4572,4632
12,9304,10,100,0.001,0.01,0.77,0.944432502149613,4626,4678
12,9404,10,100,0.001,0.01,0.804,0.9394938324117397,4685,4719
12,9504,10,100,0.001,0.01,0.79,0.9525462962962963,4727,4777
12,9604,10,100,0.001,0.01,0.788,0.9542898792169929,4778,4826
12,9704,10,100,0.001,0.01,0.8,0.9518755152514426,4832,4872
12,9804,10,100,0.001,0.01,0.756,0.9485924112607099,4887,4917
12,9904,10,100,0.001,0.01,0.794,0.9566841680129241,4936,4968
12,10004,10,100,0.001,0.01,0.802,0.9521191523390644,4995,5009
12,10104,10,100,0.001,0.01,0.802,0.9557600950118765,5042,5062
12,10204,10,100,0.001,0.01,0.748,0.9132693061544492,5090,5114
12,10304,10,100,0.001,0.01,0.732,0.859569099378882,5138,5166
12,10404,10,100,0.001,0.01,0.782,0.9148404459823145,5193,5211
12,10504,10,100,0.001,0.01,0.794,0.9455445544554455,5246,5258
12,10604,10,100,0.001,0.01,0.826,0.9514334213504338,5294,5310
12,10704,10,100,0.001,0.01,0.826,0.9588938714499252,5342,5362
12,10804,10,100,0.001,0.01,0.792,0.9291003332099222,5389,5415
12,10904,10,100,0.001,0.01,0.752,0.8714233308877476,5439,5465
12,11004,10,100,0.001,0.01,0.81,0.9217557251908397,5498,5506
12,11104,10,100,0.001,0.01,0.82,0.9326368876080692,5555,5549
12,11204,10,100,0.001,0.01,0.844,0.9399321670831846,5608,5596
12,11304,10,100,0.001,0.01,0.832,0.9509907997169144,5645,5659
12,11404,10,100,0.001,0.01,0.848,0.950368291827429,5707,5697
12,11504,10,100,0.001,0.01,0.844,0.961230876216968,5757,5747
12,11604,10,100,0.001,0.01,0.846,0.9607032057911065,5810,5794
12,11704,10,100,0.001,0.01,0.858,0.9634313055365687,5859,5845
12,11804,10,100,0.001,0.01,0.846,0.9733141308031176,5910,5894
12,11904,10,100,0.001,0.01,0.878,0.9685819892473119,5954,5950
12,12004,10,100,0.001,0.01,0.872,0.9640119960013329,6013,5991
12,12104,10,100,0.001,0.01,0.866,0.9692663582286847,6054,6050
12,12204,10,100,0.001,0.01,0.85,0.9586201245493281,6106,6098
12,12304,10,100,0.001,0.01,0.862,0.959037711313394,6159,6145
12,12404,10,100,0.001,0.01,0.858,0.9731538213479523,6213,6191
12,12504,10,100,0.001,0.01,0.856,0.9632117722328855,6264,6240
12,12604,10,100,0.001,0.01,0.852,0.9384322437321485,6310,6294
12,12704,10,100,0.001,0.01,0.856,0.9330919395465995,6366,6338
12,12804,10,100,0.001,0.01,0.894,0.9636832239925024,6410,6394
12,12904,10,100,0.001,0.01,0.89,0.9670644761314321,6460,6444
12,13004,10,100,0.001,0.01,0.892,0.9577053214395571,6505,6499
12,13104,10,100,0.001,0.01,0.822,0.9164377289377289,6560,6544
12,13204,10,100,0.001,0.01,0.828,0.9475916388973038,6598,6606
12,13304,10,100,0.001,0.01,0.882,0.9623421527360192,6656,6648
12,13404,10,100,0.001,0.01,0.884,0.9688152790211877,6704,6700
12,13504,10,100,0.001,0.01,0.876,0.9716380331753555,6751,6753
12,13604,10,100,0.001,0.01,0.886,0.9764039988238753,6804,6800
12,13704,10,100,0.001,0.01,0.894,0.9824138937536485,6856,6848
12,13804,10,100,0.001,0.01,0.902,0.9771080846131556,6908,6896
12,13904,10,100,0.001,0.01,0.912,0.9794303797468354,6958,6946
12,14004,10,100,0.001,0.01,0.888,0.9478720365609826,7003,7001
12,14104,10,100,0.001,0.01,0.916,0.9736954055587067,7055,7049
12,14204,10,100,0.001,0.01,0.914,0.9866938890453394,7102,7102
12,14304,10,100,0.001,0.01,0.92,0.9832913870246085,7141,7163
12,14404,10,100,0.001,0.01,0.934,0.9907664537628437,7192,7212
12,14504,10,100,0.001,0.01,0.934,0.9917953667953668,7247,7257
12,14604,10,100,0.001,0.01,0.92,0.984661736510545,7289,7315
12,14704,10,100,0.001,0.01,0.912,0.9753808487486398,7338,7366
12,14804,10,100,0.001,0.01,0.926,0.9831126722507431,7392,7412
12,14904,10,100,0.001,0.01,0.932,0.980072463768116,7439,7465
12,15004,10,100,0.001,0.01,0.93,0.9854705411890162,7490,7514
13,104,10,100,0.001,0.01,0.478,0.4519230769230769,47,57
13,204,10,100,0.001,0.01,0.468,0.553921568627451,102,102
13,304,10,100,0.001,0.01,0.498,0.625,150,154
13,404,10,100,0.001,0.01,0.516,0.5420792079207921,196,208
13,504,10,100,0.001,0.01,0.5,0.5972222222222222,246,258
13,604,10,100,0.001,0.01,0.486,0.6473509933774835,295,309
13,704,10,100,0.001,0.01,0.488,0.6306818181818182,345,359
13,804,10,100,0.001,0.01,0.498,0.6629353233830846,406,398
13,904,10,100,0.001,0.01,0.492,0.6460176991150443,466,438
13,1004,10,100,0.001,0.01,0.514,0.6713147410358565,516,488
13,1104,10,100,0.001,0.01,0.52,0.6766304347826086,576,528
13,1204,10,100,0.001,0.01,0.528,0.6960132890365448,630,574
13,1304,10,100,0.001,0.01,0.502,0.6932515337423313,685,619
13,1404,10,100,0.001,0.01,0.516,0.7108262108262108,737,667
13,1504,10,100,0.001,0.01,0.496,0.682845744680851,785,719
13,1604,10,100,0.001,0.01,0.49,0.699501246882793,832,772
13,1704,10,100,0.001,0.01,0.478,0.6666666666666666,880,824
13,1804,10,100,0.001,0.01,0.514,0.6990022172949002,935,869
13,1904,10,100,0.001,0.01,0.514,0.7027310924369747,988,916
13,2004,10,100,0.001,0.01,0.5,0.7130738522954092,1034,970
13,2104,10,100,0.001,0.01,0.516,0.75,1083,1021
13,2204,10,100,0.001,0.01,0.506,0.7400181488203267,1135,1069
13,2304,10,100,0.001,0.01,0.49,0.7495659722222222,1186,1118
13,2404,10,100,0.001,0.01,0.518,0.7445923460898503,1235,1169
13,2504,10,100,0.001,0.01,0.51,0.7559904153354633,1287,1217
13,2604,10,100,0.001,0.01,0.506,0.7592165898617511,1336,1268
13,2704,10,100,0.001,0.01,0.51,0.7318786982248521,1386,1318
13,2804,10,100,0.001,0.01,0.506,0.7578459343794579,1436,1368
13,2904,10,100,0.001,0.01,0.518,0.7758264462809917,1481,1423
13,3004,10,100,0.001,0.01,0.518,0.7796271637816246,1528,1476
13,3104,10,100,0.001,0.01,0.514,0.78125,1582,1522
13,3204,10,100,0.001,0.01,0.53,0.7933832709113608,1633,1571
13,3304,10,100,0.001,0.01,0.502,0.8053874092009685,1683,1621
13,3404,10,100,0.001,0.01,0.504,0.7752643948296122,1733,1671
13,3504,10,100,0.001,0.01,0.482,0.738013698630137,1785,1719
13,3604,10,100,0.001,0.01,0.502,0.7447280799112098,1843,1761
13,3704,10,100,0.001,0.01,0.506,0.7697084233261339,1890,1814
13,3804,10,100,0.001,0.01,0.51,0.7949526813880127,1941,1863
13,3904,10,100,0.001,0.01,0.516,0.7973872950819673,1989,1915
13,4004,10,100,0.001,0.01,0.51,0.8159340659340659,2044,1960
13,4104,10,100,0.001,0.01,0.494,0.8096978557504874,2093,2011
13,4204,10,100,0.001,0.01,0.508,0.8132730732635585,2131,2073
13,4304,10,100,0.001,0.01,0.484,0.820631970260223,2182,2122
13,4404,10,100,0.001,0.01,0.506,0.8306085376930064,2221,2183
13,4504,10,100,0.001,0.01,0.484,0.8068383658969804,2273,2231
13,4604,10,100,0.001,0.01,0.488,0.8321025195482189,2321,2283
13,4704,10,100,0.001,0.01,0.472,0.8371598639455783,2365,2339
13,4804,10,100,0.001,0.01,0.47,0.828684429641965,2419,2385
13,4904,10,100,0.001,0.01,0.496,0.7795676998368679,2462,2442
13,5004,10,100,0.001,0.01,0.49,0.8163469224620303,2508,2496
13,5104,10,100,0.001,0.01,0.516,0.8307210031347962,2558,2546
13,5204,10,100,0.001,0.01,0.504,0.8291698693312837,2611,2593
13,5304,10,100,0.001,0.01,0.504,0.8242835595776772,2664,2640
13,5404,10,100,0.001,0.01,0.506,0.8451147298297558,2721,2683
13,5504,10,100,0.001,0.01,0.518,0.8363008720930233,2767,2737
13,5604,10,100,0.001,0.01,0.512,0.8361884368308351,2817,2787
13,5704,10,100,0.001,0.01,0.516,0.8038218793828892,2871,2833
13,5804,10,100,0.001,0.01,0.524,0.8289110957960028,2926,2878
13,5904,10,100,0.001,0.01,0.532,0.8443428184281843,2983,2921
13,6004,10,100,0.001,0.01,0.562,0.8432711525649567,3031,2973
13,6104,10,100,0.001,0.01,0.514,0.8571428571428571,3074,3030
13,6204,10,100,0.001,0.01,0.546,0.8430045132172792,3129,3075
13,6304,10,100,0.001,0.01,0.512,0.8178934010152284,3179,3125
13,6404,10,100,0.001,0.01,0.526,0.8408806995627732,3241,3163
13,6504,10,100,0.001,0.01,0.532,0.847939729397294,3292,3212
13,6604,10,100,0.001,0.01,0.554,0.8491823137492429,3341,3263
13,6704,10,100,0.001,0.01,0.54,0.8703758949880668,3385,3319
13,6804,10,100,0.001,0.01,0.536,0.8643445032333921,3439,3365
13,6904,10,100,0.001,0.01,0.536,0.8622537659327926,3489,3415
13,7004,10,100,0.001,0.01,0.514,0.8792118789263278,3538,3466
13,7104,10,100,0.001,0.01,0.548,0.8757038288288288,3585,3519
13,7204,10,100,0.001,0.01,0.548,0.8520266518600778,3642,3562
13,7304,10,100,0.001,0.01,0.544,0.8103778751369113,3690,3614
13,7404,10,100,0.001,0.01,0.562,0.8373851971907077,3738,3666
13,7504,10,100,0.001,0.01,0.548,0.8295575692963753,3784,3720
13,7604,10,100,0.001,0.01,0.552,0.8424513413992636,3836,3768
13,7704,10,100,0.001,0.01,0.546,0.7954309449636553,3880,3824
13,7804,10,100,0.001,0.01,0.574,0.8336750384418247,3922,3882
13,7904,10,100,0.001,0.01,0.578,0.8470394736842105,3969,3935
13,8004,10,100,0.001,0.01,0.572,0.8658170914542729,4019,3985
13,8104,10,100,0.001,0.01,0.55,0.8658687068114511,4073,4031
13,8204,10,100,0.001,0.01,0.592,0.8605558264261336,4126,4078
13,8304,10,100,0.001,0.01,0.58,0.8604287090558767,4171,4133
13,8404,10,100,0.001,0.01,0.584,0.873155640171347,4223,4181
13,8504,10,100,0.001,0.01,0.564,0.8701787394167451,4275,4229
13,8604,10,100,0.001,0.01,0.554,0.8773826127382612,4322,4282
13,8704,10,100,0.001,0.01,0.568,0.8737362132352942,4362,4342
13,8804,10,100,0.001,0.01,0.532,0.8841435711040436,4405,4399
13,8904,10,100,0.001,0.01,0.588,0.8742138364779874,4462,4442
13,9004,10,100,0.001,0.01,0.574,0.8788316303864949,4511,4493
13,9104,10,100,0.001,0.01,0.564,0.8837873462214412,4561,4543
13,9204,10,100,0.001,0.01,0.552,0.8895045632333768,4611,4593
13,9304,10,100,0.001,0.01,0.594,0.8593078245915735,4660,4644
13,9404,10,100,0.001,0.01,0.588,0.8807954062101233,4712,4692
13,9504,10,100,0.001,0.01,0.578,0.8859427609427609,4769,4735
13,9604,10,100,0.001,0.01,0.604,0.8858808829654311,4819,4785
13,9704,10,100,0.001,0.01,0.596,0.8898392415498764,4875,4829
13,9804,10,100,0.001,0.01,0.618,0.8882088943288454,4931,4873
13,9904,10,100,0.001,0.01,0.618,0.8980210016155089,4980,4924
13,10004,10,100,0.001,0.01,0.59,0.8774490203918432,5029,4975
13,10104,10,100,0.001,0.01,0.614,0.8856888361045131,5086,5018
13,10204,10,100,0.001,0.01,0.608,0.8896511172089376,5131,5073
13,10304,10,100,0.001,0.01,0.63,0.8977096273291926,5175,5129
13,10404,10,100,0.001,0.01,0.612,0.891676278354479,5225,5179
13,10504,10,100,0.001,0.01,0.616,0.8864242193450115,5275,5229
13,10604,10,100,0.001,0.01,0.592,0.8878725009430404,5315,5289
13,10704,10,100,0.001,0.01,0.622,0.9053624813153961,5371,5333
13,10804,10,100,0.001,0.01,0.658,0.8976305072195483,5414,5390
13,10904,10,100,0.001,0.01,0.638,0.8967351430667645,5464,5440
13,11004,10,100,0.001,0.01,0.636,0.8926753907669939,5517,5487
13,11104,10,100,0.001,0.01,0.632,0.8873378962536023,5562,5542
13,11204,10,100,0.001,0.01,0.65,0.8958407711531596,5616,5588
13,11304,10,100,0.001,0.01,0.64,0.8980891719745223,5669,5635
13,11404,10,100,0.001,0.01,0.658,0.8955629603647843,5717,5687
13,11504,10,100,0.001,0.01,0.644,0.9020340751043116,5779,5725
13,11604,10,100,0.001,0.01,0.632,0.9004653567735263,5834,5770
13,11704,10,100,0.001,0.01,0.654,0.8890123034859877,5873,5831
13,11804,10,100,0.001,0.01,0.646,0.9000338868180278,5924,5880
13,11904,10,100,0.001,0.01,0.646,0.9048219086021505,5964,5940
13,12004,10,100,0.001,0.01,0.674,0.9034488503832055,6017,5987
13,12104,10,100,0.001,0.01,0.66,0.8842531394580304,6070,6034
13,12204,10,100,0.001,0.01,0.654,0.893477548344805,6126,6078
13,12304,10,100,0.001,0.01,0.662,0.8875162548764629,6183,6121
13,12404,10,100,0.001,0.01,0.676,0.8981780070944857,6219,6185
13,12504,10,100,0.001,0.01,0.678,0.9120281509916827,6270,6234
13,12604,10,100,0.001,0.01,0.666,0.9123294192319898,6324,6280
13,12704,10,100,0.001,0.01,0.688,0.907588161209068,6372,6332
13,12804,10,100,0.001,0.01,0.682,0.9098719150265542,6429,6375
13,12904,10,100,0.001,0.01,0.692,0.9113453192808432,6481,6423
13,13004,10,100,0.001,0.01,0.68,0.9166410335281452,6527,6477
13,13104,10,100,0.001,0.01,0.63,0.8858363858363858,6570,6534
13,13204,10,100,0.001,0.01,0.678,0.9098757952135716,6621,6583
13,13304,10,100,0.001,0.01,0.686,0.913334335538184,6668,6636
13,13404,10,100,0.001,0.01,0.678,0.9102506714413607,6709,6695
13,13504,10,100,0.001,0.01,0.684,0.9075829383886256,6761,6743
13,13604,10,100,0.001,0.01,0.69,0.9123787121434872,6810,6794
13,13704,10,100,0.001,0.01,0.676,0.9120694687682428,6862,6842
13,13804,10,100,0.001,0.01,0.692,0.9023471457548536,6915,6889
13,13904,10,100,0.001,0.01,0.68,0.9060701956271576,6965,6939
13,14004,10,100,0.001,0.01,0.714,0.9171665238503285,7022,6982
13,14104,10,100,0.001,0.01,0.706,0.9196681792399319,7080,7024
13,14204,10,100,0.001,0.01,0.708,0.9289636722050126,7134,7070
13,14304,10,100,0.001,0.01,0.696,0.927013422818792,7179,7125
13,14404,10,100,0.001,0.01,0.712,0.9218966953623994,7224,7180
13,14504,10,100,0.001,0.01,0.722,0.9173331494760066,7262,7242
13,14604,10,100,0.001,0.01,0.732,0.9304300191728294,7308,7296
13,14704,10,100,0.001,0.01,0.708,0.9234902067464635,7360,7344
13,14804,10,100,0.001,0.01,0.734,0.9295460686300999,7415,7389
13,14904,10,100,0.001,0.01,0.75,0.9389425657541599,7465,7439
13,15004,10,100,0.001,0.01,0.734,0.9283524393495068,7513,7491
14,104,10,100,0.001,0.01,0.48,0.5096153846153846,57,47
14,204,10,100,0.001,0.01,0.516,0.5490196078431373,104,100
14,304,10,100,0.001,0.01,0.494,0.618421052631579,148,156
14,404,10,100,0.001,0.01,0.464,0.599009900990099,199,205
14,504,10,100,0.001,0.01,0.476,0.6190476190476191,243,261
14,604,10,100,0.001,0.01,0.508,0.5728476821192053,289,315
14,704,10,100,0.001,0.01,0.494,0.6420454545454546,337,367
14,804,10,100,0.001,0.01,0.474,0.6467661691542289,389,415
14,904,10,100,0.001,0.01,0.51,0.6493362831858407,442,462
14,1004,10,100,0.001,0.01,0.536,0.6792828685258964,485,519
14,1104,10,100,0.001,0.01,0.508,0.6838768115942029,541,563
14,1204,10,100,0.001,0.01,0.508,0.6976744186046512,580,624
14,1304,10,100,0.001,0.01,0.502,0.6993865030674846,626,678
14,1404,10,100,0.001,0.01,0.514,0.7122507122507122,683,721
14,1504,10,100,0.001,0.01,0.526,0.6788563829787234,738,766
14,1604,10,100,0.001,0.01,0.502,0.7250623441396509,794,810
14,1704,10,100,0.001,0.01,0.502,0.6971830985915493,837,867
14,1804,10,100,0.001,0.01,0.504,0.7566518847006651,884,920
14,1904,10,100,0.001,0.01,0.484,0.7190126050420168,937,967
14,2004,10,100,0.001,0.01,0.484,0.7559880239520959,981,1023
14,2104,10,100,0.001,0.01,0.518,0.7647338403041825,1030,1074
14,2204,10,100,0.001,0.01,0.522,0.8012704174228675,1081,1123
14,2304,10,100,0.001,0.01,0.56,0.7664930555555556,1134,1170
14,2404,10,100,0.001,0.01,0.544,0.8103161397670549,1180,1224
14,2504,10,100,0.001,0.01,0.56,0.8242811501597445,1224,1280
14,2604,10,100,0.001,0.01,0.54,0.8102918586789555,1282,1322
14,2704,10,100,0.001,0.01,0.578,0.8409763313609467,1328,1376
14,2804,10,100,0.001,0.01,0.574,0.8662624821683309,1374,1430
14,2904,10,100,0.001,0.01,0.562,0.8615702479338843,1428,1476
14,3004,10,100,0.001,0.01,0.576,0.8778295605858855,1474,1530
14,3104,10,100,0.001,0.01,0.612,0.9049613402061856,1533,1571
14,3204,10,100,0.001,0.01,0.61,0.8773408239700374,1583,1621
14,3304,10,100,0.001,0.01,0.618,0.847457627118644,1636,1668
14,3404,10,100,0.001,0.01,0.65,0.8763219741480611,1682,1722
14,3504,10,100,0.001,0.01,0.638,0.9052511415525114,1733,1771
14,3604,10,100,0.001,0.01,0.682,0.9289678135405105,1772,1832
14,3704,10,100,0.001,0.01,0.7,0.9508639308855291,1824,1880
14,3804,10,100,0.001,0.01,0.676,0.9258675078864353,1871,1933
14,3904,10,100,0.001,0.01,0.688,0.9067622950819673,1918,1986
14,4004,10,100,0.001,0.01,0.718,0.9283216783216783,1971,2033
14,4104,10,100,0.001,0.01,0.754,0.9415204678362573,2021,2083
14,4204,10,100,0.001,0.01,0.78,0.9581351094196003,2071,2133
14,4304,10,100,0.001,0.01,0.776,0.9716542750929368,2118,2186
14,4404,10,100,0.001,0.01,0.766,0.948455949137148,2169,2235
14,4504,10,100,0.001,0.01,0.752,0.8838809946714032,2221,2283
14,4604,10,100,0.001,0.01,0.808,0.9391833188531712,2267,2337
14,4704,10,100,0.001,0.01,0.834,0.9638605442176871,2324,2380
14,4804,10,100,0.001,0.01,0.854,0.9760616153205662,2377,2427
14,4904,10,100,0.001,0.01,0.868,0.9796084828711256,2428,2476
14,5004,10,100,0.001,0.01,0.856,0.978617106314948,2480,2524
14,5104,10,100,0.001,0.01,0.884,0.9858934169278997,2526,2578
14,5204,10,100,0.001,0.01,0.864,0.9846272098385856,2584,2620
14,5304,10,100,0.001,0.01,0.862,0.9734162895927602,2627,2677
14,5404,10,100,0.001,0.01,0.87,0.9814951887490747,2675,2729
14,5504,10,100,0.001,0.01,0.894,0.9883720930232558,2728,2776
14,5604,10,100,0.001,0.01,0.892,0.9898286937901499,2779,2825
14,5704,10,100,0.001,0.01,0.89,0.988078541374474,2833,2871
14,5804,10,100,0.001,0.01,0.888,0.9851826326671261,2884,2920
14,5904,10,100,0.001,0.01,0.89,0.9834010840108401,2933,2971
14,6004,10,100,0.001,0.01,0.87,0.9735176548967355,2983,3021
14,6104,10,100,0.001,0.01,0.83,0.9331585845347313,3031,3073
14,6204,10,100,0.001,0.01,0.87,0.9629271437782077,3087,3117
14,6304,10,100,0.001,0.01,0.902,0.9743020304568528,3131,3173
14,6404,10,100,0.001,0.01,0.91,0.9845409119300437,3183,3221
14,6504,10,100,0.001,0.01,0.914,0.986469864698647,3235,3269
14,6604,10,100,0.001,0.01,0.884,0.9695639006662629,3284,3320
14,6704,10,100,0.001,0.01,0.904,0.976282816229117,3342,3362
14,6804,10,100,0.001,0.01,0.916,0.9857436801881246,3390,3414
14,6904,10,100,0.001,0.01,0.918,0.9904403244495944,3440,3464
14,7004,10,100,0.001,0.01,0.914,0.9902912621359223,3487,3517
14,7104,10,100,0.001,0.01,0.92,0.9866272522522522,3537,3567
14,7204,10,100,0.001,0.01,0.932,0.9926429761243754,3585,3619
14,7304,10,100,0.001,0.01,0.926,0.9924698795180723,3629,3675
14,7404,10,100,0.001,0.01,0.922,0.9873041599135602,3685,3719
14,7504,10,100,0.001,0.01,0.944,0.9918710021321961,3728,3776
14,7604,10,100,0.001,0.01,0.922,0.9885586533403472,3784,3820
14,7704,10,100,0.001,0.01,0.924,0.9713136033229491,3829,3875
14,7804,10,100,0.001,0.01,0.922,0.9775756022552538,3868,3936
14,7904,10,100,0.001,0.01,0.926,0.9821609311740891,3918,3986
14,8004,10,100,0.001,0.01,0.936,0.9897551224387806,3971,4033
14,8104,10,100,0.001,0.01,0.926,0.9898815399802566,4020,4084
14,8204,10,100,0.001,0.01,0.936,0.9872013651877133,4080,4124
14,8304,10,100,0.001,0.01,0.938,0.9959055876685935,4120,4184
14,8404,10,100,0.001,0.01,0.928,0.9919086149452642,4179,4225
14,8504,10,100,0.001,0.01,0.932,0.9940028222013171,4232,4272
14,8604,10,100,0.001,0.01,0.926,0.995583449558345,4283,4321
14,8704,10,100,0.001,0.01,0.944,0.9957490808823529,4340,4364
14,8804,10,100,0.001,0.01,0.942,0.9913675601999091,4394,4410
14,8904,10,100,0.001,0.01,0.93,0.9905660377358491,4438,4466
14,9004,10,100,0.001,0.01,0.942,0.9871168369613506,4494,4510
14,9104,10,100,0.001,0.01,0.924,0.9893453427065027,4546,4558
14,9204,10,100,0.001,0.01,0.932,0.988374619730552,4592,4612
14,9304,10,100,0.001,0.01,0.94,0.9884995700773861,4635,4669
14,9404,10,100,0.001,0.01,0.944,0.9910676307954062,4687,4717
14,9504,10,100,0.001,0.01,0.95,0.9886363636363636,4739,4765
14,9604,10,100,0.001,0.01,0.948,0.9886505622657226,4777,4827
14,9704,10,100,0.001,0.01,0.95,0.9905193734542457,4826,4878
14,9804,10,100,0.001,0.01,0.942,0.9921460628314973,4877,4927
14,9904,10,100,0.001,0.01,0.946,0.9896001615508885,4927,4977
14,10004,10,100,0.001,0.01,0.94,0.9873050779688125,4983,5021
14,10104,10,100,0.001,0.01,0.956,0.9922802850356295,5039,5065
14,10204,10,100,0.001,0.01,0.938,0.988141905135241,5097,5107
14,10304,10,100,0.001,0.01,0.948,0.9917507763975155,5149,5155
14,10404,10,100,0.001,0.01,0.952,0.9913494809688581,5193,5211
14,10504,10,100,0.001,0.01,0.956,0.9870525514089871,5249,5255
14,10604,10,100,0.001,0.01,0.958,0.9900037721614485,5310,5294
14,10704,10,100,0.001,0.01,0.952,0.9910313901345291,5358,5346
14,10804,10,100,0.001,0.01,0.958,0.9915771936319882,5399,5405
14,10904,10,100,0.001,0.01,0.966,0.9937637564196625,5442,5462
14,11004,10,100,0.001,0.01,0.966,0.9941839331152308,5492,5512
14,11104,10,100,0.001,0.01,0.958,0.9918948126801153,5534,5570
14,11204,10,100,0.001,0.01,0.946,0.9851838629061049,5589,5615
14,11304,10,100,0.001,0.01,0.964,0.9922151450813871,5642,5662
14,11404,10,100,0.001,0.01,0.95,0.9852683269028412,5692,5712
14,11504,10,100,0.001,0.01,0.968,0.9904381084840056,5743,5761
14,11604,10,100,0.001,0.01,0.964,0.9937090658393657,5792,5812
14,11704,10,100,0.001,0.01,0.962,0.99419002050581,5843,5861
14,11804,10,100,0.001,0.01,0.974,0.9955947136563876,5887,5917
14,11904,10,100,0.001,0.01,0.968,0.9968918010752689,5941,5963
14,12004,10,100,0.001,0.01,0.958,0.9937520826391203,5998,6006
14,12104,10,100,0.001,0.01,0.974,0.9957865168539326,6048,6056
14,12204,10,100,0.001,0.01,0.956,0.9841035725991478,6092,6112
14,12304,10,100,0.001,0.01,0.954,0.9836638491547465,6146,6158
14,12404,10,100,0.001,0.01,0.972,0.9894388906804257,6203,6201
14,12504,10,100,0.001,0.01,0.96,0.9921625079974408,6255,6249
14,12604,10,100,0.001,0.01,0.964,0.993097429387496,6293,6311
14,12704,10,100,0.001,0.01,0.964,0.9909477329974811,6343,6361
14,12804,10,100,0.001,0.01,0.968,0.9900812246173071,6392,6412
14,12904,10,100,0.001,0.01,0.968,0.9949628022318661,6446,6458
14,13004,10,100,0.001,0.01,0.974,0.9970009227929868,6499,6505
14,13104,10,100,0.001,0.01,0.976,0.996947496947497,6557,6547
14,13204,10,100,0.001,0.01,0.968,0.9966676764616783,6605,6599
14,13304,10,100,0.001,0.01,0.962,0.9948887552615755,6653,6651
14,13404,10,100,0.001,0.01,0.964,0.9921665174574754,6701,6703
14,13504,10,100,0.001,0.01,0.972,0.9917802132701422,6747,6757
14,13604,10,100,0.001,0.01,0.97,0.9888268156424581,6790,6814
14,13704,10,100,0.001,0.01,0.976,0.9897840046701692,6844,6860
14,13804,10,100,0.001,0.01,0.982,0.9954361054766734,6891,6913
14,13904,10,100,0.001,0.01,0.97,0.9916570771001151,6943,6961
14,14004,10,100,0.001,0.01,0.974,0.9948586118251928,6996,7008
14,14104,10,100,0.001,0.01,0.976,0.9965258082813386,7049,7055
14,14204,10,100,0.001,0.01,0.976,0.9972542945649113,7096,7108
14,14304,10,100,0.001,0.01,0.978,0.9983920581655481,7149,7155
14,14404,10,100,0.001,0.01,0.976,0.9929880588725354,7193,7211
14,14504,10,100,0.001,0.01,0.97,0.9899338113623828,7239,7265
14,14604,10,100,0.001,0.01,0.966,0.9822651328403177,7295,7309
14,14704,10,100,0.001,0.01,0.968,0.9899347116430903,7346,7358
14,14804,10,100,0.001,0.01,0.98,0.9960145906511754,7399,7405
14,14904,10,100,0.001,0.01,0.98,0.998389694041868,7445,7459
14,15004,10,100,0.001,0.01,0.976,0.9976006398293789,7491,7513
15,104,10,100,0.001,0.01,0.462,0.4519230769230769,47,57
15,204,10,100,0.001,0.01,0.494,0.5735294117647058,99,105
15,304,10,100,0.001,0.01,0.544,0.5723684210526315,155,149
15,404,10,100,0.001,0.01,0.548,0.6311881188118812,203,201
15,504,10,100,0.001,0.01,0.51,0.6071428571428571,246,258
15,604,10,100,0.001,0.01,0.528,0.6208609271523179,296,308
15,704,10,100,0.001,0.01,0.526,0.6349431818181818,353,351
15,804,10,100,0.001,0.01,0.506,0.6554726368159204,403,401
15,904,10,100,0.001,0.01,0.496,0.672566371681416,453,451
15,1004,10,100,0.001,0.01,0.536,0.7081673306772909,496,508
15,1104,10,100,0.001,0.01,0.554,0.6847826086956522,552,552
15,1204,10,100,0.001,0.01,0.536,0.7200996677740864,601,603
15,1304,10,100,0.001,0.01,0.536,0.7246932515337423,640,664
15,1404,10,100,0.001,0.01,0.556,0.7564102564102564,699,705
15,1504,10,100,0.001,0.01,0.522,0.7446808510638298,759,745
15,1604,10,100,0.001,0.01,0.53,0.8048628428927681,804,800
15,1704,10,100,0.001,0.01,0.518,0.7922535211267606,862,842
15,1804,10,100,0.001,0.01,0.556,0.7843680709534369,914,890
15,1904,10,100,0.001,0.01,0.534,0.8040966386554622,962,942
15,2004,10,100,0.001,0.01,0.596,0.8228542914171657,1015,989
15,2104,10,100,0.001,0.01,0.536,0.8231939163498099,1070,1034
15,2204,10,100,0.001,0.01,0.576,0.8656987295825771,1117,1087
15,2304,10,100,0.001,0.01,0.54,0.8415798611111112,1167,1137
15,2404,10,100,0.001,0.01,0.552,0.8598169717138103,1224,1180
15,2504,10,100,0.001,0.01,0.556,0.8889776357827476,1270,1234
15,2604,10,100,0.001,0.01,0.566,0.8924731182795699,1320,1284
15,2704,10,100,0.001,0.01,0.57,0.8561390532544378,1377,1327
15,2804,10,100,0.001,0.01,0.618,0.880527817403709,1422,1382
15,2904,10,100,0.001,0.01,0.604,0.8581267217630854,1471,1433
15,3004,10,100,0.001,0.01,0.64,0.8784953395472703,1529,1475
15,3104,10,100,0.001,0.01,0.658,0.8975515463917526,1597,1507
15,3204,10,100,0.001,0.01,0.662,0.9197877652933832,1649,1555
15,3304,10,100,0.001,0.01,0.67,0.9267554479418886,1695,1609
15,3404,10,100,0.001,0.01,0.716,0.9447708578143361,1747,1657
15,3504,10,100,0.001,0.01,0.702,0.9414954337899544,1783,1721
15,3604,10,100,0.001,0.01,0.76,0.9650388457269701,1837,1767
15,3704,10,100,0.001,0.01,0.76,0.9713822894168467,1880,1824
15,3804,10,100,0.001,0.01,0.78,0.9739747634069401,1931,1873
15,3904,10,100,0.001,0.01,0.784,0.9626024590163934,1984,1920
15,4004,10,100,0.001,0.01,0.802,0.9767732267732268,2037,1967
15,4104,10,100,0.001,0.01,0.81,0.9887914230019493,2089,2015
15,4204,10,100,0.001,0.01,0.818,0.9866793529971456,2129,2075
15,4304,10,100,0.001,0.01,0.834,0.9865241635687733,2186,2118
15,4404,10,100,0.001,0.01,0.866,0.9934150772025432,2239,2165
15,4504,10,100,0.001,0.01,0.864,0.9842362344582594,2294,2210
15,4604,10,100,0.001,0.01,0.87,0.9941355343179844,2347,2257
15,4704,10,100,0.001,0.01,0.862,0.9823554421768708,2391,2313
15,4804,10,100,0.001,0.01,0.87,0.9902164862614488,2430,2374
15,4904,10,100,0.001,0.01,0.88,0.9955138662316476,2477,2427
15,5004,10,100,0.001,0.01,0.892,0.9900079936051159,2532,2472
15,5104,10,100,0.001,0.01,0.89,0.987460815047022,2580,2524
15,5204,10,100,0.001,0.01,0.914,0.9919292851652575,2625,2579
15,5304,10,100,0.001,0.01,0.884,0.9932126696832579,2680,2624
15,5404,10,100,0.001,0.01,0.896,0.9907475943745374,2721,2683
15,5504,10,100,0.001,0.01,0.916,0.9949127906976745,2774,2730
15,5604,10,100,0.001,0.01,0.914,0.9942897930049964,2827,2777
15,5704,10,100,0.001,0.01,0.918,0.9973702664796634,2883,2821
15,5804,10,100,0.001,0.01,0.932,0.9936250861474845,2932,2872
15,5904,10,100,0.001,0.01,0.922,0.9867886178861789,2981,2923
15,6004,10,100,0.001,0.01,0.908,0.9786808794137242,3029,2975
15,6104,10,100,0.001,0.01,0.92,0.9736238532110092,3071,3033
15,6204,10,100,0.001,0.01,0.91,0.9637330754352031,3116,3088
15,6304,10,100,0.001,0.01,0.892,0.947493654822335,3164,3140
15,6404,10,100,0.001,0.01,0.928,0.9712679575265459,3216,3188
15,6504,10,100,0.001,0.01,0.946,0.9829335793357934,3266,3238
15,6604,10,100,0.001,0.01,0.956,0.9892489400363416,3317,3287
15,6704,10,100,0.001,0.01,0.958,0.9925417661097852,3365,3339
15,6804,10,100,0.001,0.01,0.962,0.9933862433862434,3411,3393
15,6904,10,100,0.001,0.01,0.968,0.9971031286210892,3464,3440
15,7004,10,100,0.001,0.01,0.968,0.997430039977156,3513,3491
15,7104,10,100,0.001,0.01,0.968,0.9973254504504504,3560,3544
15,7204,10,100,0.001,0.01,0.968,0.9995835646862854,3608,3596
15,7304,10,100,0.001,0.01,0.97,0.9995892661555312,3663,3641
15,7404,10,100,0.001,0.01,0.956,0.9866288492706645,3724,3680
15,7504,10,100,0.001,0.01,0.958,0.9844083155650319,3778,3726
15,7604,10,100,0.001,0.01,0.958,0.9797475013150974,3833,3771
15,7704,10,100,0.001,0.01,0.926,0.9741692627206646,3889,3815
15,7804,10,100,0.001,0.01,0.968,0.9917990773962071,3934,3870
15,7904,10,100,0.001,0.01,0.974,0.9972165991902834,3993,3911
15,8004,10,100,0.001,0.01,0.972,0.9973763118440779,4052,3952
15,8104,10,100,0.001,0.01,0.966,0.9979022704837117,4102,4002
15,8204,10,100,0.001,0.01,0.972,0.9984154071184788,4161,4043
15,8304,10,100,0.001,0.01,0.974,0.9992774566473989,4204,4100
15,8404,10,100,0.001,0.01,0.978,0.9985721085197525,4249,4155
15,8504,10,100,0.001,0.01,0.968,0.998824082784572,4303,4201
15,8604,10,100,0.001,0.01,0.974,0.99767549976755,4349,4255
15,8704,10,100,0.001,0.01,0.972,0.9986213235294118,4399,4305
15,8804,10,100,0.001,0.01,0.972,0.9961381190368015,4447,4357
15,8904,10,100,0.001,0.01,0.978,0.9994384546271339,4490,4414
15,9004,10,100,0.001,0.01,0.976,0.9985561972456686,4543,4461
15,9104,10,100,0.001,0.01,0.968,0.9974736379613357,4593,4511
15,9204,10,100,0.001,0.01,0.97,0.9942416340721425,4649,4555
15,9304,10,100,0.001,0.01,0.948,0.9797936371453139,4697,4607
15,9404,10,100,0.001,0.01,0.962,0.9888345384942577,4751,4653
15,9504,10,100,0.001,0.01,0.966,0.9900042087542088,4808,4696
15,9604,10,100,0.001,0.01,0.974,0.9927113702623906,4859,4745
15,9704,10,100,0.001,0.01,0.968,0.9986603462489695,4906,4798
15,9804,10,100,0.001,0.01,0.972,0.9970420236638107,4960,4844
15,9904,10,100,0.001,0.01,0.976,0.9968699515347335,5005,4899
15,10004,10,100,0.001,0.01,0.966,0.9983006797281088,5057,4947
15,10104,10,100,0.001,0.01,0.974,0.9975257323832145,5105,4999
15,10204,10,100,0.001,0.01,0.978,0.9951979615836927,5151,5053
15,10304,10,100,0.001,0.01,0.972,0.9959239130434783,5198,5106
15,10404,10,100,0.001,0.01,0.976,0.995674740484429,5254,5150
15,10504,10,100,0.001,0.01,0.972,0.997048743335872,5302,5202
15,10604,10,100,0.001,0.01,0.972,0.9937759336099585,5343,5261
15,10704,10,100,0.001,0.01,0.978,0.9965433482810164,5392,5312
15,10804,10,100,0.001,0.01,0.982,0.9979637171417993,5440,5364
15,10904,10,100,0.001,0.01,0.986,0.997982391782832,5490,5414
15,11004,10,100,0.001,0.01,0.978,0.9966375863322429,5541,5463
15,11104,10,100,0.001,0.01,0.978,0.9959474063400576,5581,5523
15,11204,10,100,0.001,0.01,0.982,0.9979471617279543,5635,5569
15,11304,10,100,0.001,0.01,0.986,0.9984961075725407,5689,5615
15,11404,10,100,0.001,0.01,0.986,0.9998246229393195,5739,5665
15,11504,10,100,0.001,0.01,0.984,0.9988699582753825,5787,5717
15,11604,10,100,0.001,0.01,0.98,0.9991382281971734,5842,5762
15,11704,10,100,0.001,0.01,0.98,0.9975222146274778,5889,5815
15,11804,10,100,0.001,0.01,0.964,0.9826330057607591,5939,5865
15,11904,10,100,0.001,0.01,0.976,0.9927755376344086,5998,5906
15,12004,10,100,0.001,0.01,0.976,0.9895034988337221,6047,5957
15,12104,10,100,0.001,0.01,0.976,0.9966126900198281,6096,6008
15,12204,10,100,0.001,0.01,0.982,0.9964765650606359,6150,6054
15,12304,10,100,0.001,0.01,0.982,0.9939856957087126,6195,6109
15,12404,10,100,0.001,0.01,0.978,0.9953240890035473,6243,6161
15,12504,10,100,0.001,0.01,0.98,0.9957613563659629,6297,6207
15,12604,10,100,0.001,0.01,0.98,0.9956363059346239,6336,6268
15,12704,10,100,0.001,0.01,0.976,0.9971662468513854,6387,6317
15,12804,10,100,0.001,0.01,0.974,0.9981255857544518,6441,6363
15,12904,10,100,0.001,0.01,0.982,0.9985275883446993,6485,6419
15,13004,10,100,0.001,0.01,0.986,0.9983851122731467,6526,6478
15,13104,10,100,0.001,0.01,0.984,0.9977869352869353,6579,6525
15,13204,10,100,0.001,0.01,0.982,0.9965919418358073,6634,6570
15,13304,10,100,0.001,0.01,0.986,0.9924082982561636,6682,6622
15,13404,10,100,0.001,0.01,0.984,0.9974634437481349,6736,6668
15,13504,10,100,0.001,0.01,0.982,0.9973341232227488,6796,6708
15,13604,10,100,0.001,0.01,0.982,0.9963981182005293,6840,6764
15,13704,10,100,0.001,0.01,0.984,0.9981027437244601,6880,6824
15,13804,10,100,0.001,0.01,0.986,0.9988409156766155,6923,6881
15,13904,10,100,0.001,0.01,0.988,0.9982019562715765,6982,6922
15,14004,10,100,0.001,0.01,0.982,0.9962153670379892,7033,6971
15,14104,10,100,0.001,0.01,0.98,0.997093023255814,7087,7017
15,14204,10,100,0.001,0.01,0.98,0.993593353984793,7135,7069
15,14304,10,100,0.001,0.01,0.988,0.9941974272930649,7180,7124
15,14404,10,100,0.001,0.01,0.984,0.9941682865870591,7222,7182
15,14504,10,100,0.001,0.01,0.982,0.9957942636514066,7283,7221
15,14604,10,100,0.001,0.01,0.982,0.9971925499863051,7332,7272
15,14704,10,100,0.001,0.01,0.984,0.9953754080522307,7386,7318
15,14804,10,100,0.001,0.01,0.982,0.9957443934071872,7433,7371
15,14904,10,100,0.001,0.01,0.984,0.9988593666129898,7477,7427
15,15004,10,100,0.001,0.01,0.988,0.9939349506798187,7521,7483
16,104,10,100,0.001,0.01,0.488,0.5,50,54
16,204,10,100,0.001,0.01,0.508,0.5931372549019608,103,101
16,304,10,100,0.001,0.01,0.506,0.5789473684210527,156,148
16,404,10,100,0.001,0.01,0.49,0.5767326732673267,202,202
16,504,10,100,0.001,0.01,0.48,0.5515873015873016,250,254
16,604,10,100,0.001,0.01,0.508,0.5662251655629139,299,305
16,704,10,100,0.001,0.01,0.512,0.5894886363636364,352,352
16,804,10,100,0.001,0.01,0.496,0.6057213930348259,398,406
16,904,10,100,0.001,0.01,0.488,0.6017699115044248,448,456
16,1004,10,100,0.001,0.01,0.518,0.6225099601593626,497,507
16,1104,10,100,0.001,0.01,0.516,0.605072463768116,544,560
16,1204,10,100,0.001,0.01,0.484,0.6727574750830565,585,619
16,1304,10,100,0.001,0.01,0.508,0.6541411042944786,631,673
16,1404,10,100,0.001,0.01,0.49,0.6780626780626781,678,726
16,1504,10,100,0.001,0.01,0.484,0.6722074468085106,727,777
16,1604,10,100,0.001,0.01,0.498,0.685785536159601,773,831
16,1704,10,100,0.001,0.01,0.478,0.664906103286385,819,885
16,1804,10,100,0.001,0.01,0.506,0.7167405764966741,865,939
16,1904,10,100,0.001,0.01,0.506,0.7169117647058824,917,987
16,2004,10,100,0.001,0.01,0.53,0.7460079840319361,965,1039
16,2104,10,100,0.001,0.01,0.512,0.7495247148288974,1015,1089
16,2204,10,100,0.001,0.01,0.54,0.7713248638838476,1072,1132
16,2304,10,100,0.001,0.01,0.54,0.7825520833333334,1121,1183
16,2404,10,100,0.001,0.01,0.528,0.7828618968386023,1168,1236
16,2504,10,100,0.001,0.01,0.528,0.7899361022364217,1222,1282
16,2604,10,100,0.001,0.01,0.518,0.7956989247311828,1266,1338
16,2704,10,100,0.001,0.01,0.552,0.8369082840236687,1320,1384
16,2804,10,100,0.001,0.01,0.548,0.8074179743223966,1367,1437
16,2904,10,100,0.001,0.01,0.556,0.8112947658402204,1421,1483
16,3004,10,100,0.001,0.01,0.584,0.831225033288948,1473,1531
16,3104,10,100,0.001,0.01,0.582,0.8289304123711341,1522,1582
16,3204,10,100,0.001,0.01,0.57,0.8233458177278402,1571,1633
16,3304,10,100,0.001,0.01,0.612,0.8450363196125908,1621,1683
16,3404,10,100,0.001,0.01,0.596,0.854289071680376,1666,1738
16,3504,10,100,0.001,0.01,0.598,0.8601598173515982,1711,1793
16,3604,10,100,0.001,0.01,0.626,0.8693118756936737,1756,1848
16,3704,10,100,0.001,0.01,0.586,0.8188444924406048,1805,1899
16,3804,10,100,0.001,0.01,0.602,0.7854889589905363,1853,1951
16,3904,10,100,0.001,0.01,0.596,0.8004610655737705,1908,1996
16,4004,10,100,0.001,0.01,0.636,0.836913086913087,1956,2048
16,4104,10,100,0.001,0.01,0.646,0.8452729044834308,2020,2084
16,4204,10,100,0.001,0.01,0.644,0.8487155090390105,2063,2141
16,4304,10,100,0.001,0.01,0.658,0.8638475836431226,2116,2188
16,4404,10,100,0.001,0.01,0.652,0.857402361489555,2170,2234
16,4504,10,100,0.001,0.01,0.642,0.8741119005328597,2217,2287
16,4604,10,100,0.001,0.01,0.668,0.8740225890529973,2270,2334
16,4704,10,100,0.001,0.01,0.668,0.8520408163265306,2314,2390
16,4804,10,100,0.001,0.01,0.664,0.8619900083263947,2378,2426
16,4904,10,100,0.001,0.01,0.668,0.87663132137031,2428,2476
16,5004,10,100,0.001,0.01,0.674,0.890087929656275,2477,2527
16,5104,10,100,0.001,0.01,0.668,0.8857758620689655,2536,2568
16,5204,10,100,0.001,0.01,0.68,0.8900845503458877,2589,2615
16,5304,10,100,0.001,0.01,0.682,0.9038461538461539,2633,2671
16,5404,10,100,0.001,0.01,0.69,0.8886010362694301,2681,2723
16,5504,10,100,0.001,0.01,0.7,0.9095203488372093,2729,2775
16,5604,10,100,0.001,0.01,0.664,0.894361170592434,2790,2814
16,5704,10,100,0.001,0.01,0.718,0.9051542776998598,2827,2877
16,5804,10,100,0.001,0.01,0.698,0.8992074431426602,2876,2928
16,5904,10,100,0.001,0.01,0.708,0.9164972899728997,2924,2980
16,6004,10,100,0.001,0.01,0.704,0.9027315123251166,2983,3021
16,6104,10,100,0.001,0.01,0.698,0.9069462647444299,3043,3061
16,6204,10,100,0.001,0.01,0.706,0.8850741457124436,3088,3116
16,6304,10,100,0.001,0.01,0.714,0.9019670050761421,3137,3167
16,6404,10,100,0.001,0.01,0.674,0.9031855090568395,3186,3218
16,6504,10,100,0.001,0.01,0.738,0.9154366543665436,3234,3270
16,6604,10,100,0.001,0.01,0.714,0.8941550575408843,3282,3322
16,6704,10,100,0.001,0.01,0.73,0.908263723150358,3330,3374
16,6804,10,100,0.001,0.01,0.724,0.9166666666666666,3378,3426
16,6904,10,100,0.001,0.01,0.706,0.9265643105446119,3420,3484
16,7004,10,100,0.001,0.01,0.742,0.9246145059965734,3470,3534
16,7104,10,100,0.001,0.01,0.742,0.917088963963964,3525,3579
16,7204,10,100,0.001,0.01,0.728,0.9168517490283176,3572,3632
16,7304,10,100,0.001,0.01,0.744,0.9208652792990142,3622,3682
16,7404,10,100,0.001,0.01,0.722,0.9024851431658563,3675,3729
16,7504,10,100,0.001,0.01,0.746,0.9253731343283582,3725,3779
16,7604,10,100,0.001,0.01,0.732,0.9224092582851131,3778,3826
16,7704,10,100,0.001,0.01,0.764,0.9349688473520249,3834,3870
16,7804,10,100,0.001,0.01,0.782,0.9256791389031266,3877,3927
16,7904,10,100,0.001,0.01,0.76,0.933830971659919,3922,3982
16,8004,10,100,0.001,0.01,0.76,0.9420289855072463,3965,4039
16,8104,10,100,0.001,0.01,0.806,0.9539733464955578,4016,4088
16,8204,10,100,0.001,0.01,0.792,0.9431984397854705,4058,4146
16,8304,10,100,0.001,0.01,0.784,0.9427986512524085,4110,4194
16,8404,10,100,0.001,0.01,0.798,0.9370537839124227,4162,4242
16,8504,10,100,0.001,0.01,0.762,0.9238005644402634,4209,4295
16,8604,10,100,0.001,0.01,0.814,0.9504881450488145,4260,4344
16,8704,10,100,0.001,0.01,0.814,0.939453125,4312,4392
16,8804,10,100,0.001,0.01,0.798,0.9535438437074057,4362,4442
16,8904,10,100,0.001,0.01,0.832,0.9633872416891285,4414,4490
16,9004,10,100,0.001,0.01,0.83,0.968236339404709,4469,4535
16,9104,10,100,0.001,0.01,0.86,0.9675966608084359,4524,4580
16,9204,10,100,0.001,0.01,0.83,0.9386136462407649,4573,4631
16,9304,10,100,0.001,0.01,0.798,0.9215391229578676,4623,4681
16,9404,10,100,0.001,0.01,0.808,0.9421522756273926,4677,4727
16,9504,10,100,0.001,0.01,0.836,0.9494949494949495,4736,4768
16,9604,10,100,0.001,0.01,0.86,0.9629321116201582,4783,4821
16,9704,10,100,0.001,0.01,0.85,0.9714550700741962,4839,4865
16,9804,10,100,0.001,0.01,0.856,0.9648102815177478,4892,4912
16,9904,10,100,0.001,0.01,0.87,0.9641558966074314,4945,4959
16,10004,10,100,0.001,0.01,0.866,0.9697121151539384,4990,5014
16,10104,10,100,0.001,0.01,0.876,0.9781274742676168,5038,5066
16,10204,10,100,0.001,0.01,0.904,0.9835358682869463,5091,5113
16,10304,10,100,0.001,0.01,0.862,0.9716614906832298,5133,5171
16,10404,10,100,0.001,0.01,0.886,0.9692425990003845,5178,5226
16,10504,10,100,0.001,0.01,0.876,0.9674409748667174,5229,5275
16,10604,10,100,0.001,0.01,0.882,0.9785929837797057,5277,5327
16,10704,10,100,0.001,0.01,0.916,0.9858931240657698,5333,5371
16,10804,10,100,0.001,0.01,0.908,0.9864864864864865,5385,5419
16,10904,10,100,0.001,0.01,0.878,0.9548789435069699,5434,5470
16,11004,10,100,0.001,0.01,0.912,0.9691930207197382,5486,5518
16,11104,10,100,0.001,0.01,0.91,0.9791966858789626,5533,5571
16,11204,10,100,0.001,0.01,0.896,0.9758122099250268,5587,5617
16,11304,10,100,0.001,0.01,0.91,0.9711606510969568,5629,5675
16,11404,10,100,0.001,0.01,0.942,0.9898281304805332,5683,5721
16,11504,10,100,0.001,0.01,0.938,0.991307371349096,5737,5767
16,11604,10,100,0.001,0.01,0.928,0.9918993450534298,5785,5819
16,11704,10,100,0.001,0.01,0.944,0.989149008885851,5836,5868
16,11804,10,100,0.001,0.01,0.89,0.9520501524906811,5884,5920
16,11904,10,100,0.001,0.01,0.876,0.9223790322580645,5931,5973
16,12004,10,100,0.001,0.01,0.902,0.9638453848717095,5976,6028
16,12104,10,100,0.001,0.01,0.926,0.9814937210839392,6029,6075
16,12204,10,100,0.001,0.01,0.93,0.9864798426745329,6078,6126
16,12304,10,100,0.001,0.01,0.944,0.9874837451235371,6129,6175
16,12404,10,100,0.001,0.01,0.946,0.9912931312479846,6179,6225
16,12504,10,100,0.001,0.01,0.946,0.9836052463211772,6226,6278
16,12604,10,100,0.001,0.01,0.948,0.9894477943509997,6277,6327
16,12704,10,100,0.001,0.01,0.948,0.9940963476070529,6332,6372
16,12804,10,100,0.001,0.01,0.96,0.992970946579194,6391,6413
16,12904,10,100,0.001,0.01,0.954,0.9913205207687539,6437,6467
16,13004,10,100,0.001,0.01,0.954,0.9933097508458936,6499,6505
16,13104,10,100,0.001,0.01,0.95,0.990995115995116,6548,6556
16,13204,10,100,0.001,0.01,0.946,0.9816722205392305,6592,6612
16,13304,10,100,0.001,0.01,0.94,0.9830126277811184,6644,6660
16,13404,10,100,0.001,0.01,0.956,0.9864965681886004,6704,6700
16,13504,10,100,0.001,0.01,0.95,0.9807464454976303,6758,6746
16,13604,10,100,0.001,0.01,0.972,0.9972802117024404,6813,6791
16,13704,10,100,0.001,0.01,0.972,0.9972270869819031,6870,6834
16,13804,10,100,0.001,0.01,0.964,0.9966676325702695,6920,6884
16,13904,10,100,0.001,0.01,0.97,0.9933831990794016,6966,6938
16,14004,10,100,0.001,0.01,0.96,0.9950014281633819,7006,6998
16,14104,10,100,0.001,0.01,0.984,0.9977311401020987,7049,7055
16,14204,10,100,0.001,0.01,0.976,0.9976063080822304,7099,7105
16,14304,10,100,0.001,0.01,0.946,0.9791666666666666,7152,7152
16,14404,10,100,0.001,0.01,0.948,0.9813246320466537,7197,7207
16,14504,10,100,0.001,0.01,0.958,0.9851765030336459,7243,7261
16,14604,10,100,0.001,0.01,0.972,0.9924678170364284,7290,7314
16,14704,10,100,0.001,0.01,0.98,0.9966675734494015,7347,7357
16,14804,10,100,0.001,0.01,0.972,0.9971629289381249,7399,7405
16,14904,10,100,0.001,0.01,0.978,0.9959742351046699,7454,7450
16,15004,10,100,0.001,0.01,0.984,0.9942015462543322,7508,7496
17,104,10,100,0.001,0.01,0.502,0.5192307692307693,50,54
17,204,10,100,0.001,0.01,0.478,0.6519607843137255,100,104
17,304,10,100,0.001,0.01,0.484,0.5921052631578947,146,158
17,404,10,100,0.001,0.01,0.484,0.6460396039603961,202,202
17,504,10,100,0.001,0.01,0.484,0.6369047619047619,254,250
17,604,10,100,0.001,0.01,0.48,0.6639072847682119,302,302
17,704,10,100,0.001,0.01,0.494,0.6747159090909091,351,353
17,804,10,100,0.001,0.01,0.504,0.7039800995024875,401,403
17,904,10,100,0.001,0.01,0.53,0.7179203539823009,447,457
17,1004,10,100,0.001,0.01,0.534,0.7450199203187251,497,507
17,1104,10,100,0.001,0.01,0.536,0.7210144927536232,546,558
17,1204,10,100,0.001,0.01,0.502,0.717607973421927,597,607
17,1304,10,100,0.001,0.01,0.526,0.7200920245398773,653,651
17,1404,10,100,0.001,0.01,0.536,0.7578347578347578,702,702
17,1504,10,100,0.001,0.01,0.536,0.7918882978723404,749,755
17,1604,10,100,0.001,0.01,0.544,0.7930174563591023,805,799
17,1704,10,100,0.001,0.01,0.54,0.7535211267605634,857,847
17,1804,10,100,0.001,0.01,0.55,0.7832594235033259,914,890
17,1904,10,100,0.001,0.01,0.54,0.7993697478991597,965,939
17,2004,10,100,0.001,0.01,0.576,0.814870259481038,1017,987
17,2104,10,100,0.001,0.01,0.552,0.8288973384030418,1063,1041
17,2204,10,100,0.001,0.01,0.586,0.8679673321234119,1116,1088
17,2304,10,100,0.001,0.01,0.648,0.8875868055555556,1164,1140
17,2404,10,100,0.001,0.01,0.628,0.8527454242928453,1209,1195
17,2504,10,100,0.001,0.01,0.648,0.8482428115015974,1261,1243
17,2604,10,100,0.001,0.01,0.646,0.8897849462365591,1312,1292
17,2704,10,100,0.001,0.01,0.686,0.9349112426035503,1355,1349
17,2804,10,100,0.001,0.01,0.706,0.9315263908701854,1411,1393
17,2904,10,100,0.001,0.01,0.684,0.9097796143250688,1457,1447
17,3004,10,100,0.001,0.01,0.718,0.9370838881491345,1502,1502
17,3104,10,100,0.001,0.01,0.756,0.9603737113402062,1553,1551
17,3204,10,100,0.001,0.01,0.734,0.968789013732834,1605,1599
17,3304,10,100,0.001,0.01,0.724,0.9373486682808717,1651,1653
17,3404,10,100,0.001,0.01,0.752,0.9647473560517039,1706,1698
17,3504,10,100,0.001,0.01,0.792,0.9731735159817352,1757,1747
17,3604,10,100,0.001,0.01,0.77,0.9814095449500555,1813,1791
17,3704,10,100,0.001,0.01,0.786,0.9827213822894169,1854,1850
17,3804,10,100,0.001,0.01,0.76,0.9742376445846478,1899,1905
17,3904,10,100,0.001,0.01,0.77,0.9592725409836066,1953,1951
17,4004,10,100,0.001,0.01,0.812,0.9772727272727273,2002,2002
17,4104,10,100,0.001,0.01,0.822,0.9768518518518519,2046,2058
17,4204,10,100,0.001,0.01,0.816,0.9778782112274025,2099,2105
17,4304,10,100,0.001,0.01,0.808,0.958410780669145,2145,2159
17,4404,10,100,0.001,0.01,0.84,0.9786557674841053,2195,2209
17,4504,10,100,0.001,0.01,0.828,0.9897868561278863,2246,2258
17,4604,10,100,0.001,0.01,0.798,0.9798001737619462,2298,2306
17,4704,10,100,0.001,0.01,0.84,0.9940476190476191,2343,2361
17,4804,10,100,0.001,0.01,0.838,0.9875104079933389,2400,2404
17,4904,10,100,0.001,0.01,0.834,0.9730831973898858,2449,2455
17,5004,10,100,0.001,0.01,0.858,0.978017585931255,2497,2507
17,5104,10,100,0.001,0.01,0.85,0.9849137931034483,2547,2557
17,5204,10,100,0.001,0.01,0.866,0.9915449654112222,2594,2610
17,5304,10,100,0.001,0.01,0.888,0.9822775263951734,2642,2662
17,5404,10,100,0.001,0.01,0.874,0.9877868245743894,2692,2712
17,5504,10,100,0.001,0.01,0.906,0.9943677325581395,2737,2767
17,5604,10,100,0.001,0.01,0.896,0.9950035688793719,2788,2816
17,5704,10,100,0.001,0.01,0.912,0.9943899018232819,2836,2868
17,5804,10,100,0.001,0.01,0.918,0.9898345968297726,2887,2917
17,5904,10,100,0.001,0.01,0.898,0.9886517615176151,2935,2969
17,6004,10,100,0.001,0.01,0.924,0.9938374417055297,2987,3017
17,6104,10,100,0.001,0.01,0.914,0.9934469200524246,3032,3072
17,6204,10,100,0.001,0.01,0.928,0.988394584139265,3080,3124
17,6304,10,100,0.001,0.01,0.93,0.9630393401015228,3132,3172
17,6404,10,100,0.001,0.01,0.944,0.9851655215490318,3169,3235
17,6504,10,100,0.001,0.01,0.94,0.9930811808118081,3222,3282
17,6604,10,100,0.001,0.01,0.94,0.9931859479103574,3275,3329
17,6704,10,100,0.001,0.01,0.954,0.9967183770883055,3331,3373
17,6804,10,100,0.001,0.01,0.964,0.9969135802469136,3375,3429
17,6904,10,100,0.001,0.01,0.942,0.9976825028968713,3427,3477
17,7004,10,100,0.001,0.01,0.952,0.9992861222158766,3478,3526
17,7104,10,100,0.001,0.01,0.958,0.9992961711711712,3533,3571
17,7204,10,100,0.001,0.01,0.948,0.9963908939478068,3580,3624
17,7304,10,100,0.001,0.01,0.966,0.9972617743702081,3627,3677
17,7404,10,100,0.001,0.01,0.944,0.9963533225283631,3677,3727
17,7504,10,100,0.001,0.01,0.954,0.9952025586353944,3727,3777
17,7604,10,100,0.001,0.01,0.956,0.9961862177801157,3774,3830
17,7704,10,100,0.001,0.01,0.95,0.9931204569055037,3824,3880
17,7804,10,100,0.001,0.01,0.948,0.9951307022039979,3871,3933
17,7904,10,100,0.001,0.01,0.938,0.9807692307692307,3922,3982
17,8004,10,100,0.001,0.01,0.948,0.9885057471264368,3969,4035
17,8104,10,100,0.001,0.01,0.96,0.9949407699901284,4024,4080
17,8204,10,100,0.001,0.01,0.97,0.9965870307167235,4065,4139
17,8304,10,100,0.001,0.01,0.97,0.9960260115606936,4120,4184
17,8404,10,100,0.001,0.01,0.958,0.9932175154688244,4171,4233
17,8504,10,100,0.001,0.01,0.964,0.9948259642521167,4209,4295
17,8604,10,100,0.001,0.01,0.964,0.9970943747094375,4260,4344
17,8704,10,100,0.001,0.01,0.964,0.9972426470588235,4314,4390
17,8804,10,100,0.001,0.01,0.962,0.9972739663789186,4363,4441
17,8904,10,100,0.001,0.01,0.964,0.99651841868823,4412,4492
17,9004,10,100,0.001,0.01,0.958,0.9950022212350067,4465,4539
17,9104,10,100,0.001,0.01,0.958,0.9976933216168717,4519,4585
17,9204,10,100,0.001,0.01,0.96,0.9956540634506736,4563,4641
17,9304,10,100,0.001,0.01,0.964,0.9911865864144453,4615,4689
17,9404,10,100,0.001,0.01,0.966,0.9947894512973203,4657,4747
17,9504,10,100,0.001,0.01,0.97,0.9965277777777778,4717,4787
17,9604,10,100,0.001,0.01,0.966,0.9953144523115368,4768,4836
17,9704,10,100,0.001,0.01,0.964,0.9948474855729597,4821,4883
17,9804,10,100,0.001,0.01,0.964,0.9901060791513668,4869,4935
17,9904,10,100,0.001,0.01,0.972,0.9930331179321487,4919,4985
17,10004,10,100,0.001,0.01,0.97,0.9967013194722111,4961,5043
17,10104,10,100,0.001,0.01,0.974,0.992181314330958,5003,5101
17,10204,10,100,0.001,0.01,0.962,0.9902979223833791,5051,5153
17,10304,10,100,0.001,0.01,0.974,0.9963121118012422,5105,5199
17,10404,10,100,0.001,0.01,0.976,0.9970203767781622,5167,5237
17,10504,10,100,0.001,0.01,0.976,0.9982863670982483,5228,5276
17,10604,10,100,0.001,0.01,0.968,0.9912297246322143,5278,5326
17,10704,10,100,0.001,0.01,0.972,0.9982249626307922,5318,5386
17,10804,10,100,0.001,0.01,0.968,0.991299518696779,5360,5444
17,10904,10,100,0.001,0.01,0.98,0.9971570066030815,5412,5492
17,11004,10,100,0.001,0.01,0.97,0.995274445656125,5460,5544
17,11104,10,100,0.001,0.01,0.966,0.9926152737752162,5506,5598
17,11204,10,100,0.001,0.01,0.964,0.9916993930739022,5561,5643
17,11304,10,100,0.001,0.01,0.972,0.98982661004954,5609,5695
17,11404,10,100,0.001,0.01,0.976,0.9937741143458436,5664,5740
17,11504,10,100,0.001,0.01,0.974,0.9916550764951322,5720,5784
17,11604,10,100,0.001,0.01,0.974,0.9930196483971044,5765,5839
17,11704,10,100,0.001,0.01,0.98,0.9979494190020506,5823,5881
17,11804,10,100,0.001,0.01,0.976,0.9972043375127075,5871,5933
17,11904,10,100,0.001,0.01,0.974,0.996135752688172,5921,5983
17,12004,10,100,0.001,0.01,0.984,0.9945018327224259,5973,6031
17,12104,10,100,0.001,0.01,0.974,0.9972736285525446,6029,6075
17,12204,10,100,0.001,0.01,0.972,0.9969682071451983,6071,6133
17,12304,10,100,0.001,0.01,0.976,0.997074122236671,6120,6184
17,12404,10,100,0.001,0.01,0.972,0.9970170912608836,6180,6224
17,12504,10,100,0.001,0.01,0.966,0.992402431222009,6226,6278
17,12604,10,100,0.001,0.01,0.976,0.9921453506823231,6276,6328
17,12704,10,100,0.001,0.01,0.978,0.9956706549118388,6328,6376
17,12804,10,100,0.001,0.01,0.974,0.9953139643861293,6379,6425
17,12904,10,100,0.001,0.01,0.984,0.9971326720396776,6431,6473
17,13004,10,100,0.001,0.01,0.976,0.997385419870809,6485,6519
17,13104,10,100,0.001,0.01,0.976,0.9971001221001221,6537,6567
17,13204,10,100,0.001,0.01,0.97,0.9959860648288398,6588,6616
17,13304,10,100,0.001,0.01,0.984,0.9981208659049909,6637,6667
17,13404,10,100,0.001,0.01,0.978,0.9971650253655625,6685,6719
17,13504,10,100,0.001,0.01,0.976,0.9957049763033176,6734,6770
17,13604,10,100,0.001,0.01,0.982,0.9969126727433107,6781,6823
17,13704,10,100,0.001,0.01,0.982,0.9967162872154116,6837,6867
17,13804,10,100,0.001,0.01,0.972,0.992103738046943,6887,6917
17,13904,10,100,0.001,0.01,0.986,0.9958285385500575,6934,6970
17,14004,10,100,0.001,0.01,0.966,0.9880034275921166,6985,7019
17,14104,10,100,0.001,0.01,0.978,0.9862450368689734,7037,7067
17,14204,10,100,0.001,0.01,0.98,0.9934525485778654,7094,7110
17,14304,10,100,0.001,0.01,0.976,0.9958053691275168,7155,7149
17,14404,10,100,0.001,0.01,0.988,0.9956262149402944,7207,7197
17,14504,10,100,0.001,0.01,0.986,0.9951737451737451,7261,7243
17,14604,10,100,0.001,0.01,0.986,0.9937688304574089,7320,7284
17,14704,10,100,0.001,0.01,0.99,0.9944232861806311,7365,7339
17,14804,10,100,0.001,0.01,0.972,0.9962172385841664,7404,7400
17,14904,10,100,0.001,0.01,0.976,0.9975174449812131,7449,7455
17,15004,10,100,0.001,0.01,0.98,0.9956678219141563,7503,7501
18,104,10,100,0.001,0.01,0.502,0.4519230769230769,47,57
18,204,10,100,0.001,0.01,0.5,0.6470588235294118,93,111
18,304,10,100,0.001,0.01,0.506,0.6611842105263158,143,161
18,404,10,100,0.001,0.01,0.516,0.650990099009901,197,207
18,504,10,100,0.001,0.01,0.514,0.6825396825396826,244,260
18,604,10,100,0.001,0.01,0.518,0.6721854304635762,295,309
18,704,10,100,0.001,0.01,0.522,0.6633522727272727,332,372
18,804,10,100,0.001,0.01,0.516,0.6878109452736318,378,426
18,904,10,100,0.001,0.01,0.508,0.6792035398230089,429,475
18,1004,10,100,0.001,0.01,0.488,0.6693227091633466,476,528
18,1104,10,100,0.001,0.01,0.504,0.6847826086956522,522,582
18,1204,10,100,0.001,0.01,0.486,0.7084717607973422,573,631
18,1304,10,100,0.001,0.01,0.542,0.6886503067484663,626,678
18,1404,10,100,0.001,0.01,0.508,0.6759259259259259,670,734
18,1504,10,100,0.001,0.01,0.534,0.7194148936170213,709,795
18,1604,10,100,0.001,0.01,0.52,0.7406483790523691,757,847
18,1704,10,100,0.001,0.01,0.532,0.7177230046948356,811,893
18,1804,10,100,0.001,0.01,0.526,0.7405764966740577,865,939
18,1904,10,100,0.001,0.01,0.516,0.729516806722689,908,996
18,2004,10,100,0.001,0.01,0.516,0.7485029940119761,950,1054
18,2104,10,100,0.001,0.01,0.532,0.721958174904943,990,1114
18,2204,10,100,0.001,0.01,0.526,0.7717785843920145,1037,1167
18,2304,10,100,0.001,0.01,0.518,0.7677951388888888,1077,1227
18,2404,10,100,0.001,0.01,0.51,0.7845257903494176,1122,1282
18,2504,10,100,0.001,0.01,0.516,0.735223642172524,1168,1336
18,2604,10,100,0.001,0.01,0.534,0.7649769585253456,1214,1390
18,2704,10,100,0.001,0.01,0.558,0.7599852071005917,1260,1444
18,2804,10,100,0.001,0.01,0.56,0.7671184022824536,1309,1495
18,2904,10,100,0.001,0.01,0.544,0.7289944903581267,1364,1540
18,3004,10,100,0.001,0.01,0.548,0.7896138482023968,1410,1594
18,3104,10,100,0.001,0.01,0.588,0.7967139175257731,1461,1643
18,3204,10,100,0.001,0.01,0.582,0.7946317103620475,1509,1695
18,3304,10,100,0.001,0.01,0.554,0.8090193704600485,1559,1745
18,3404,10,100,0.001,0.01,0.598,0.8231492361927144,1603,1801
18,3504,10,100,0.001,0.01,0.6,0.8253424657534246,1651,1853
18,3604,10,100,0.001,0.01,0.566,0.836015538290788,1696,1908
18,3704,10,100,0.001,0.01,0.59,0.849622030237581,1758,1946
18,3804,10,100,0.001,0.01,0.59,0.8430599369085173,1813,1991
18,3904,10,100,0.001,0.01,0.588,0.8399077868852459,1864,2040
18,4004,10,100,0.001,0.01,0.626,0.8259240759240759,1916,2088
18,4104,10,100,0.001,0.01,0.62,0.8328460038986355,1965,2139
18,4204,10,100,0.001,0.01,0.624,0.8499048525214081,2026,2178
18,4304,10,100,0.001,0.01,0.642,0.8387546468401487,2085,2219
18,4404,10,100,0.001,0.01,0.624,0.8648955495004541,2132,2272
18,4504,10,100,0.001,0.01,0.636,0.8303730017761989,2191,2313
18,4604,10,100,0.001,0.01,0.65,0.8536055603822763,2254,2350
18,4704,10,100,0.001,0.01,0.632,0.8333333333333334,2298,2406
18,4804,10,100,0.001,0.01,0.656,0.8538717735220649,2349,2455
18,4904,10,100,0.001,0.01,0.624,0.8464518760195758,2402,2502
18,5004,10,100,0.001,0.01,0.666,0.8523181454836131,2451,2553
18,5104,10,100,0.001,0.01,0.65,0.8554075235109718,2513,2591
18,5204,10,100,0.001,0.01,0.67,0.8604919292851653,2568,2636
18,5304,10,100,0.001,0.01,0.652,0.8740573152337858,2620,2684
18,5404,10,100,0.001,0.01,0.662,0.8732420429311621,2676,2728
18,5504,10,100,0.001,0.01,0.648,0.877906976744186,2721,2783
18,5604,10,100,0.001,0.01,0.708,0.8979300499643112,2768,2836
18,5704,10,100,0.001,0.01,0.68,0.8818373071528752,2822,2882
18,5804,10,100,0.001,0.01,0.684,0.8852515506547208,2857,2947
18,5904,10,100,0.001,0.01,0.66,0.8556910569105691,2911,2993
18,6004,10,100,0.001,0.01,0.676,0.8877415056628915,2965,3039
18,6104,10,100,0.001,0.01,0.656,0.8977719528178244,3015,3089
18,6204,10,100,0.001,0.01,0.692,0.8862024500322373,3070,3134
18,6304,10,100,0.001,0.01,0.698,0.9070431472081218,3121,3183
18,6404,10,100,0.001,0.01,0.704,0.8974078700811993,3174,3230
18,6504,10,100,0.001,0.01,0.65,0.8739237392373924,3220,3284
18,6604,10,100,0.001,0.01,0.694,0.8943064809206541,3266,3338
18,6704,10,100,0.001,0.01,0.666,0.9031921241050119,3321,3383
18,6804,10,100,0.001,0.01,0.716,0.9041740152851264,3360,3444
18,6904,10,100,0.001,0.01,0.664,0.8893395133256083,3411,3493
18,7004,10,100,0.001,0.01,0.69,0.8950599657338664,3470,3534
18,7104,10,100,0.001,0.01,0.672,0.9215934684684685,3511,3593
18,7204,10,100,0.001,0.01,0.674,0.9108828428650749,3556,3648
18,7304,10,100,0.001,0.01,0.682,0.9007393209200438,3603,3701
18,7404,10,100,0.001,0.01,0.7,0.9134251755807672,3648,3756
18,7504,10,100,0.001,0.01,0.676,0.888726012793177,3705,3799
18,7604,10,100,0.001,0.01,0.65,0.8721725407680169,3759,3845
18,7704,10,100,0.001,0.01,0.682,0.8513759086188992,3801,3903
18,7804,10,100,0.001,0.01,0.698,0.874038954382368,3848,3956
18,7904,10,100,0.001,0.01,0.692,0.8758856275303644,3906,3998
18,8004,10,100,0.001,0.01,0.694,0.888680659670165,3956,4048
18,8104,10,100,0.001,0.01,0.708,0.8993089832181639,4015,4089
18,8204,10,100,0.001,0.01,0.738,0.9038274012676744,4066,4138
18,8304,10,100,0.001,0.01,0.722,0.908116570327553,4115,4189
18,8404,10,100,0.001,0.01,0.738,0.906592099000476,4177,4227
18,8504,10,100,0.001,0.01,0.694,0.9135700846660395,4227,4277
18,8604,10,100,0.001,0.01,0.714,0.9078335657833566,4272,4332
18,8704,10,100,0.001,0.01,0.726,0.9087775735294118,4330,4374
18,8804,10,100,0.001,0.01,0.748,0.9100408905043162,4384,4420
18,8904,10,100,0.001,0.01,0.712,0.8893755615453729,4437,4467
18,9004,10,100,0.001,0.01,0.712,0.9102621057307864,4489,4515
18,9104,10,100,0.001,0.01,0.756,0.9230008787346221,4538,4566
18,9204,10,100,0.001,0.01,0.738,0.911451542807475,4589,4615
18,9304,10,100,0.001,0.01,0.746,0.923688736027515,4642,4662
18,9404,10,100,0.001,0.01,0.752,0.9221607826456827,4687,4717
18,9504,10,100,0.001,0.01,0.772,0.9268728956228957,4746,4758
18,9604,10,100,0.001,0.01,0.762,0.9101416076634735,4799,4805
18,9704,10,100,0.001,0.01,0.728,0.906121187139324,4846,4858
18,9804,10,100,0.001,0.01,0.732,0.8866789065687475,4891,4913
18,9904,10,100,0.001,0.01,0.752,0.9273021001615509,4945,4959
18,10004,10,100,0.001,0.01,0.736,0.9197321071571372,4994,5010
18,10104,10,100,0.001,0.01,0.766,0.9225059382422803,5053,5051
18,10204,10,100,0.001,0.01,0.738,0.9245393963151706,5114,5090
18,10304,10,100,0.001,0.01,0.744,0.9241071428571429,5167,5137
18,10404,10,100,0.001,0.01,0.758,0.923683198769704,5229,5175
18,10504,10,100,0.001,0.01,0.746,0.9294554455445545,5283,5221
18,10604,10,100,0.001,0.01,0.77,0.9231422104866088,5330,5274
18,10704,10,100,0.001,0.01,0.772,0.9206838565022422,5384,5320
18,10804,10,100,0.001,0.01,0.76,0.9125323954091077,5432,5372
18,10904,10,100,0.001,0.01,0.756,0.9247065297138665,5483,5421
18,11004,10,100,0.001,0.01,0.764,0.9342966194111232,5528,5476
18,11104,10,100,0.001,0.01,0.75,0.921199567723343,5576,5528
18,11204,10,100,0.001,0.01,0.788,0.9308282756158515,5620,5584
18,11304,10,100,0.001,0.01,0.76,0.9337402689313518,5677,5627
18,11404,10,100,0.001,0.01,0.77,0.9327428972290425,5732,5672
18,11504,10,100,0.001,0.01,0.768,0.9532336578581363,5787,5717
18,11604,10,100,0.001,0.01,0.784,0.938728024819028,5833,5771
18,11704,10,100,0.001,0.01,0.768,0.9351503759398496,5890,5814
18,11804,10,100,0.001,0.01,0.782,0.9495933581836665,5943,5861
18,11904,10,100,0.001,0.01,0.778,0.9525369623655914,5997,5907
18,12004,10,100,0.001,0.01,0.784,0.9108630456514495,6046,5958
18,12104,10,100,0.001,0.01,0.782,0.9137475214805023,6095,6009
18,12204,10,100,0.001,0.01,0.804,0.9454277286135693,6148,6056
18,12304,10,100,0.001,0.01,0.782,0.9448959687906372,6195,6109
18,12404,10,100,0.001,0.01,0.802,0.9498548855207998,6244,6160
18,12504,10,100,0.001,0.01,0.79,0.9408189379398593,6293,6211
18,12604,10,100,0.001,0.01,0.79,0.9565217391304348,6347,6257
18,12704,10,100,0.001,0.01,0.79,0.9520623425692695,6395,6309
18,12804,10,100,0.001,0.01,0.768,0.9341611996251171,6437,6367
18,12904,10,100,0.001,0.01,0.772,0.9386236825790453,6475,6429
18,13004,10,100,0.001,0.01,0.806,0.9450169178714242,6532,6472
18,13104,10,100,0.001,0.01,0.8,0.9488705738705738,6578,6526
18,13204,10,100,0.001,0.01,0.794,0.9562253862465919,6632,6572
18,13304,10,100,0.001,0.01,0.82,0.9549007817197835,6685,6619
18,13404,10,100,0.001,0.01,0.792,0.9561324977618622,6731,6673
18,13504,10,100,0.001,0.01,0.818,0.951718009478673,6774,6730
18,13604,10,100,0.001,0.01,0.808,0.9437665392531608,6822,6782
18,13704,10,100,0.001,0.01,0.818,0.9562901342673672,6871,6833
18,13804,10,100,0.001,0.01,0.81,0.949290060851927,6913,6891
18,13904,10,100,0.001,0.01,0.81,0.9544016110471807,6958,6946
18,14004,10,100,0.001,0.01,0.82,0.9424450157097972,7005,6999
18,14104,10,100,0.001,0.01,0.828,0.9544809982983551,7062,7042
18,14204,10,100,0.001,0.01,0.778,0.9474091805125316,7116,7088
18,14304,10,100,0.001,0.01,0.828,0.9542785234899329,7157,7147
18,14404,10,100,0.001,0.01,0.836,0.9595945570674812,7207,7197
18,14504,10,100,0.001,0.01,0.82,0.9504964147821291,7257,7247
18,14604,10,100,0.001,0.01,0.81,0.9533689400164339,7312,7292
18,14704,10,100,0.001,0.01,0.836,0.9529379760609358,7357,7347
18,14804,10,100,0.001,0.01,0.816,0.9527154823020805,7410,7394
18,14904,10,100,0.001,0.01,0.818,0.9530327428878154,7458,7446
18,15004,10,100,0.001,0.01,0.828,0.9540122633964276,7501,7503
19,104,10,100,0.001,0.01,0.524,0.49038461538461536,53,51
19,204,10,100,0.001,0.01,0.512,0.5686274509803921,95,109
19,304,10,100,0.001,0.01,0.5,0.5526315789473685,147,157
19,404,10,100,0.001,0.01,0.502,0.556930693069307,193,211
19,504,10,100,0.001,0.01,0.5,0.5694444444444444,242,262
19,604,10,100,0.001,0.01,0.498,0.6291390728476821,293,311
19,704,10,100,0.001,0.01,0.484,0.6022727272727273,336,368
19,804,10,100,0.001,0.01,0.506,0.6268656716417911,392,412
19,904,10,100,0.001,0.01,0.506,0.6161504424778761,437,467
19,1004,10,100,0.001,0.01,0.492,0.6095617529880478,493,511
19,1104,10,100,0.001,0.01,0.486,0.6331521739130435,547,557
19,1204,10,100,0.001,0.01,0.498,0.6611295681063123,594,610
19,1304,10,100,0.001,0.01,0.506,0.6641104294478528,651,653
19,1404,10,100,0.001,0.01,0.51,0.6752136752136753,705,699
19,1504,10,100,0.001,0.01,0.52,0.6894946808510638,757,747
19,1604,10,100,0.001,0.01,0.518,0.7163341645885287,807,797
19,1704,10,100,0.001,0.01,0.508,0.7142018779342723,855,849
19,1804,10,100,0.001,0.01,0.548,0.7577605321507761,911,893
19,1904,10,100,0.001,0.01,0.556,0.7505252100840336,960,944
19,2004,10,100,0.001,0.01,0.558,0.7614770459081837,1003,1001
19,2104,10,100,0.001,0.01,0.582,0.7832699619771863,1056,1048
19,2204,10,100,0.001,0.01,0.606,0.7686025408348457,1102,1102
19,2304,10,100,0.001,0.01,0.622,0.8272569444444444,1146,1158
19,2404,10,100,0.001,0.01,0.61,0.81738768718802,1199,1205
19,2504,10,100,0.001,0.01,0.624,0.8262779552715654,1247,1257
19,2604,10,100,0.001,0.01,0.66,0.8552227342549923,1305,1299
19,2704,10,100,0.001,0.01,0.668,0.838387573964497,1358,1346
19,2804,10,100,0.001,0.01,0.694,0.8698288159771754,1416,1388
19,2904,10,100,0.001,0.01,0.71,0.8805096418732782,1473,1431
19,3004,10,100,0.001,0.01,0.728,0.8908122503328895,1520,1484
19,3104,10,100,0.001,0.01,0.722,0.8530927835051546,1573,1531
19,3204,10,100,0.001,0.01,0.75,0.8913857677902621,1627,1577
19,3304,10,100,0.001,0.01,0.712,0.8553268765133172,1679,1625
19,3404,10,100,0.001,0.01,0.774,0.8848413631022327,1724,1680
19,3504,10,100,0.001,0.01,0.782,0.8975456621004566,1770,1734
19,3604,10,100,0.001,0.01,0.806,0.9198113207547169,1815,1789
19,3704,10,100,0.001,0.01,0.8,0.890658747300216,1857,1847
19,3804,10,100,0.001,0.01,0.816,0.9198212407991588,1907,1897
19,3904,10,100,0.001,0.01,0.826,0.9300717213114754,1960,1944
19,4004,10,100,0.001,0.01,0.856,0.9502997002997003,2019,1985
19,4104,10,100,0.001,0.01,0.86,0.959307992202729,2070,2034
19,4204,10,100,0.001,0.01,0.816,0.9212654614652712,2124,2080
19,4304,10,100,0.001,0.01,0.828,0.8815055762081785,2170,2134
19,4404,10,100,0.001,0.01,0.84,0.9091734786557675,2211,2193
19,4504,10,100,0.001,0.01,0.848,0.9498223801065719,2262,2242
19,4604,10,100,0.001,0.01,0.802,0.9024761077324066,2310,2294
19,4704,10,100,0.001,0.01,0.846,0.9164540816326531,2359,2345
19,4804,10,100,0.001,0.01,0.87,0.9471273938384679,2409,2395
19,4904,10,100,0.001,0.01,0.876,0.9504486133768353,2468,2436
19,5004,10,100,0.001,0.01,0.86,0.964828137490008,2518,2486
19,5104,10,100,0.001,0.01,0.88,0.9717868338557993,2566,2538
19,5204,10,100,0.001,0.01,0.868,0.9729054573405073,2615,2589
19,5304,10,100,0.001,0.01,0.86,0.9688914027149321,2666,2638
19,5404,10,100,0.001,0.01,0.89,0.9739082161361954,2723,2681
19,5504,10,100,0.001,0.01,0.886,0.9758357558139535,2779,2725
19,5604,10,100,0.001,0.01,0.904,0.9755531763026409,2825,2779
19,5704,10,100,0.001,0.01,0.89,0.9798387096774194,2879,2825
19,5804,10,100,0.001,0.01,0.892,0.9858718125430738,2922,2882
19,5904,10,100,0.001,0.01,0.87,0.9766260162601627,2964,2940
19,6004,10,100,0.001,0.01,0.874,0.9558627581612259,3013,2991
19,6104,10,100,0.001,0.01,0.898,0.9416775884665793,3057,3047
19,6204,10,100,0.001,0.01,0.902,0.9680851063829787,3107,3097
19,6304,10,100,0.001,0.01,0.916,0.9746192893401016,3156,3148
19,6404,10,100,0.001,0.01,0.906,0.9693941286695815,3208,3196
19,6504,10,100,0.001,0.01,0.898,0.9804735547355473,3258,3246
19,6604,10,100,0.001,0.01,0.906,0.9819806178073894,3318,3286
19,6704,10,100,0.001,0.01,0.9,0.9821002386634845,3365,3339
19,6804,10,100,0.001,0.01,0.894,0.9867724867724867,3423,3381
19,6904,10,100,0.001,0.01,0.912,0.9823290845886443,3474,3430
19,7004,10,100,0.001,0.01,0.916,0.9814391776127926,3522,3482
19,7104,10,100,0.001,0.01,0.914,0.9897240990990991,3572,3532
19,7204,10,100,0.001,0.01,0.902,0.9875069405885619,3621,3583
19,7304,10,100,0.001,0.01,0.922,0.9858981380065718,3663,3641
19,7404,10,100,0.001,0.01,0.906,0.9702863317125878,3717,3687
19,7504,10,100,0.001,0.01,0.904,0.9625533049040512,3771,3733
19,7604,10,100,0.001,0.01,0.916,0.9768542872172541,3824,3780
19,7704,10,100,0.001,0.01,0.92,0.985202492211838,3874,3830
19,7804,10,100,0.001,0.01,0.918,0.9832137365453614,3924,3880
19,7904,10,100,0.001,0.01,0.928,0.9853238866396761,3975,3929
19,8004,10,100,0.001,0.01,0.92,0.9846326836581709,4029,3975
19,8104,10,100,0.001,0.01,0.936,0.9892645607107601,4082,4022
19,8204,10,100,0.001,0.01,0.92,0.9875670404680643,4135,4069
19,8304,10,100,0.001,0.01,0.93,0.9885597302504817,4181,4123
19,8404,10,100,0.001,0.01,0.92,0.9846501665873394,4228,4176
19,8504,10,100,0.001,0.01,0.932,0.98447789275635,4289,4215
19,8604,10,100,0.001,0.01,0.93,0.9823337982333799,4342,4262
19,8704,10,100,0.001,0.01,0.93,0.9794347426470589,4394,4310
19,8804,10,100,0.001,0.01,0.934,0.9850068150840527,4447,4357
19,8904,10,100,0.001,0.01,0.934,0.9896675651392632,4492,4412
19,9004,10,100,0.001,0.01,0.926,0.9824522434473567,4542,4462
19,9104,10,100,0.001,0.01,0.938,0.9898945518453427,4586,4518
19,9204,10,100,0.001,0.01,0.942,0.9806605823554976,4635,4569
19,9304,10,100,0.001,0.01,0.936,0.9883920894239037,4679,4625
19,9404,10,100,0.001,0.01,0.936,0.9856444066354743,4725,4679
19,9504,10,100,0.001,0.01,0.938,0.9861111111111112,4771,4733
19,9604,10,100,0.001,0.01,0.934,0.984277384423157,4832,4772
19,9704,10,100,0.001,0.01,0.938,0.9727947238252267,4883,4821
19,9804,10,100,0.001,0.01,0.95,0.9842921256629947,4933,4871
19,9904,10,100,0.001,0.01,0.942,0.9941437802907916,4970,4934
19,10004,10,100,0.001,0.01,0.95,0.989204318272691,5020,4984
19,10104,10,100,0.001,0.01,0.95,0.9901029295328583,5065,5039
19,10204,10,100,0.001,0.01,0.944,0.9890239121912975,5123,5081
19,10304,10,100,0.001,0.01,0.946,0.9910714285714286,5173,5131
19,10404,10,100,0.001,0.01,0.942,0.988081507112649,5209,5195
19,10504,10,100,0.001,0.01,0.946,0.9878141660319878,5258,5246
19,10604,10,100,0.001,0.01,0.938,0.9863259147491512,5305,5299
19,10704,10,100,0.001,0.01,0.942,0.992152466367713,5353,5351
19,10804,10,100,0.001,0.01,0.942,0.9904664938911514,5395,5409
19,10904,10,100,0.001,0.01,0.958,0.9933052090975789,5442,5462
19,11004,10,100,0.001,0.01,0.956,0.9938204289349327,5491,5513
19,11104,10,100,0.001,0.01,0.958,0.9971181556195965,5545,5559
19,11204,10,100,0.001,0.01,0.938,0.982595501606569,5589,5615
19,11304,10,100,0.001,0.01,0.936,0.9609872611464968,5639,5665
19,11404,10,100,0.001,0.01,0.942,0.9832514907050158,5684,5720
19,11504,10,100,0.001,0.01,0.958,0.9882649513212796,5734,5770
19,11604,10,100,0.001,0.01,0.958,0.9940537745604964,5787,5817
19,11704,10,100,0.001,0.01,0.954,0.9972658920027341,5846,5858
19,11804,10,100,0.001,0.01,0.954,0.9972043375127075,5895,5909
19,11904,10,100,0.001,0.01,0.962,0.9972278225806451,5949,5955
19,12004,10,100,0.001,0.01,0.966,0.9948350549816728,5996,6008
19,12104,10,100,0.001,0.01,0.956,0.9967779246530073,6048,6056
19,12204,10,100,0.001,0.01,0.944,0.982055063913471,6100,6104
19,12304,10,100,0.001,0.01,0.946,0.9788686605981795,6142,6162
19,12404,10,100,0.001,0.01,0.936,0.9832312157368591,6190,6214
19,12504,10,100,0.001,0.01,0.964,0.9933621241202815,6236,6268
19,12604,10,100,0.001,0.01,0.96,0.9953982862583307,6283,6321
19,12704,10,100,0.001,0.01,0.964,0.9977959697732998,6332,6372
19,12804,10,100,0.001,0.01,0.962,0.9983598875351453,6383,6421
19,12904,10,100,0.001,0.01,0.956,0.9948078115313082,6436,6468
19,13004,10,100,0.001,0.01,0.962,0.9950784374038757,6499,6505
19,13104,10,100,0.001,0.01,0.938,0.9837454212454212,6548,6556
19,13204,10,100,0.001,0.01,0.934,0.9791729778854893,6612,6592
19,13304,10,100,0.001,0.01,0.952,0.9894016837041492,6670,6634
19,13404,10,100,0.001,0.01,0.966,0.9932855863921217,6720,6684
19,13504,10,100,0.001,0.01,0.968,0.9951125592417062,6770,6734
19,13604,10,100,0.001,0.01,0.956,0.9919876506909733,6820,6784
19,13704,10,100,0.001,0.01,0.958,0.9934325744308231,6879,6825
19,13804,10,100,0.001,0.01,0.966,0.9944943494639235,6934,6870
19,13904,10,100,0.001,0.01,0.966,0.9935270425776754,6989,6915
19,14004,10,100,0.001,0.01,0.926,0.9767209368751785,7041,6963
19,14104,10,100,0.001,0.01,0.964,0.9915626772546795,7091,7013
19,14204,10,100,0.001,0.01,0.964,0.9940157702055759,7136,7068
19,14304,10,100,0.001,0.01,0.966,0.9921700223713646,7187,7117
19,14404,10,100,0.001,0.01,0.962,0.9931269091918912,7239,7165
19,14504,10,100,0.001,0.01,0.966,0.9947600661886377,7286,7218
19,14604,10,100,0.001,0.01,0.962,0.993631881676253,7327,7277
19,14704,10,100,0.001,0.01,0.97,0.9914309031556039,7370,7334
19,14804,10,100,0.001,0.01,0.96,0.9913536881923805,7412,7392
19,14904,10,100,0.001,0.01,0.97,0.995101986044015,7466,7438
19,15004,10,100,0.001,0.01,0.97,0.9947347374033592,7514,7490
20,104,10,100,0.001,0.01,0.512,0.5480769230769231,57,47
20,204,10,100,0.001,0.01,0.554,0.696078431372549,102,102
20,304,10,100,0.001,0.01,0.496,0.6282894736842105,150,154
20,404,10,100,0.001,0.01,0.514,0.6212871287128713,207,197
20,504,10,100,0.001,0.01,0.508,0.6051587301587301,250,254
20,604,10,100,0.001,0.01,0.484,0.6440397350993378,298,306
20,704,10,100,0.001,0.01,0.476,0.6619318181818182,350,354
20,804,10,100,0.001,0.01,0.484,0.6703980099502488,388,416
20,904,10,100,0.001,0.01,0.484,0.6780973451327433,439,465
20,1004,10,100,0.001,0.01,0.498,0.6842629482071713,492,512
20,1104,10,100,0.001,0.01,0.492,0.6739130434782609,540,564
20,1204,10,100,0.001,0.01,0.506,0.7018272425249169,590,614
20,1304,10,100,0.001,0.01,0.516,0.7223926380368099,641,663
20,1404,10,100,0.001,0.01,0.518,0.7478632478632479,691,713
20,1504,10,100,0.001,0.01,0.518,0.7360372340425532,735,769
20,1604,10,100,0.001,0.01,0.528,0.7643391521197007,789,815
20,1704,10,100,0.001,0.01,0.516,0.7171361502347418,845,859
20,1804,10,100,0.001,0.01,0.51,0.7699556541019955,894,910
20,1904,10,100,0.001,0.01,0.528,0.7710084033613446,940,964
20,2004,10,100,0.001,0.01,0.536,0.782435129740519,997,1007
20,2104,10,100,0.001,0.01,0.532,0.7989543726235742,1047,1057
20,2204,10,100,0.001,0.01,0.51,0.7749546279491834,1105,1099
20,2304,10,100,0.001,0.01,0.542,0.8012152777777778,1165,1139
20,2404,10,100,0.001,0.01,0.56,0.8352745424292846,1216,1188
20,2504,10,100,0.001,0.01,0.564,0.8330670926517572,1271,1233
20,2604,10,100,0.001,0.01,0.576,0.8302611367127496,1324,1280
20,2704,10,100,0.001,0.01,0.582,0.8587278106508875,1379,1325
20,2804,10,100,0.001,0.01,0.624,0.8922967189728959,1425,1379
20,2904,10,100,0.001,0.01,0.638,0.9170110192837465,1474,1430
20,3004,10,100,0.001,0.01,0.64,0.9287616511318242,1525,1479
20,3104,10,100,0.001,0.01,0.65,0.913659793814433,1570,1534
20,3204,10,100,0.001,0.01,0.658,0.9069912609238452,1621,1583
20,3304,10,100,0.001,0.01,0.658,0.8610774818401937,1673,1631
20,3404,10,100,0.001,0.01,0.706,0.895710928319624,1721,1683
20,3504,10,100,0.001,0.01,0.726,0.9175228310502284,1764,1740
20,3604,10,100,0.001,0.01,0.714,0.9298002219755827,1811,1793
20,3704,10,100,0.001,0.01,0.754,0.9505939524838013,1855,1849
20,3804,10,100,0.001,0.01,0.756,0.943217665615142,1915,1889
20,3904,10,100,0.001,0.01,0.726,0.9275102459016393,1966,1938
20,4004,10,100,0.001,0.01,0.79,0.9428071928071928,2016,1988
20,4104,10,100,0.001,0.01,0.762,0.9429824561403509,2075,2029
20,4204,10,100,0.001,0.01,0.794,0.9443387250237869,2134,2070
20,4304,10,100,0.001,0.01,0.776,0.9388940520446096,2191,2113
20,4404,10,100,0.001,0.01,0.78,0.952316076294278,2244,2160
20,4504,10,100,0.001,0.01,0.778,0.9280639431616341,2296,2208
20,4604,10,100,0.001,0.01,0.768,0.9328844483058211,2335,2269
20,4704,10,100,0.001,0.01,0.794,0.9494047619047619,2384,2320
20,4804,10,100,0.001,0.01,0.8,0.9637801831806828,2433,2371
20,4904,10,100,0.001,0.01,0.796,0.9694127243066885,2482,2422
20,5004,10,100,0.001,0.01,0.786,0.9624300559552358,2530,2474
20,5104,10,100,0.001,0.01,0.814,0.9488636363636364,2582,2522
20,5204,10,100,0.001,0.01,0.794,0.9583013066871637,2637,2567
20,5304,10,100,0.001,0.01,0.78,0.9524886877828054,2697,2607
20,5404,10,100,0.001,0.01,0.808,0.9715025906735751,2741,2663
20,5504,10,100,0.001,0.01,0.836,0.9723837209302325,2789,2715
20,5604,10,100,0.001,0.01,0.792,0.960028551034975,2838,2766
20,5704,10,100,0.001,0.01,0.826,0.9582748948106592,2885,2819
20,5804,10,100,0.001,0.01,0.82,0.9657133011716058,2929,2875
20,5904,10,100,0.001,0.01,0.834,0.9759485094850948,2970,2934
20,6004,10,100,0.001,0.01,0.792,0.9611925383077948,3025,2979
20,6104,10,100,0.001,0.01,0.844,0.9675622542595019,3072,3032
20,6204,10,100,0.001,0.01,0.844,0.9706640876853643,3127,3077
20,6304,10,100,0.001,0.01,0.848,0.9695431472081218,3172,3132
20,6404,10,100,0.001,0.01,0.812,0.9561211742660837,3229,3175
20,6504,10,100,0.001,0.01,0.802,0.932349323493235,3279,3225
20,6604,10,100,0.001,0.01,0.83,0.9445790430042399,3334,3270
20,6704,10,100,0.001,0.01,0.824,0.9519689737470167,3373,3331
20,6804,10,100,0.001,0.01,0.834,0.9667842445620224,3417,3387
20,6904,10,100,0.001,0.01,0.864,0.9705967555040557,3467,3437
20,7004,10,100,0.001,0.01,0.852,0.9750142775556825,3514,3490
20,7104,10,100,0.001,0.01,0.854,0.971706081081081,3557,3547
20,7204,10,100,0.001,0.01,0.85,0.9761243753470294,3605,3599
20,7304,10,100,0.001,0.01,0.852,0.9715224534501643,3658,3646
20,7404,10,100,0.001,0.01,0.846,0.9747433819556997,3705,3699
20,7504,10,100,0.001,0.01,0.858,0.9820095948827292,3754,3750
20,7604,10,100,0.001,0.01,0.852,0.9725144660704892,3806,3798
20,7704,10,100,0.001,0.01,0.82,0.9410695742471443,3861,3843
20,7804,10,100,0.001,0.01,0.858,0.9588672475653511,3919,3885
20,7904,10,100,0.001,0.01,0.868,0.9629301619433198,3967,3937
20,8004,10,100,0.001,0.01,0.882,0.974512743628186,4013,3991
20,8104,10,100,0.001,0.01,0.876,0.9813672260612043,4064,4040
20,8204,10,100,0.001,0.01,0.882,0.9867137981472452,4112,4092
20,8304,10,100,0.001,0.01,0.892,0.9857899807321773,4160,4144
20,8404,10,100,0.001,0.01,0.874,0.9744169443122322,4216,4188
20,8504,10,100,0.001,0.01,0.872,0.9674270931326434,4262,4242
20,8604,10,100,0.001,0.01,0.85,0.9514179451417946,4306,4298
20,8704,10,100,0.001,0.01,0.872,0.9655330882352942,4357,4347
20,8804,10,100,0.001,0.01,0.884,0.9712630622444344,4410,4394
20,8904,10,100,0.001,0.01,0.888,0.9789982030548068,4461,4443
20,9004,10,100,0.001,0.01,0.898,0.9834517992003554,4511,4493
20,9104,10,100,0.001,0.01,0.89,0.9824253075571178,4558,4546
20,9204,10,100,0.001,0.01,0.878,0.9818557149065623,4610,4594
20,9304,10,100,0.001,0.01,0.892,0.9892519346517626,4662,4642
20,9404,10,100,0.001,0.01,0.894,0.9829859634198214,4717,4687
20,9504,10,100,0.001,0.01,0.898,0.9797979797979798,4770,4734
20,9604,10,100,0.001,0.01,0.876,0.9703248646397334,4809,4795
20,9704,10,100,0.001,0.01,0.864,0.9482687551525144,4860,4844
20,9804,10,100,0.001,0.01,0.878,0.9705222358221134,4910,4894
20,9904,10,100,0.001,0.01,0.9,0.9710218093699515,4955,4949
20,10004,10,100,0.001,0.01,0.888,0.9827069172331068,4995,5009
20,10104,10,100,0.001,0.01,0.902,0.9849564528899446,5038,5066
20,10204,10,100,0.001,0.01,0.894,0.982359858878871,5092,5112
20,10304,10,100,0.001,0.01,0.892,0.9783579192546584,5151,5153
20,10404,10,100,0.001,0.01,0.878,0.971837754709727,5210,5194
20,10504,10,100,0.001,0.01,0.896,0.9793412033511043,5259,5245
20,10604,10,100,0.001,0.01,0.902,0.9858543945680875,5313,5291
20,10704,10,100,0.001,0.01,0.91,0.9887892376681614,5367,5337
20,10804,10,100,0.001,0.01,0.91,0.9917623102554609,5423,5381
20,10904,10,100,0.001,0.01,0.908,0.9914710198092443,5468,5436
20,11004,10,100,0.001,0.01,0.91,0.9809160305343512,5517,5487
20,11104,10,100,0.001,0.01,0.904,0.9792867435158501,5574,5530
20,11204,10,100,0.001,0.01,0.9,0.979560871117458,5630,5574
20,11304,10,100,0.001,0.01,0.896,0.9828379334748761,5695,5609
20,11404,10,100,0.001,0.01,0.9,0.9891266222378113,5737,5667
20,11504,10,100,0.001,0.01,0.922,0.9895688456189151,5790,5714
20,11604,10,100,0.001,0.01,0.908,0.9810410203378146,5833,5771
20,11704,10,100,0.001,0.01,0.902,0.9794087491455913,5874,5830
20,11804,10,100,0.001,0.01,0.906,0.9869535750593019,5931,5873
20,11904,10,100,0.001,0.01,0.918,0.9844590053763441,5969,5935
20,12004,10,100,0.001,0.01,0.908,0.9899200266577808,6020,5984
20,12104,10,100,0.001,0.01,0.92,0.9855419695968275,6071,6033
20,12204,10,100,0.001,0.01,0.91,0.977548344804982,6122,6082
20,12304,10,100,0.001,0.01,0.918,0.9835825747724317,6165,6139
20,12404,10,100,0.001,0.01,0.91,0.9799258303772976,6213,6191
20,12504,10,100,0.001,0.01,0.906,0.9874440179142674,6255,6249
20,12604,10,100,0.001,0.01,0.916,0.9883370358616312,6298,6306
20,12704,10,100,0.001,0.01,0.932,0.9911051637279596,6350,6354
20,12804,10,100,0.001,0.01,0.922,0.9871915026554202,6394,6410
20,12904,10,100,0.001,0.01,0.92,0.991088034717917,6439,6465
20,13004,10,100,0.001,0.01,0.922,0.9833128268225162,6488,6516
20,13104,10,100,0.001,0.01,0.914,0.9918345543345544,6541,6563
20,13204,10,100,0.001,0.01,0.924,0.988336867615874,6596,6608
20,13304,10,100,0.001,0.01,0.928,0.9919573060733614,6649,6655
20,13404,10,100,0.001,0.01,0.936,0.9884362876753208,6704,6700
20,13504,10,100,0.001,0.01,0.924,0.98489336492891,6756,6748
20,13604,10,100,0.001,0.01,0.938,0.9841958247574243,6807,6797
20,13704,10,100,0.001,0.01,0.946,0.9905137186223001,6847,6857
20,13804,10,100,0.001,0.01,0.944,0.9892784700086932,6898,6906
20,13904,10,100,0.001,0.01,0.934,0.9839614499424626,6941,6963
20,14004,10,100,0.001,0.01,0.952,0.9811482433590403,6995,7009
20,14104,10,100,0.001,0.01,0.954,0.9917044809982983,7043,7061
20,14204,10,100,0.001,0.01,0.944,0.9884539566319347,7098,7106
20,14304,10,100,0.001,0.01,0.96,0.9920302013422819,7145,7159
20,14404,10,100,0.001,0.01,0.958,0.9927797833935018,7197,7207
20,14504,10,100,0.001,0.01,0.942,0.9873138444567016,7245,7259
20,14604,10,100,0.001,0.01,0.912,0.977540399890441,7291,7313
20,14704,10,100,0.001,0.01,0.944,0.9825217627856365,7338,7366
20,14804,10,100,0.001,0.01,0.954,0.990070251283437,7396,7408
20,14904,10,100,0.001,0.01,0.95,0.9928207192699946,7445,7459
20,15004,10,100,0.001,0.01,0.956,0.9957344708077845,7496,7508
